[14, 30, 78, 119, 184, 210, 262, 268, 298, 327, 386, 427, 447, 518, 553, 561, 611, 618, 637, 751, 759, 769]
[15, 41, 71, 130, 174, 251, 285, 339, 400, 515, 535, 558, 568, 585, 649, 677, 715, 736, 739, 772, 778, 818]

[14, 30, 78, 119, 184, 210, 262, 268, 298, 327, 386, 427, 447, 518, 553, 561, 611, 618, 637, 751, 759, 769]
[12, 15, 31, 41, 47, 66, 70, 71, 77, 80, 96, 107, 122, 126, 128, 130, 153, 154, 156, 161, 166, 174, 176, 226, 229, 233, 237, 247, 251, 267, 275, 285, 297, 305, 309, 315, 329, 334, 336, 339, 342, 350, 356, 371, 382, 388, 396, 400, 414, 416, 426, 428, 448, 452, 453, 456, 481, 484, 498, 501, 515, 519, 524, 527, 528, 529, 532, 535, 536, 540, 544, 554, 558, 562, 568, 569, 573, 585, 587, 590, 599, 603, 604, 609, 610, 625, 629, 633, 639, 649, 662, 677, 687, 689, 690, 696, 713, 715, 721, 726, 727, 730, 736, 739, 745, 748, 753, 771, 772, 775, 778, 779, 813, 814, 818, 821, 831, 832, 838, 863, 880, 889]

[2, 4, 6, 14, 20, 22, 23, 30, 38, 39, 42, 55, 77, 78, 94, 97, 107, 119, 121, 123, 132, 134, 136, 150, 159, 167, 175, 180, 183, 184, 192, 194, 207, 210, 229, 233, 240, 252, 253, 261, 262, 268, 269, 274, 281, 298, 299, 327, 328, 338, 355, 371, 383, 386, 389, 401, 411, 415, 418, 427, 434, 437, 439, 447, 449, 469, 475, 489, 493, 494, 504, 518, 548, 549, 553, 555, 561, 611, 613, 618, 637, 663, 665, 688, 740, 751, 759, 762, 769, 804, 808, 825, 840, 847, 878, 879, 886]
[12, 15, 31, 41, 47, 66, 70, 71, 77, 80, 96, 107, 122, 126, 128, 130, 153, 154, 156, 161, 166, 174, 176, 226, 229, 233, 237, 247, 251, 267, 275, 285, 297, 305, 309, 315, 329, 334, 336, 339, 342, 350, 356, 371, 382, 388, 396, 400, 414, 416, 426, 428, 448, 452, 453, 456, 481, 484, 498, 501, 515, 519, 524, 527, 528, 529, 532, 535, 536, 540, 544, 554, 558, 562, 568, 569, 573, 585, 587, 590, 599, 603, 604, 609, 610, 625, 629, 633, 639, 649, 662, 677, 687, 689, 690, 696, 713, 715, 721, 726, 727, 730, 736, 739, 745, 748, 753, 771, 772, 775, 778, 779, 813, 814, 818, 821, 831, 832, 838, 863, 880, 889]

[2, 4, 6, 14, 18, 20, 22, 23, 25, 26, 28, 30, 31, 38, 39, 42, 52, 55, 77, 78, 79, 80, 82, 84, 94, 96, 97, 99, 107, 113, 116, 119, 121, 123, 127, 132, 134, 136, 140, 150, 153, 159, 162, 164, 167, 175, 179, 180, 183, 184, 192, 194, 207, 210, 212, 221, 229, 233, 240, 252, 253, 261, 262, 268, 269, 272, 274, 277, 281, 298, 299, 301, 308, 327, 328, 329, 338, 341, 350, 355, 371, 383, 386, 389, 391, 393, 399, 400, 401, 406, 411, 415, 418, 427, 431, 432, 434, 437, 439, 441, 445, 447, 449, 456, 460, 469, 475, 482, 483, 489, 493, 494, 504, 518, 540, 548, 549, 550, 553, 555, 561, 565, 590, 611, 612, 613, 618, 631, 632, 637, 638, 649, 663, 665, 676, 677, 684, 688, 700, 705, 719, 727, 729, 740, 745, 751, 752, 759, 761, 762, 763, 769, 771, 804, 808, 811, 818, 825, 826, 834, 836, 840, 847, 852, 862, 863, 865, 869, 878, 879, 884, 886]
[12, 15, 31, 41, 47, 66, 70, 71, 77, 80, 96, 107, 122, 126, 128, 130, 153, 154, 156, 161, 166, 174, 176, 226, 229, 233, 237, 247, 251, 267, 275, 285, 297, 305, 309, 315, 329, 334, 336, 339, 342, 350, 356, 371, 382, 388, 396, 400, 414, 416, 426, 428, 448, 452, 453, 456, 481, 484, 498, 501, 515, 519, 524, 527, 528, 529, 532, 535, 536, 540, 544, 554, 558, 562, 568, 569, 573, 585, 587, 590, 599, 603, 604, 609, 610, 625, 629, 633, 639, 649, 662, 677, 687, 689, 690, 696, 713, 715, 721, 726, 727, 730, 736, 739, 745, 748, 753, 771, 772, 775, 778, 779, 813, 814, 818, 821, 831, 832, 838, 863, 880, 889]

[2, 4, 6, 10, 14, 18, 20, 22, 23, 25, 26, 28, 30, 31, 38, 39, 40, 41, 42, 48, 52, 55, 56, 68, 76, 77, 78, 79, 80, 82, 84, 92, 94, 96, 97, 98, 99, 100, 102, 107, 113, 116, 119, 121, 123, 126, 127, 132, 134, 136, 140, 150, 151, 153, 159, 162, 164, 166, 167, 175, 179, 180, 183, 184, 188, 192, 194, 207, 210, 212, 214, 218, 221, 225, 228, 229, 233, 235, 240, 242, 245, 252, 253, 261, 262, 263, 268, 269, 270, 272, 274, 277, 281, 293, 296, 298, 299, 301, 302, 308, 320, 323, 327, 328, 329, 338, 341, 344, 349, 350, 355, 371, 381, 383, 386, 388, 389, 391, 393, 399, 400, 401, 404, 406, 409, 411, 415, 418, 427, 429, 431, 432, 433, 434, 437, 439, 441, 445, 447, 449, 456, 460, 466, 469, 471, 475, 482, 483, 485, 489, 490, 491, 493, 494, 504, 509, 516, 518, 538, 539, 540, 548, 549, 550, 553, 555, 561, 564, 565, 580, 582, 590, 595, 604, 605, 611, 612, 613, 618, 622, 631, 632, 637, 638, 639, 640, 649, 663, 664, 665, 674, 675, 676, 677, 678, 684, 688, 690, 693, 700, 705, 706, 716, 719, 727, 729, 740, 744, 745, 751, 752, 759, 761, 762, 763, 769, 771, 803, 804, 808, 809, 811, 818, 825, 826, 829, 834, 836, 838, 840, 847, 849, 850, 852, 854, 855, 862, 863, 865, 866, 869, 870, 875, 878, 879, 884, 886]
[12, 15, 31, 41, 47, 66, 70, 71, 77, 80, 96, 107, 122, 126, 128, 130, 153, 154, 156, 161, 166, 174, 176, 226, 229, 233, 237, 247, 251, 267, 275, 285, 297, 305, 309, 315, 329, 334, 336, 339, 342, 350, 356, 371, 382, 388, 396, 400, 414, 416, 426, 428, 448, 452, 453, 456, 481, 484, 498, 501, 515, 519, 524, 527, 528, 529, 532, 535, 536, 540, 544, 554, 558, 562, 568, 569, 573, 585, 587, 590, 599, 603, 604, 609, 610, 625, 629, 633, 639, 649, 662, 677, 687, 689, 690, 696, 713, 715, 721, 726, 727, 730, 736, 739, 745, 748, 753, 771, 772, 775, 778, 779, 813, 814, 818, 821, 831, 832, 838, 863, 880, 889]

[2, 4, 6, 10, 14, 18, 20, 22, 23, 25, 26, 28, 30, 31, 33, 38, 39, 40, 41, 42, 43, 46, 48, 52, 55, 56, 68, 76, 77, 78, 79, 80, 82, 84, 92, 94, 96, 97, 98, 99, 100, 101, 102, 107, 113, 115, 116, 119, 121, 123, 126, 127, 132, 133, 134, 136, 140, 141, 142, 144, 150, 151, 152, 153, 159, 161, 162, 163, 164, 166, 167, 174, 175, 179, 180, 183, 184, 188, 192, 194, 204, 206, 207, 208, 210, 212, 214, 218, 221, 225, 228, 229, 232, 233, 235, 240, 242, 245, 250, 252, 253, 261, 262, 263, 268, 269, 270, 272, 273, 274, 275, 277, 281, 286, 293, 296, 297, 298, 299, 301, 302, 303, 308, 320, 323, 327, 328, 329, 331, 335, 338, 340, 341, 342, 344, 349, 350, 353, 355, 356, 361, 371, 379, 381, 383, 386, 388, 389, 391, 393, 395, 399, 400, 401, 404, 406, 409, 411, 415, 416, 418, 427, 429, 431, 432, 433, 434, 436, 437, 438, 439, 441, 445, 447, 449, 451, 456, 457, 460, 462, 466, 469, 471, 473, 475, 478, 482, 483, 485, 489, 490, 491, 493, 494, 498, 500, 504, 508, 509, 512, 516, 518, 530, 538, 539, 540, 544, 548, 549, 550, 551, 553, 555, 556, 561, 563, 564, 565, 575, 580, 582, 589, 590, 594, 595, 598, 604, 605, 611, 612, 613, 614, 618, 622, 627, 628, 631, 632, 637, 638, 639, 640, 643, 649, 656, 663, 664, 665, 666, 674, 675, 676, 677, 678, 684, 688, 690, 693, 700, 705, 706, 707, 708, 716, 719, 722, 727, 729, 733, 740, 744, 745, 749, 751, 752, 759, 761, 762, 763, 764, 766, 767, 769, 771, 779, 782, 785, 801, 803, 804, 808, 809, 811, 813, 818, 822, 825, 826, 829, 834, 836, 838, 840, 845, 847, 849, 850, 852, 854, 855, 862, 863, 865, 866, 869, 870, 872, 875, 878, 879, 882, 884, 886, 887]
[12, 15, 31, 41, 47, 66, 70, 71, 77, 80, 96, 107, 122, 126, 128, 130, 153, 154, 156, 161, 166, 174, 176, 226, 229, 233, 237, 247, 251, 267, 275, 285, 297, 305, 309, 315, 329, 334, 336, 339, 342, 350, 356, 371, 382, 388, 396, 400, 414, 416, 426, 428, 448, 452, 453, 456, 481, 484, 498, 501, 515, 519, 524, 527, 528, 529, 532, 535, 536, 540, 544, 554, 558, 562, 568, 569, 573, 585, 587, 590, 599, 603, 604, 609, 610, 625, 629, 633, 639, 649, 662, 677, 687, 689, 690, 696, 713, 715, 721, 726, 727, 730, 736, 739, 745, 748, 753, 771, 772, 775, 778, 779, 813, 814, 818, 821, 831, 832, 838, 863, 880, 889]

[0, 2, 4, 6, 8, 10, 14, 15, 18, 20, 22, 23, 25, 26, 28, 30, 31, 33, 35, 38, 39, 40, 41, 42, 43, 46, 48, 52, 55, 56, 62, 68, 70, 72, 76, 77, 78, 79, 80, 82, 84, 90, 92, 94, 96, 97, 98, 99, 100, 101, 102, 103, 107, 113, 115, 116, 119, 120, 121, 122, 123, 126, 127, 129, 131, 132, 133, 134, 136, 139, 140, 141, 142, 144, 150, 151, 152, 153, 155, 157, 159, 161, 162, 163, 164, 165, 166, 167, 168, 170, 174, 175, 177, 179, 180, 183, 184, 185, 188, 192, 194, 203, 204, 206, 207, 208, 210, 212, 214, 215, 218, 220, 221, 225, 228, 229, 232, 233, 235, 240, 242, 245, 248, 250, 252, 253, 261, 262, 263, 268, 269, 270, 272, 273, 274, 275, 277, 279, 281, 286, 288, 293, 294, 296, 297, 298, 299, 301, 302, 303, 308, 310, 313, 320, 323, 326, 327, 328, 329, 331, 333, 335, 338, 340, 341, 342, 344, 347, 349, 350, 353, 355, 356, 361, 368, 371, 379, 381, 383, 386, 387, 388, 389, 390, 391, 392, 393, 395, 399, 400, 401, 404, 406, 409, 410, 411, 415, 416, 418, 419, 420, 421, 427, 429, 431, 432, 433, 434, 436, 437, 438, 439, 441, 445, 447, 449, 451, 456, 457, 460, 462, 466, 469, 471, 473, 475, 478, 482, 483, 485, 489, 490, 491, 493, 494, 498, 500, 504, 506, 508, 509, 512, 514, 516, 518, 523, 526, 527, 530, 533, 536, 538, 539, 540, 543, 544, 548, 549, 550, 551, 552, 553, 555, 556, 561, 563, 564, 565, 566, 575, 580, 582, 585, 588, 589, 590, 593, 594, 595, 598, 604, 605, 606, 611, 612, 613, 614, 616, 618, 622, 627, 628, 631, 632, 637, 638, 639, 640, 641, 643, 645, 649, 650, 656, 658, 660, 663, 664, 665, 666, 674, 675, 676, 677, 678, 683, 684, 688, 690, 693, 694, 700, 703, 705, 706, 707, 708, 715, 716, 719, 722, 725, 727, 729, 733, 738, 740, 741, 744, 745, 749, 751, 752, 759, 761, 762, 763, 764, 766, 767, 769, 770, 771, 779, 782, 785, 801, 803, 804, 808, 809, 810, 811, 813, 818, 822, 825, 826, 829, 834, 836, 838, 840, 842, 845, 847, 849, 850, 851, 852, 854, 855, 861, 862, 863, 864, 865, 866, 869, 870, 872, 874, 875, 878, 879, 882, 884, 886, 887]
[12, 15, 31, 41, 47, 66, 70, 71, 77, 80, 96, 107, 122, 126, 128, 130, 153, 154, 156, 161, 166, 174, 176, 226, 229, 233, 237, 247, 251, 267, 275, 285, 297, 305, 309, 315, 329, 334, 336, 339, 342, 350, 356, 371, 382, 388, 396, 400, 414, 416, 426, 428, 448, 452, 453, 456, 481, 484, 498, 501, 515, 519, 524, 527, 528, 529, 532, 535, 536, 540, 544, 554, 558, 562, 568, 569, 573, 585, 587, 590, 599, 603, 604, 609, 610, 625, 629, 633, 639, 649, 662, 677, 687, 689, 690, 696, 713, 715, 721, 726, 727, 730, 736, 739, 745, 748, 753, 771, 772, 775, 778, 779, 813, 814, 818, 821, 831, 832, 838, 863, 880, 889]

[0, 2, 4, 5, 6, 8, 10, 11, 13, 14, 15, 18, 20, 22, 23, 25, 26, 28, 30, 31, 32, 33, 35, 38, 39, 40, 41, 42, 43, 44, 46, 48, 52, 55, 56, 61, 62, 68, 69, 70, 72, 76, 77, 78, 79, 80, 82, 84, 88, 90, 92, 93, 94, 96, 97, 98, 99, 100, 101, 102, 103, 107, 111, 113, 115, 116, 119, 120, 121, 122, 123, 126, 127, 129, 131, 132, 133, 134, 136, 137, 139, 140, 141, 142, 144, 145, 150, 151, 152, 153, 155, 157, 159, 161, 162, 163, 164, 165, 166, 167, 168, 170, 172, 173, 174, 175, 176, 177, 179, 180, 182, 183, 184, 185, 188, 192, 194, 196, 199, 202, 203, 204, 206, 207, 208, 210, 211, 212, 213, 214, 215, 218, 220, 221, 222, 225, 226, 228, 229, 231, 232, 233, 235, 238, 239, 240, 242, 245, 248, 250, 252, 253, 261, 262, 263, 268, 269, 270, 271, 272, 273, 274, 275, 277, 279, 281, 286, 288, 290, 293, 294, 296, 297, 298, 299, 301, 302, 303, 305, 308, 310, 313, 320, 323, 324, 326, 327, 328, 329, 331, 333, 335, 338, 340, 341, 342, 344, 347, 349, 350, 353, 355, 356, 361, 367, 368, 371, 376, 377, 379, 381, 383, 385, 386, 387, 388, 389, 390, 391, 392, 393, 394, 395, 397, 399, 400, 401, 404, 406, 409, 410, 411, 414, 415, 416, 418, 419, 420, 421, 427, 429, 431, 432, 433, 434, 435, 436, 437, 438, 439, 441, 445, 447, 449, 451, 453, 456, 457, 460, 462, 466, 469, 471, 473, 475, 478, 482, 483, 485, 488, 489, 490, 491, 492, 493, 494, 498, 500, 501, 504, 506, 508, 509, 512, 514, 516, 517, 518, 523, 526, 527, 530, 532, 533, 536, 538, 539, 540, 543, 544, 548, 549, 550, 551, 552, 553, 555, 556, 557, 561, 563, 564, 565, 566, 575, 580, 582, 585, 588, 589, 590, 593, 594, 595, 598, 604, 605, 606, 611, 612, 613, 614, 616, 618, 622, 627, 628, 629, 630, 631, 632, 633, 637, 638, 639, 640, 641, 642, 643, 645, 646, 649, 650, 651, 656, 658, 660, 663, 664, 665, 666, 674, 675, 676, 677, 678, 683, 684, 685, 688, 690, 693, 694, 695, 696, 697, 699, 700, 703, 705, 706, 707, 708, 713, 715, 716, 719, 720, 722, 725, 727, 729, 733, 738, 740, 741, 744, 745, 747, 749, 751, 752, 754, 756, 759, 761, 762, 763, 764, 766, 767, 768, 769, 770, 771, 779, 782, 785, 786, 791, 800, 801, 803, 804, 806, 808, 809, 810, 811, 813, 816, 818, 822, 825, 826, 828, 829, 834, 835, 836, 838, 840, 842, 843, 845, 846, 847, 849, 850, 851, 852, 854, 855, 861, 862, 863, 864, 865, 866, 867, 868, 869, 870, 872, 874, 875, 878, 879, 882, 883, 884, 885, 886, 887]
[12, 15, 31, 41, 47, 66, 70, 71, 77, 80, 96, 107, 122, 126, 128, 130, 153, 154, 156, 161, 166, 174, 176, 226, 229, 233, 237, 247, 251, 267, 275, 285, 297, 305, 309, 315, 329, 334, 336, 339, 342, 350, 356, 371, 382, 388, 396, 400, 414, 416, 426, 428, 448, 452, 453, 456, 481, 484, 498, 501, 515, 519, 524, 527, 528, 529, 532, 535, 536, 540, 544, 554, 558, 562, 568, 569, 573, 585, 587, 590, 599, 603, 604, 609, 610, 625, 629, 633, 639, 649, 662, 677, 687, 689, 690, 696, 713, 715, 721, 726, 727, 730, 736, 739, 745, 748, 753, 771, 772, 775, 778, 779, 813, 814, 818, 821, 831, 832, 838, 863, 880, 889]

[0, 1, 2, 4, 5, 6, 8, 10, 11, 13, 14, 15, 16, 18, 19, 20, 22, 23, 25, 26, 28, 30, 31, 32, 33, 35, 36, 37, 38, 39, 40, 41, 42, 43, 44, 46, 48, 49, 51, 52, 55, 56, 58, 61, 62, 68, 69, 70, 72, 76, 77, 78, 79, 80, 82, 84, 88, 90, 92, 93, 94, 96, 97, 98, 99, 100, 101, 102, 103, 107, 111, 113, 115, 116, 117, 119, 120, 121, 122, 123, 125, 126, 127, 128, 129, 131, 132, 133, 134, 136, 137, 139, 140, 141, 142, 144, 145, 150, 151, 152, 153, 155, 157, 159, 161, 162, 163, 164, 165, 166, 167, 168, 169, 170, 171, 172, 173, 174, 175, 176, 177, 179, 180, 181, 182, 183, 184, 185, 188, 192, 194, 196, 199, 202, 203, 204, 206, 207, 208, 210, 211, 212, 213, 214, 215, 216, 217, 218, 219, 220, 221, 222, 225, 226, 228, 229, 231, 232, 233, 234, 235, 238, 239, 240, 242, 243, 245, 248, 249, 250, 252, 253, 260, 261, 262, 263, 268, 269, 270, 271, 272, 273, 274, 275, 277, 278, 279, 281, 282, 286, 288, 290, 293, 294, 296, 297, 298, 299, 301, 302, 303, 305, 308, 310, 313, 317, 320, 323, 324, 326, 327, 328, 329, 331, 333, 335, 338, 340, 341, 342, 344, 347, 349, 350, 352, 353, 355, 356, 358, 359, 361, 366, 367, 368, 370, 371, 376, 377, 379, 380, 381, 383, 385, 386, 387, 388, 389, 390, 391, 392, 393, 394, 395, 397, 398, 399, 400, 401, 404, 405, 406, 408, 409, 410, 411, 414, 415, 416, 417, 418, 419, 420, 421, 424, 425, 427, 429, 430, 431, 432, 433, 434, 435, 436, 437, 438, 439, 441, 445, 447, 449, 451, 453, 456, 457, 460, 462, 466, 469, 471, 473, 475, 478, 480, 482, 483, 485, 488, 489, 490, 491, 492, 493, 494, 498, 499, 500, 501, 504, 506, 507, 508, 509, 512, 513, 514, 515, 516, 517, 518, 520, 523, 526, 527, 529, 530, 532, 533, 536, 538, 539, 540, 543, 544, 548, 549, 550, 551, 552, 553, 555, 556, 557, 561, 563, 564, 565, 566, 575, 576, 580, 582, 584, 585, 588, 589, 590, 591, 593, 594, 595, 598, 602, 604, 605, 606, 609, 610, 611, 612, 613, 614, 616, 618, 622, 627, 628, 629, 630, 631, 632, 633, 636, 637, 638, 639, 640, 641, 642, 643, 645, 646, 649, 650, 651, 652, 656, 658, 659, 660, 663, 664, 665, 666, 668, 671, 673, 674, 675, 676, 677, 678, 682, 683, 684, 685, 688, 690, 693, 694, 695, 696, 697, 699, 700, 703, 705, 706, 707, 708, 712, 713, 714, 715, 716, 717, 719, 720, 722, 723, 724, 725, 727, 729, 730, 731, 733, 738, 740, 741, 744, 745, 747, 749, 750, 751, 752, 754, 756, 759, 760, 761, 762, 763, 764, 766, 767, 768, 769, 770, 771, 779, 782, 785, 786, 789, 790, 791, 800, 801, 803, 804, 806, 808, 809, 810, 811, 813, 814, 816, 818, 822, 825, 826, 827, 828, 829, 831, 832, 834, 835, 836, 838, 840, 842, 843, 844, 845, 846, 847, 849, 850, 851, 852, 854, 855, 861, 862, 863, 864, 865, 866, 867, 868, 869, 870, 872, 874, 875, 876, 878, 879, 881, 882, 883, 884, 885, 886, 887]
[12, 15, 31, 41, 47, 66, 70, 71, 77, 80, 96, 107, 122, 126, 128, 130, 153, 154, 156, 161, 166, 174, 176, 226, 229, 233, 237, 247, 251, 267, 275, 285, 297, 305, 309, 315, 329, 334, 336, 339, 342, 350, 356, 371, 382, 388, 396, 400, 414, 416, 426, 428, 448, 452, 453, 456, 481, 484, 498, 501, 515, 519, 524, 527, 528, 529, 532, 535, 536, 540, 544, 554, 558, 562, 568, 569, 573, 585, 587, 590, 599, 603, 604, 609, 610, 625, 629, 633, 639, 649, 662, 677, 687, 689, 690, 696, 713, 715, 721, 726, 727, 730, 736, 739, 745, 748, 753, 771, 772, 775, 778, 779, 813, 814, 818, 821, 831, 832, 838, 863, 880, 889]

[0, 1, 2, 4, 5, 6, 8, 9, 10, 11, 13, 14, 15, 16, 18, 19, 20, 22, 23, 24, 25, 26, 28, 30, 31, 32, 33, 35, 36, 37, 38, 39, 40, 41, 42, 43, 44, 46, 48, 49, 51, 52, 55, 56, 58, 60, 61, 62, 63, 68, 69, 70, 72, 73, 76, 77, 78, 79, 80, 81, 82, 83, 84, 86, 88, 89, 90, 92, 93, 94, 95, 96, 97, 98, 99, 100, 101, 102, 103, 107, 111, 113, 115, 116, 117, 119, 120, 121, 122, 123, 125, 126, 127, 128, 129, 131, 132, 133, 134, 136, 137, 139, 140, 141, 142, 143, 144, 145, 150, 151, 152, 153, 154, 155, 157, 159, 161, 162, 163, 164, 165, 166, 167, 168, 169, 170, 171, 172, 173, 174, 175, 176, 177, 179, 180, 181, 182, 183, 184, 185, 188, 189, 192, 194, 196, 198, 199, 201, 202, 203, 204, 205, 206, 207, 208, 210, 211, 212, 213, 214, 215, 216, 217, 218, 219, 220, 221, 222, 224, 225, 226, 228, 229, 231, 232, 233, 234, 235, 237, 238, 239, 240, 242, 243, 245, 248, 249, 250, 252, 253, 257, 258, 260, 261, 262, 263, 264, 265, 268, 269, 270, 271, 272, 273, 274, 275, 277, 278, 279, 281, 282, 283, 286, 288, 290, 293, 294, 296, 297, 298, 299, 300, 301, 302, 303, 305, 308, 310, 311, 313, 317, 318, 320, 321, 323, 324, 326, 327, 328, 329, 331, 332, 333, 335, 337, 338, 339, 340, 341, 342, 343, 344, 345, 347, 349, 350, 352, 353, 355, 356, 357, 358, 359, 361, 364, 366, 367, 368, 370, 371, 372, 375, 376, 377, 379, 380, 381, 383, 385, 386, 387, 388, 389, 390, 391, 392, 393, 394, 395, 397, 398, 399, 400, 401, 404, 405, 406, 408, 409, 410, 411, 414, 415, 416, 417, 418, 419, 420, 421, 422, 424, 425, 427, 429, 430, 431, 432, 433, 434, 435, 436, 437, 438, 439, 441, 445, 446, 447, 449, 451, 453, 456, 457, 460, 461, 462, 463, 466, 467, 469, 471, 473, 475, 476, 478, 480, 482, 483, 485, 488, 489, 490, 491, 492, 493, 494, 498, 499, 500, 501, 504, 506, 507, 508, 509, 512, 513, 514, 515, 516, 517, 518, 520, 523, 526, 527, 529, 530, 532, 533, 536, 538, 539, 540, 543, 544, 546, 548, 549, 550, 551, 552, 553, 554, 555, 556, 557, 558, 560, 561, 563, 564, 565, 566, 568, 575, 576, 580, 582, 584, 585, 586, 587, 588, 589, 590, 591, 593, 594, 595, 598, 600, 602, 604, 605, 606, 609, 610, 611, 612, 613, 614, 615, 616, 618, 620, 621, 622, 624, 626, 627, 628, 629, 630, 631, 632, 633, 636, 637, 638, 639, 640, 641, 642, 643, 645, 646, 649, 650, 651, 652, 656, 657, 658, 659, 660, 663, 664, 665, 666, 667, 668, 671, 673, 674, 675, 676, 677, 678, 679, 682, 683, 684, 685, 687, 688, 689, 690, 691, 693, 694, 695, 696, 697, 699, 700, 703, 705, 706, 707, 708, 711, 712, 713, 714, 715, 716, 717, 719, 720, 722, 723, 724, 725, 727, 728, 729, 730, 731, 733, 738, 740, 741, 744, 745, 747, 749, 750, 751, 752, 754, 756, 759, 760, 761, 762, 763, 764, 766, 767, 768, 769, 770, 771, 776, 779, 782, 785, 786, 787, 789, 790, 791, 792, 793, 794, 800, 801, 802, 803, 804, 805, 806, 808, 809, 810, 811, 812, 813, 814, 816, 818, 819, 821, 822, 825, 826, 827, 828, 829, 831, 832, 834, 835, 836, 838, 840, 842, 843, 844, 845, 846, 847, 848, 849, 850, 851, 852, 854, 855, 861, 862, 863, 864, 865, 866, 867, 868, 869, 870, 872, 874, 875, 876, 878, 879, 881, 882, 883, 884, 885, 886, 887, 888]
[12, 15, 31, 41, 47, 66, 70, 71, 77, 80, 96, 107, 122, 126, 128, 130, 153, 154, 156, 161, 166, 174, 176, 226, 229, 233, 237, 247, 251, 267, 275, 285, 297, 305, 309, 315, 329, 334, 336, 339, 342, 350, 356, 371, 382, 388, 396, 400, 414, 416, 426, 428, 448, 452, 453, 456, 481, 484, 498, 501, 515, 519, 524, 527, 528, 529, 532, 535, 536, 540, 544, 554, 558, 562, 568, 569, 573, 585, 587, 590, 599, 603, 604, 609, 610, 625, 629, 633, 639, 649, 662, 677, 687, 689, 690, 696, 713, 715, 721, 726, 727, 730, 736, 739, 745, 748, 753, 771, 772, 775, 778, 779, 813, 814, 818, 821, 831, 832, 838, 863, 880, 889]

[0, 1, 2, 4, 5, 6, 7, 8, 9, 10, 11, 13, 14, 15, 16, 17, 18, 19, 20, 21, 22, 23, 24, 25, 26, 28, 29, 30, 31, 32, 33, 35, 36, 37, 38, 39, 40, 41, 42, 43, 44, 46, 48, 49, 51, 52, 55, 56, 57, 58, 60, 61, 62, 63, 65, 67, 68, 69, 70, 72, 73, 76, 77, 78, 79, 80, 81, 82, 83, 84, 85, 86, 88, 89, 90, 92, 93, 94, 95, 96, 97, 98, 99, 100, 101, 102, 103, 105, 107, 109, 110, 111, 112, 113, 115, 116, 117, 119, 120, 121, 122, 123, 125, 126, 127, 128, 129, 131, 132, 133, 134, 136, 137, 139, 140, 141, 142, 143, 144, 145, 150, 151, 152, 153, 154, 155, 157, 159, 161, 162, 163, 164, 165, 166, 167, 168, 169, 170, 171, 172, 173, 174, 175, 176, 177, 179, 180, 181, 182, 183, 184, 185, 186, 188, 189, 191, 192, 194, 196, 198, 199, 200, 201, 202, 203, 204, 205, 206, 207, 208, 210, 211, 212, 213, 214, 215, 216, 217, 218, 219, 220, 221, 222, 224, 225, 226, 228, 229, 230, 231, 232, 233, 234, 235, 237, 238, 239, 240, 241, 242, 243, 245, 246, 247, 248, 249, 250, 251, 252, 253, 257, 258, 260, 261, 262, 263, 264, 265, 266, 267, 268, 269, 270, 271, 272, 273, 274, 275, 277, 278, 279, 281, 282, 283, 284, 285, 286, 288, 290, 293, 294, 295, 296, 297, 298, 299, 300, 301, 302, 303, 305, 306, 308, 310, 311, 313, 316, 317, 318, 320, 321, 323, 324, 326, 327, 328, 329, 331, 332, 333, 334, 335, 337, 338, 339, 340, 341, 342, 343, 344, 345, 347, 349, 350, 352, 353, 354, 355, 356, 357, 358, 359, 360, 361, 364, 366, 367, 368, 370, 371, 372, 375, 376, 377, 379, 380, 381, 383, 385, 386, 387, 388, 389, 390, 391, 392, 393, 394, 395, 397, 398, 399, 400, 401, 404, 405, 406, 408, 409, 410, 411, 413, 414, 415, 416, 417, 418, 419, 420, 421, 422, 423, 424, 425, 426, 427, 429, 430, 431, 432, 433, 434, 435, 436, 437, 438, 439, 440, 441, 445, 446, 447, 449, 451, 453, 455, 456, 457, 460, 461, 462, 463, 466, 467, 468, 469, 470, 471, 473, 475, 476, 477, 478, 479, 480, 482, 483, 485, 487, 488, 489, 490, 491, 492, 493, 494, 496, 497, 498, 499, 500, 501, 503, 504, 505, 506, 507, 508, 509, 510, 511, 512, 513, 514, 515, 516, 517, 518, 520, 523, 525, 526, 527, 529, 530, 532, 533, 534, 535, 536, 538, 539, 540, 543, 544, 546, 548, 549, 550, 551, 552, 553, 554, 555, 556, 557, 558, 560, 561, 563, 564, 565, 566, 567, 568, 569, 572, 574, 575, 576, 578, 580, 582, 584, 585, 586, 587, 588, 589, 590, 591, 593, 594, 595, 597, 598, 600, 602, 603, 604, 605, 606, 607, 608, 609, 610, 611, 612, 613, 614, 615, 616, 618, 620, 621, 622, 624, 626, 627, 628, 629, 630, 631, 632, 633, 636, 637, 638, 639, 640, 641, 642, 643, 644, 645, 646, 649, 650, 651, 652, 656, 657, 658, 659, 660, 661, 662, 663, 664, 665, 666, 667, 668, 670, 671, 673, 674, 675, 676, 677, 678, 679, 682, 683, 684, 685, 687, 688, 689, 690, 691, 692, 693, 694, 695, 696, 697, 699, 700, 703, 705, 706, 707, 708, 709, 710, 711, 712, 713, 714, 715, 716, 717, 718, 719, 720, 722, 723, 724, 725, 727, 728, 729, 730, 731, 733, 738, 739, 740, 741, 744, 745, 747, 749, 750, 751, 752, 753, 754, 756, 757, 759, 760, 761, 762, 763, 764, 765, 766, 767, 768, 769, 770, 771, 776, 777, 779, 781, 782, 785, 786, 787, 788, 789, 790, 791, 792, 793, 794, 795, 796, 800, 801, 802, 803, 804, 805, 806, 808, 809, 810, 811, 812, 813, 814, 816, 817, 818, 819, 821, 822, 825, 826, 827, 828, 829, 831, 832, 833, 834, 835, 836, 837, 838, 840, 842, 843, 844, 845, 846, 847, 848, 849, 850, 851, 852, 853, 854, 855, 856, 858, 859, 861, 862, 863, 864, 865, 866, 867, 868, 869, 870, 871, 872, 874, 875, 876, 878, 879, 881, 882, 883, 884, 885, 886, 887, 888]
[12, 15, 31, 41, 47, 66, 70, 71, 77, 80, 96, 107, 122, 126, 128, 130, 153, 154, 156, 161, 166, 174, 176, 226, 229, 233, 237, 247, 251, 267, 275, 285, 297, 305, 309, 315, 329, 334, 336, 339, 342, 350, 356, 371, 382, 388, 396, 400, 414, 416, 426, 428, 448, 452, 453, 456, 481, 484, 498, 501, 515, 519, 524, 527, 528, 529, 532, 535, 536, 540, 544, 554, 558, 562, 568, 569, 573, 585, 587, 590, 599, 603, 604, 609, 610, 625, 629, 633, 639, 649, 662, 677, 687, 689, 690, 696, 713, 715, 721, 726, 727, 730, 736, 739, 745, 748, 753, 771, 772, 775, 778, 779, 813, 814, 818, 821, 831, 832, 838, 863, 880, 889]

[0, 1, 2, 4, 5, 6, 7, 8, 9, 10, 11, 12, 13, 14, 15, 16, 17, 18, 19, 20, 21, 22, 23, 24, 25, 26, 28, 29, 30, 31, 32, 33, 35, 36, 37, 38, 39, 40, 41, 42, 43, 44, 46, 47, 48, 49, 50, 51, 52, 55, 56, 57, 58, 59, 60, 61, 62, 63, 64, 65, 66, 67, 68, 69, 70, 71, 72, 73, 75, 76, 77, 78, 79, 80, 81, 82, 83, 84, 85, 86, 88, 89, 90, 91, 92, 93, 94, 95, 96, 97, 98, 99, 100, 101, 102, 103, 104, 105, 106, 107, 109, 110, 111, 112, 113, 115, 116, 117, 118, 119, 120, 121, 122, 123, 124, 125, 126, 127, 128, 129, 131, 132, 133, 134, 136, 137, 139, 140, 141, 142, 143, 144, 145, 146, 150, 151, 152, 153, 154, 155, 157, 158, 159, 161, 162, 163, 164, 165, 166, 167, 168, 169, 170, 171, 172, 173, 174, 175, 176, 177, 179, 180, 181, 182, 183, 184, 185, 186, 188, 189, 191, 192, 194, 195, 196, 197, 198, 199, 200, 201, 202, 203, 204, 205, 206, 207, 208, 210, 211, 212, 213, 214, 215, 216, 217, 218, 219, 220, 221, 222, 224, 225, 226, 228, 229, 230, 231, 232, 233, 234, 235, 237, 238, 239, 240, 241, 242, 243, 245, 246, 247, 248, 249, 250, 251, 252, 253, 255, 257, 258, 259, 260, 261, 262, 263, 264, 265, 266, 267, 268, 269, 270, 271, 272, 273, 274, 275, 277, 278, 279, 281, 282, 283, 284, 285, 286, 288, 289, 290, 292, 293, 294, 295, 296, 297, 298, 299, 300, 301, 302, 303, 304, 305, 306, 308, 309, 310, 311, 313, 316, 317, 318, 319, 320, 321, 323, 324, 326, 327, 328, 329, 330, 331, 332, 333, 334, 335, 336, 337, 338, 339, 340, 341, 342, 343, 344, 345, 346, 347, 349, 350, 352, 353, 354, 355, 356, 357, 358, 359, 360, 361, 363, 364, 366, 367, 368, 370, 371, 372, 373, 375, 376, 377, 379, 380, 381, 383, 385, 386, 387, 388, 389, 390, 391, 392, 393, 394, 395, 397, 398, 399, 400, 401, 403, 404, 405, 406, 408, 409, 410, 411, 413, 414, 415, 416, 417, 418, 419, 420, 421, 422, 423, 424, 425, 426, 427, 428, 429, 430, 431, 432, 433, 434, 435, 436, 437, 438, 439, 440, 441, 442, 443, 445, 446, 447, 449, 450, 451, 452, 453, 454, 455, 456, 457, 459, 460, 461, 462, 463, 466, 467, 468, 469, 470, 471, 473, 474, 475, 476, 477, 478, 479, 480, 482, 483, 485, 486, 487, 488, 489, 490, 491, 492, 493, 494, 496, 497, 498, 499, 500, 501, 503, 504, 505, 506, 507, 508, 509, 510, 511, 512, 513, 514, 515, 516, 517, 518, 519, 520, 521, 522, 523, 525, 526, 527, 528, 529, 530, 531, 532, 533, 534, 535, 536, 537, 538, 539, 540, 541, 542, 543, 544, 546, 547, 548, 549, 550, 551, 552, 553, 554, 555, 556, 557, 558, 559, 560, 561, 563, 564, 565, 566, 567, 568, 569, 571, 572, 574, 575, 576, 578, 580, 582, 583, 584, 585, 586, 587, 588, 589, 590, 591, 593, 594, 595, 597, 598, 600, 602, 603, 604, 605, 606, 607, 608, 609, 610, 611, 612, 613, 614, 615, 616, 618, 619, 620, 621, 622, 623, 624, 626, 627, 628, 629, 630, 631, 632, 633, 636, 637, 638, 639, 640, 641, 642, 643, 644, 645, 646, 649, 650, 651, 652, 653, 654, 656, 657, 658, 659, 660, 661, 662, 663, 664, 665, 666, 667, 668, 670, 671, 673, 674, 675, 676, 677, 678, 679, 680, 682, 683, 684, 685, 687, 688, 689, 690, 691, 692, 693, 694, 695, 696, 697, 699, 700, 701, 702, 703, 704, 705, 706, 707, 708, 709, 710, 711, 712, 713, 714, 715, 716, 717, 718, 719, 720, 722, 723, 724, 725, 727, 728, 729, 730, 731, 733, 734, 735, 738, 739, 740, 741, 744, 745, 746, 747, 748, 749, 750, 751, 752, 753, 754, 756, 757, 758, 759, 760, 761, 762, 763, 764, 765, 766, 767, 768, 769, 770, 771, 772, 774, 775, 776, 777, 778, 779, 780, 781, 782, 784, 785, 786, 787, 788, 789, 790, 791, 792, 793, 794, 795, 796, 800, 801, 802, 803, 804, 805, 806, 807, 808, 809, 810, 811, 812, 813, 814, 816, 817, 818, 819, 821, 822, 823, 825, 826, 827, 828, 829, 831, 832, 833, 834, 835, 836, 837, 838, 839, 840, 842, 843, 844, 845, 846, 847, 848, 849, 850, 851, 852, 853, 854, 855, 856, 858, 859, 861, 862, 863, 864, 865, 866, 867, 868, 869, 870, 871, 872, 874, 875, 876, 877, 878, 879, 880, 881, 882, 883, 884, 885, 886, 887, 888]
[12, 15, 31, 41, 47, 66, 70, 71, 77, 80, 96, 107, 122, 126, 128, 130, 153, 154, 156, 161, 166, 174, 176, 226, 229, 233, 237, 247, 251, 267, 275, 285, 297, 305, 309, 315, 329, 334, 336, 339, 342, 350, 356, 371, 382, 388, 396, 400, 414, 416, 426, 428, 448, 452, 453, 456, 481, 484, 498, 501, 515, 519, 524, 527, 528, 529, 532, 535, 536, 540, 544, 554, 558, 562, 568, 569, 573, 585, 587, 590, 599, 603, 604, 609, 610, 625, 629, 633, 639, 649, 662, 677, 687, 689, 690, 696, 713, 715, 721, 726, 727, 730, 736, 739, 745, 748, 753, 771, 772, 775, 778, 779, 813, 814, 818, 821, 831, 832, 838, 863, 880, 889]

