[4, 58, 69, 74, 113, 123, 141, 144, 149, 154, 200, 201, 227, 275, 293, 327, 366, 372, 484, 545, 560, 755]
[13, 111, 122, 168, 172, 184, 187, 218, 285, 318, 388, 417, 424, 442, 444, 620, 628, 712, 721, 734, 805, 811]

[4, 58, 69, 74, 113, 123, 141, 144, 149, 154, 200, 201, 227, 275, 293, 327, 366, 372, 484, 545, 560, 755]
[2, 13, 19, 20, 21, 29, 35, 61, 66, 82, 88, 90, 98, 99, 111, 122, 127, 130, 142, 145, 160, 162, 164, 165, 168, 169, 172, 173, 184, 187, 189, 198, 216, 217, 218, 229, 239, 251, 273, 277, 285, 294, 318, 332, 340, 365, 374, 377, 388, 400, 403, 416, 417, 424, 428, 439, 442, 444, 452, 460, 463, 469, 472, 476, 481, 501, 514, 535, 539, 544, 554, 563, 568, 573, 589, 594, 596, 598, 599, 607, 609, 620, 628, 654, 659, 661, 677, 683, 693, 695, 698, 702, 705, 708, 710, 712, 714, 719, 721, 732, 734, 746, 748, 752, 756, 785, 786, 800, 805, 809, 811, 816, 823, 834, 836, 838, 839, 842, 846, 865, 866, 884]

[4, 24, 38, 53, 55, 58, 61, 64, 69, 74, 98, 113, 123, 141, 144, 149, 150, 154, 200, 201, 204, 214, 219, 227, 231, 232, 245, 275, 276, 281, 283, 293, 321, 322, 327, 332, 339, 344, 345, 366, 371, 372, 377, 379, 381, 384, 390, 394, 405, 412, 418, 421, 453, 468, 475, 480, 484, 487, 516, 521, 535, 537, 545, 552, 553, 560, 568, 570, 581, 592, 596, 599, 607, 617, 619, 626, 665, 667, 668, 684, 691, 696, 718, 727, 732, 748, 755, 761, 764, 772, 777, 785, 795, 857, 861, 865, 870]
[2, 13, 19, 20, 21, 29, 35, 61, 66, 82, 88, 90, 98, 99, 111, 122, 127, 130, 142, 145, 160, 162, 164, 165, 168, 169, 172, 173, 184, 187, 189, 198, 216, 217, 218, 229, 239, 251, 273, 277, 285, 294, 318, 332, 340, 365, 374, 377, 388, 400, 403, 416, 417, 424, 428, 439, 442, 444, 452, 460, 463, 469, 472, 476, 481, 501, 514, 535, 539, 544, 554, 563, 568, 573, 589, 594, 596, 598, 599, 607, 609, 620, 628, 654, 659, 661, 677, 683, 693, 695, 698, 702, 705, 708, 710, 712, 714, 719, 721, 732, 734, 746, 748, 752, 756, 785, 786, 800, 805, 809, 811, 816, 823, 834, 836, 838, 839, 842, 846, 865, 866, 884]

[4, 6, 8, 22, 24, 30, 38, 45, 51, 53, 55, 58, 61, 64, 69, 74, 83, 94, 98, 107, 113, 114, 123, 125, 140, 141, 144, 149, 150, 154, 159, 162, 163, 200, 201, 204, 206, 209, 214, 215, 219, 221, 227, 229, 231, 232, 245, 248, 255, 273, 274, 275, 276, 281, 283, 293, 298, 311, 321, 322, 327, 330, 332, 335, 339, 342, 344, 345, 351, 366, 368, 371, 372, 377, 379, 381, 384, 390, 394, 396, 399, 405, 412, 418, 421, 444, 446, 453, 460, 468, 475, 480, 484, 487, 501, 514, 516, 521, 523, 526, 535, 537, 541, 545, 546, 552, 553, 558, 560, 568, 570, 577, 581, 582, 586, 589, 592, 596, 599, 607, 617, 619, 626, 632, 643, 644, 645, 650, 662, 664, 665, 667, 668, 684, 687, 691, 694, 696, 718, 725, 727, 728, 731, 732, 748, 749, 754, 755, 756, 761, 764, 766, 772, 777, 782, 785, 791, 795, 829, 831, 835, 836, 847, 857, 861, 865, 870, 873, 876, 878, 883, 888]
[2, 13, 19, 20, 21, 29, 35, 61, 66, 82, 88, 90, 98, 99, 111, 122, 127, 130, 142, 145, 160, 162, 164, 165, 168, 169, 172, 173, 184, 187, 189, 198, 216, 217, 218, 229, 239, 251, 273, 277, 285, 294, 318, 332, 340, 365, 374, 377, 388, 400, 403, 416, 417, 424, 428, 439, 442, 444, 452, 460, 463, 469, 472, 476, 481, 501, 514, 535, 539, 544, 554, 563, 568, 573, 589, 594, 596, 598, 599, 607, 609, 620, 628, 654, 659, 661, 677, 683, 693, 695, 698, 702, 705, 708, 710, 712, 714, 719, 721, 732, 734, 746, 748, 752, 756, 785, 786, 800, 805, 809, 811, 816, 823, 834, 836, 838, 839, 842, 846, 865, 866, 884]

[0, 4, 6, 8, 10, 22, 24, 30, 32, 38, 45, 50, 51, 53, 55, 58, 61, 64, 69, 74, 83, 87, 91, 94, 95, 96, 98, 103, 107, 109, 110, 111, 113, 114, 119, 123, 125, 128, 132, 137, 140, 141, 142, 144, 145, 149, 150, 154, 157, 159, 162, 163, 165, 166, 177, 184, 199, 200, 201, 203, 204, 205, 206, 209, 214, 215, 219, 221, 222, 227, 229, 230, 231, 232, 233, 236, 239, 245, 248, 250, 255, 260, 268, 273, 274, 275, 276, 281, 283, 289, 293, 298, 308, 311, 313, 321, 322, 326, 327, 330, 332, 335, 339, 342, 343, 344, 345, 351, 364, 366, 368, 371, 372, 377, 379, 381, 384, 390, 394, 396, 399, 403, 405, 412, 418, 421, 424, 434, 444, 446, 453, 460, 468, 475, 480, 484, 485, 487, 490, 493, 501, 514, 516, 519, 521, 523, 526, 535, 537, 539, 541, 545, 546, 548, 552, 553, 558, 560, 568, 570, 575, 577, 581, 582, 586, 589, 592, 596, 599, 606, 607, 617, 618, 619, 620, 621, 626, 632, 634, 643, 644, 645, 650, 653, 657, 662, 664, 665, 667, 668, 684, 687, 690, 691, 692, 694, 696, 716, 718, 725, 727, 728, 729, 730, 731, 732, 743, 748, 749, 754, 755, 756, 758, 761, 764, 766, 772, 776, 777, 781, 782, 785, 787, 788, 791, 795, 809, 812, 816, 829, 831, 835, 836, 841, 847, 857, 861, 865, 870, 873, 874, 876, 878, 880, 883, 886, 888]
[2, 13, 19, 20, 21, 29, 35, 61, 66, 82, 88, 90, 98, 99, 111, 122, 127, 130, 142, 145, 160, 162, 164, 165, 168, 169, 172, 173, 184, 187, 189, 198, 216, 217, 218, 229, 239, 251, 273, 277, 285, 294, 318, 332, 340, 365, 374, 377, 388, 400, 403, 416, 417, 424, 428, 439, 442, 444, 452, 460, 463, 469, 472, 476, 481, 501, 514, 535, 539, 544, 554, 563, 568, 573, 589, 594, 596, 598, 599, 607, 609, 620, 628, 654, 659, 661, 677, 683, 693, 695, 698, 702, 705, 708, 710, 712, 714, 719, 721, 732, 734, 746, 748, 752, 756, 785, 786, 800, 805, 809, 811, 816, 823, 834, 836, 838, 839, 842, 846, 865, 866, 884]

[0, 3, 4, 6, 8, 10, 14, 16, 17, 19, 21, 22, 24, 28, 30, 31, 32, 38, 45, 49, 50, 51, 53, 55, 58, 61, 64, 68, 69, 72, 74, 75, 81, 83, 87, 91, 94, 95, 96, 98, 100, 102, 103, 107, 109, 110, 111, 113, 114, 119, 123, 124, 125, 128, 129, 130, 131, 132, 137, 140, 141, 142, 144, 145, 147, 149, 150, 154, 157, 159, 162, 163, 165, 166, 168, 175, 177, 180, 184, 199, 200, 201, 203, 204, 205, 206, 209, 214, 215, 216, 219, 220, 221, 222, 227, 228, 229, 230, 231, 232, 233, 235, 236, 239, 240, 243, 245, 247, 248, 250, 255, 259, 260, 268, 273, 274, 275, 276, 281, 283, 289, 293, 296, 297, 298, 307, 308, 311, 312, 313, 321, 322, 326, 327, 330, 332, 335, 339, 342, 343, 344, 345, 347, 351, 364, 366, 368, 371, 372, 376, 377, 379, 381, 384, 386, 389, 390, 394, 395, 396, 399, 403, 404, 405, 412, 418, 421, 423, 424, 434, 444, 446, 453, 460, 468, 475, 480, 484, 485, 487, 490, 493, 501, 502, 510, 514, 516, 519, 521, 523, 524, 526, 530, 535, 537, 539, 541, 545, 546, 548, 552, 553, 558, 560, 563, 565, 568, 570, 574, 575, 577, 581, 582, 584, 586, 589, 592, 593, 596, 599, 600, 606, 607, 617, 618, 619, 620, 621, 626, 630, 632, 634, 640, 643, 644, 645, 649, 650, 653, 654, 657, 662, 664, 665, 666, 667, 668, 669, 670, 671, 683, 684, 687, 690, 691, 692, 693, 694, 695, 696, 705, 713, 716, 718, 720, 725, 727, 728, 729, 730, 731, 732, 743, 745, 748, 749, 754, 755, 756, 758, 761, 764, 766, 772, 776, 777, 778, 781, 782, 785, 786, 787, 788, 791, 795, 796, 803, 809, 812, 816, 817, 829, 831, 835, 836, 837, 839, 840, 841, 847, 857, 861, 865, 870, 873, 874, 876, 878, 880, 883, 886, 888]
[2, 13, 19, 20, 21, 29, 35, 61, 66, 82, 88, 90, 98, 99, 111, 122, 127, 130, 142, 145, 160, 162, 164, 165, 168, 169, 172, 173, 184, 187, 189, 198, 216, 217, 218, 229, 239, 251, 273, 277, 285, 294, 318, 332, 340, 365, 374, 377, 388, 400, 403, 416, 417, 424, 428, 439, 442, 444, 452, 460, 463, 469, 472, 476, 481, 501, 514, 535, 539, 544, 554, 563, 568, 573, 589, 594, 596, 598, 599, 607, 609, 620, 628, 654, 659, 661, 677, 683, 693, 695, 698, 702, 705, 708, 710, 712, 714, 719, 721, 732, 734, 746, 748, 752, 756, 785, 786, 800, 805, 809, 811, 816, 823, 834, 836, 838, 839, 842, 846, 865, 866, 884]

[0, 3, 4, 6, 8, 10, 12, 14, 16, 17, 19, 20, 21, 22, 24, 28, 30, 31, 32, 37, 38, 42, 45, 46, 49, 50, 51, 53, 55, 58, 61, 64, 68, 69, 72, 73, 74, 75, 78, 81, 83, 87, 90, 91, 94, 95, 96, 98, 100, 102, 103, 107, 109, 110, 111, 112, 113, 114, 119, 123, 124, 125, 128, 129, 130, 131, 132, 134, 137, 140, 141, 142, 144, 145, 147, 148, 149, 150, 154, 156, 157, 159, 162, 163, 165, 166, 167, 168, 173, 175, 177, 180, 181, 183, 184, 199, 200, 201, 203, 204, 205, 206, 209, 214, 215, 216, 218, 219, 220, 221, 222, 227, 228, 229, 230, 231, 232, 233, 234, 235, 236, 237, 239, 240, 241, 243, 245, 247, 248, 250, 255, 259, 260, 266, 268, 271, 272, 273, 274, 275, 276, 281, 283, 289, 293, 296, 297, 298, 305, 307, 308, 311, 312, 313, 318, 321, 322, 326, 327, 330, 332, 334, 335, 339, 341, 342, 343, 344, 345, 346, 347, 351, 359, 364, 365, 366, 368, 371, 372, 376, 377, 379, 381, 382, 384, 386, 389, 390, 394, 395, 396, 399, 403, 404, 405, 408, 411, 412, 416, 418, 421, 423, 424, 427, 434, 436, 443, 444, 446, 453, 460, 468, 475, 479, 480, 484, 485, 487, 490, 491, 493, 496, 501, 502, 510, 514, 515, 516, 518, 519, 521, 522, 523, 524, 526, 530, 531, 533, 535, 537, 539, 541, 545, 546, 548, 552, 553, 558, 560, 563, 565, 568, 569, 570, 574, 575, 577, 578, 581, 582, 584, 586, 587, 589, 590, 592, 593, 596, 598, 599, 600, 605, 606, 607, 610, 617, 618, 619, 620, 621, 626, 630, 632, 633, 634, 637, 640, 641, 643, 644, 645, 649, 650, 652, 653, 654, 657, 659, 661, 662, 664, 665, 666, 667, 668, 669, 670, 671, 676, 683, 684, 687, 688, 690, 691, 692, 693, 694, 695, 696, 698, 705, 707, 709, 713, 716, 718, 719, 720, 725, 727, 728, 729, 730, 731, 732, 743, 745, 747, 748, 749, 750, 754, 755, 756, 758, 761, 764, 766, 772, 776, 777, 778, 781, 782, 785, 786, 787, 788, 789, 791, 795, 796, 800, 803, 807, 809, 812, 816, 817, 820, 829, 831, 835, 836, 837, 838, 839, 840, 841, 844, 847, 853, 857, 861, 865, 870, 871, 873, 874, 876, 877, 878, 880, 883, 886, 888]
[2, 13, 19, 20, 21, 29, 35, 61, 66, 82, 88, 90, 98, 99, 111, 122, 127, 130, 142, 145, 160, 162, 164, 165, 168, 169, 172, 173, 184, 187, 189, 198, 216, 217, 218, 229, 239, 251, 273, 277, 285, 294, 318, 332, 340, 365, 374, 377, 388, 400, 403, 416, 417, 424, 428, 439, 442, 444, 452, 460, 463, 469, 472, 476, 481, 501, 514, 535, 539, 544, 554, 563, 568, 573, 589, 594, 596, 598, 599, 607, 609, 620, 628, 654, 659, 661, 677, 683, 693, 695, 698, 702, 705, 708, 710, 712, 714, 719, 721, 732, 734, 746, 748, 752, 756, 785, 786, 800, 805, 809, 811, 816, 823, 834, 836, 838, 839, 842, 846, 865, 866, 884]

[0, 3, 4, 6, 7, 8, 10, 12, 14, 16, 17, 19, 20, 21, 22, 24, 28, 30, 31, 32, 37, 38, 42, 45, 46, 49, 50, 51, 53, 55, 58, 59, 61, 63, 64, 67, 68, 69, 71, 72, 73, 74, 75, 78, 79, 81, 83, 87, 88, 90, 91, 94, 95, 96, 97, 98, 100, 102, 103, 107, 108, 109, 110, 111, 112, 113, 114, 118, 119, 123, 124, 125, 126, 128, 129, 130, 131, 132, 134, 135, 137, 138, 140, 141, 142, 143, 144, 145, 147, 148, 149, 150, 154, 156, 157, 159, 162, 163, 165, 166, 167, 168, 169, 172, 173, 175, 177, 180, 181, 183, 184, 193, 199, 200, 201, 203, 204, 205, 206, 209, 211, 214, 215, 216, 218, 219, 220, 221, 222, 227, 228, 229, 230, 231, 232, 233, 234, 235, 236, 237, 239, 240, 241, 242, 243, 245, 246, 247, 248, 250, 253, 254, 255, 259, 260, 266, 268, 271, 272, 273, 274, 275, 276, 278, 279, 280, 281, 283, 289, 293, 296, 297, 298, 305, 307, 308, 311, 312, 313, 316, 318, 319, 321, 322, 326, 327, 329, 330, 332, 334, 335, 337, 338, 339, 341, 342, 343, 344, 345, 346, 347, 349, 351, 352, 356, 358, 359, 364, 365, 366, 368, 371, 372, 373, 376, 377, 379, 380, 381, 382, 384, 386, 388, 389, 390, 394, 395, 396, 399, 403, 404, 405, 408, 411, 412, 416, 418, 421, 423, 424, 427, 431, 434, 436, 441, 443, 444, 446, 449, 451, 453, 460, 468, 475, 478, 479, 480, 482, 484, 485, 487, 490, 491, 493, 496, 498, 499, 501, 502, 510, 511, 514, 515, 516, 517, 518, 519, 520, 521, 522, 523, 524, 526, 529, 530, 531, 533, 535, 537, 539, 541, 542, 545, 546, 547, 548, 551, 552, 553, 555, 558, 560, 563, 564, 565, 568, 569, 570, 572, 574, 575, 577, 578, 581, 582, 584, 586, 587, 589, 590, 591, 592, 593, 595, 596, 598, 599, 600, 605, 606, 607, 610, 617, 618, 619, 620, 621, 624, 626, 630, 632, 633, 634, 637, 640, 641, 643, 644, 645, 647, 649, 650, 652, 653, 654, 656, 657, 659, 660, 661, 662, 664, 665, 666, 667, 668, 669, 670, 671, 676, 681, 683, 684, 687, 688, 690, 691, 692, 693, 694, 695, 696, 698, 705, 706, 707, 708, 709, 711, 712, 713, 716, 718, 719, 720, 721, 725, 727, 728, 729, 730, 731, 732, 743, 745, 747, 748, 749, 750, 751, 752, 754, 755, 756, 757, 758, 760, 761, 764, 765, 766, 772, 776, 777, 778, 781, 782, 783, 785, 786, 787, 788, 789, 791, 795, 796, 800, 803, 807, 809, 812, 816, 817, 820, 823, 829, 831, 835, 836, 837, 838, 839, 840, 841, 844, 847, 849, 851, 853, 854, 857, 861, 865, 870, 871, 873, 874, 876, 877, 878, 880, 883, 886, 888]
[2, 13, 19, 20, 21, 29, 35, 61, 66, 82, 88, 90, 98, 99, 111, 122, 127, 130, 142, 145, 160, 162, 164, 165, 168, 169, 172, 173, 184, 187, 189, 198, 216, 217, 218, 229, 239, 251, 273, 277, 285, 294, 318, 332, 340, 365, 374, 377, 388, 400, 403, 416, 417, 424, 428, 439, 442, 444, 452, 460, 463, 469, 472, 476, 481, 501, 514, 535, 539, 544, 554, 563, 568, 573, 589, 594, 596, 598, 599, 607, 609, 620, 628, 654, 659, 661, 677, 683, 693, 695, 698, 702, 705, 708, 710, 712, 714, 719, 721, 732, 734, 746, 748, 752, 756, 785, 786, 800, 805, 809, 811, 816, 823, 834, 836, 838, 839, 842, 846, 865, 866, 884]

[0, 3, 4, 6, 7, 8, 9, 10, 12, 14, 16, 17, 19, 20, 21, 22, 24, 28, 30, 31, 32, 37, 38, 39, 42, 45, 46, 49, 50, 51, 53, 55, 58, 59, 61, 62, 63, 64, 67, 68, 69, 70, 71, 72, 73, 74, 75, 78, 79, 81, 83, 87, 88, 90, 91, 94, 95, 96, 97, 98, 100, 102, 103, 107, 108, 109, 110, 111, 112, 113, 114, 118, 119, 123, 124, 125, 126, 128, 129, 130, 131, 132, 134, 135, 137, 138, 140, 141, 142, 143, 144, 145, 146, 147, 148, 149, 150, 151, 152, 153, 154, 156, 157, 159, 162, 163, 164, 165, 166, 167, 168, 169, 171, 172, 173, 175, 177, 180, 181, 183, 184, 193, 194, 199, 200, 201, 202, 203, 204, 205, 206, 209, 210, 211, 212, 214, 215, 216, 218, 219, 220, 221, 222, 227, 228, 229, 230, 231, 232, 233, 234, 235, 236, 237, 239, 240, 241, 242, 243, 245, 246, 247, 248, 250, 253, 254, 255, 259, 260, 261, 266, 268, 271, 272, 273, 274, 275, 276, 278, 279, 280, 281, 283, 286, 289, 293, 296, 297, 298, 304, 305, 306, 307, 308, 311, 312, 313, 314, 316, 318, 319, 321, 322, 324, 326, 327, 328, 329, 330, 332, 334, 335, 336, 337, 338, 339, 341, 342, 343, 344, 345, 346, 347, 349, 351, 352, 354, 356, 357, 358, 359, 364, 365, 366, 368, 371, 372, 373, 375, 376, 377, 379, 380, 381, 382, 384, 385, 386, 388, 389, 390, 394, 395, 396, 398, 399, 401, 403, 404, 405, 406, 408, 411, 412, 414, 416, 418, 421, 423, 424, 427, 431, 434, 436, 439, 441, 443, 444, 446, 447, 449, 451, 453, 456, 460, 463, 465, 468, 474, 475, 478, 479, 480, 481, 482, 484, 485, 487, 488, 490, 491, 492, 493, 495, 496, 498, 499, 500, 501, 502, 508, 510, 511, 512, 514, 515, 516, 517, 518, 519, 520, 521, 522, 523, 524, 525, 526, 529, 530, 531, 533, 535, 537, 539, 541, 542, 545, 546, 547, 548, 550, 551, 552, 553, 554, 555, 558, 560, 561, 562, 563, 564, 565, 566, 568, 569, 570, 572, 574, 575, 577, 578, 581, 582, 584, 586, 587, 589, 590, 591, 592, 593, 595, 596, 598, 599, 600, 602, 605, 606, 607, 610, 617, 618, 619, 620, 621, 624, 626, 630, 632, 633, 634, 637, 640, 641, 643, 644, 645, 647, 648, 649, 650, 652, 653, 654, 656, 657, 658, 659, 660, 661, 662, 664, 665, 666, 667, 668, 669, 670, 671, 672, 676, 680, 681, 683, 684, 687, 688, 690, 691, 692, 693, 694, 695, 696, 698, 703, 705, 706, 707, 708, 709, 711, 712, 713, 715, 716, 718, 719, 720, 721, 722, 724, 725, 727, 728, 729, 730, 731, 732, 742, 743, 745, 747, 748, 749, 750, 751, 752, 754, 755, 756, 757, 758, 760, 761, 762, 764, 765, 766, 767, 771, 772, 776, 777, 778, 781, 782, 783, 785, 786, 787, 788, 789, 791, 792, 793, 795, 796, 799, 800, 803, 807, 809, 811, 812, 814, 816, 817, 820, 823, 829, 831, 833, 835, 836, 837, 838, 839, 840, 841, 844, 846, 847, 849, 851, 853, 854, 857, 860, 861, 864, 865, 867, 869, 870, 871, 873, 874, 875, 876, 877, 878, 879, 880, 883, 884, 886, 888, 889]
[2, 13, 19, 20, 21, 29, 35, 61, 66, 82, 88, 90, 98, 99, 111, 122, 127, 130, 142, 145, 160, 162, 164, 165, 168, 169, 172, 173, 184, 187, 189, 198, 216, 217, 218, 229, 239, 251, 273, 277, 285, 294, 318, 332, 340, 365, 374, 377, 388, 400, 403, 416, 417, 424, 428, 439, 442, 444, 452, 460, 463, 469, 472, 476, 481, 501, 514, 535, 539, 544, 554, 563, 568, 573, 589, 594, 596, 598, 599, 607, 609, 620, 628, 654, 659, 661, 677, 683, 693, 695, 698, 702, 705, 708, 710, 712, 714, 719, 721, 732, 734, 746, 748, 752, 756, 785, 786, 800, 805, 809, 811, 816, 823, 834, 836, 838, 839, 842, 846, 865, 866, 884]

[0, 3, 4, 6, 7, 8, 9, 10, 11, 12, 14, 15, 16, 17, 19, 20, 21, 22, 24, 27, 28, 29, 30, 31, 32, 33, 35, 37, 38, 39, 42, 44, 45, 46, 48, 49, 50, 51, 53, 55, 57, 58, 59, 61, 62, 63, 64, 67, 68, 69, 70, 71, 72, 73, 74, 75, 78, 79, 81, 83, 87, 88, 90, 91, 94, 95, 96, 97, 98, 99, 100, 102, 103, 104, 107, 108, 109, 110, 111, 112, 113, 114, 118, 119, 122, 123, 124, 125, 126, 128, 129, 130, 131, 132, 134, 135, 137, 138, 140, 141, 142, 143, 144, 145, 146, 147, 148, 149, 150, 151, 152, 153, 154, 156, 157, 159, 162, 163, 164, 165, 166, 167, 168, 169, 171, 172, 173, 175, 177, 179, 180, 181, 183, 184, 185, 189, 193, 194, 199, 200, 201, 202, 203, 204, 205, 206, 209, 210, 211, 212, 214, 215, 216, 217, 218, 219, 220, 221, 222, 223, 227, 228, 229, 230, 231, 232, 233, 234, 235, 236, 237, 239, 240, 241, 242, 243, 245, 246, 247, 248, 250, 252, 253, 254, 255, 259, 260, 261, 265, 266, 268, 271, 272, 273, 274, 275, 276, 278, 279, 280, 281, 283, 284, 286, 287, 289, 291, 293, 295, 296, 297, 298, 300, 304, 305, 306, 307, 308, 309, 311, 312, 313, 314, 316, 317, 318, 319, 321, 322, 324, 326, 327, 328, 329, 330, 332, 334, 335, 336, 337, 338, 339, 341, 342, 343, 344, 345, 346, 347, 348, 349, 351, 352, 354, 356, 357, 358, 359, 360, 364, 365, 366, 368, 369, 371, 372, 373, 375, 376, 377, 379, 380, 381, 382, 384, 385, 386, 387, 388, 389, 390, 393, 394, 395, 396, 398, 399, 401, 402, 403, 404, 405, 406, 407, 408, 411, 412, 414, 416, 417, 418, 419, 421, 422, 423, 424, 427, 430, 431, 432, 434, 436, 439, 441, 443, 444, 446, 447, 449, 451, 453, 455, 456, 458, 460, 463, 465, 468, 471, 473, 474, 475, 478, 479, 480, 481, 482, 484, 485, 487, 488, 490, 491, 492, 493, 495, 496, 497, 498, 499, 500, 501, 502, 504, 506, 508, 510, 511, 512, 514, 515, 516, 517, 518, 519, 520, 521, 522, 523, 524, 525, 526, 529, 530, 531, 533, 535, 537, 538, 539, 540, 541, 542, 545, 546, 547, 548, 550, 551, 552, 553, 554, 555, 558, 560, 561, 562, 563, 564, 565, 566, 567, 568, 569, 570, 571, 572, 574, 575, 577, 578, 580, 581, 582, 584, 585, 586, 587, 589, 590, 591, 592, 593, 594, 595, 596, 597, 598, 599, 600, 602, 603, 604, 605, 606, 607, 608, 610, 613, 614, 617, 618, 619, 620, 621, 622, 624, 626, 630, 632, 633, 634, 637, 640, 641, 643, 644, 645, 646, 647, 648, 649, 650, 652, 653, 654, 656, 657, 658, 659, 660, 661, 662, 664, 665, 666, 667, 668, 669, 670, 671, 672, 675, 676, 680, 681, 682, 683, 684, 687, 688, 689, 690, 691, 692, 693, 694, 695, 696, 698, 699, 700, 703, 705, 706, 707, 708, 709, 711, 712, 713, 714, 715, 716, 718, 719, 720, 721, 722, 724, 725, 727, 728, 729, 730, 731, 732, 739, 742, 743, 744, 745, 747, 748, 749, 750, 751, 752, 754, 755, 756, 757, 758, 760, 761, 762, 764, 765, 766, 767, 771, 772, 773, 776, 777, 778, 781, 782, 783, 785, 786, 787, 788, 789, 791, 792, 793, 794, 795, 796, 799, 800, 803, 807, 809, 811, 812, 814, 816, 817, 820, 823, 829, 831, 833, 835, 836, 837, 838, 839, 840, 841, 844, 846, 847, 848, 849, 850, 851, 853, 854, 855, 857, 859, 860, 861, 864, 865, 866, 867, 869, 870, 871, 872, 873, 874, 875, 876, 877, 878, 879, 880, 883, 884, 886, 887, 888, 889]
[2, 13, 19, 20, 21, 29, 35, 61, 66, 82, 88, 90, 98, 99, 111, 122, 127, 130, 142, 145, 160, 162, 164, 165, 168, 169, 172, 173, 184, 187, 189, 198, 216, 217, 218, 229, 239, 251, 273, 277, 285, 294, 318, 332, 340, 365, 374, 377, 388, 400, 403, 416, 417, 424, 428, 439, 442, 444, 452, 460, 463, 469, 472, 476, 481, 501, 514, 535, 539, 544, 554, 563, 568, 573, 589, 594, 596, 598, 599, 607, 609, 620, 628, 654, 659, 661, 677, 683, 693, 695, 698, 702, 705, 708, 710, 712, 714, 719, 721, 732, 734, 746, 748, 752, 756, 785, 786, 800, 805, 809, 811, 816, 823, 834, 836, 838, 839, 842, 846, 865, 866, 884]

[0, 3, 4, 5, 6, 7, 8, 9, 10, 11, 12, 14, 15, 16, 17, 19, 20, 21, 22, 24, 27, 28, 29, 30, 31, 32, 33, 35, 36, 37, 38, 39, 42, 43, 44, 45, 46, 47, 48, 49, 50, 51, 53, 55, 57, 58, 59, 61, 62, 63, 64, 66, 67, 68, 69, 70, 71, 72, 73, 74, 75, 78, 79, 80, 81, 82, 83, 85, 86, 87, 88, 90, 91, 93, 94, 95, 96, 97, 98, 99, 100, 102, 103, 104, 105, 107, 108, 109, 110, 111, 112, 113, 114, 118, 119, 120, 122, 123, 124, 125, 126, 127, 128, 129, 130, 131, 132, 134, 135, 137, 138, 139, 140, 141, 142, 143, 144, 145, 146, 147, 148, 149, 150, 151, 152, 153, 154, 155, 156, 157, 158, 159, 160, 162, 163, 164, 165, 166, 167, 168, 169, 171, 172, 173, 174, 175, 177, 179, 180, 181, 182, 183, 184, 185, 189, 190, 192, 193, 194, 195, 197, 198, 199, 200, 201, 202, 203, 204, 205, 206, 209, 210, 211, 212, 214, 215, 216, 217, 218, 219, 220, 221, 222, 223, 225, 227, 228, 229, 230, 231, 232, 233, 234, 235, 236, 237, 239, 240, 241, 242, 243, 245, 246, 247, 248, 250, 252, 253, 254, 255, 259, 260, 261, 263, 265, 266, 268, 270, 271, 272, 273, 274, 275, 276, 278, 279, 280, 281, 283, 284, 286, 287, 289, 290, 291, 292, 293, 295, 296, 297, 298, 300, 302, 304, 305, 306, 307, 308, 309, 311, 312, 313, 314, 316, 317, 318, 319, 321, 322, 324, 325, 326, 327, 328, 329, 330, 332, 334, 335, 336, 337, 338, 339, 341, 342, 343, 344, 345, 346, 347, 348, 349, 351, 352, 354, 356, 357, 358, 359, 360, 361, 363, 364, 365, 366, 368, 369, 371, 372, 373, 375, 376, 377, 378, 379, 380, 381, 382, 384, 385, 386, 387, 388, 389, 390, 393, 394, 395, 396, 398, 399, 401, 402, 403, 404, 405, 406, 407, 408, 409, 410, 411, 412, 414, 416, 417, 418, 419, 420, 421, 422, 423, 424, 425, 427, 430, 431, 432, 434, 436, 439, 441, 443, 444, 446, 447, 449, 450, 451, 453, 454, 455, 456, 457, 458, 459, 460, 462, 463, 465, 467, 468, 471, 472, 473, 474, 475, 476, 477, 478, 479, 480, 481, 482, 484, 485, 487, 488, 490, 491, 492, 493, 495, 496, 497, 498, 499, 500, 501, 502, 503, 504, 505, 506, 508, 510, 511, 512, 514, 515, 516, 517, 518, 519, 520, 521, 522, 523, 524, 525, 526, 527, 528, 529, 530, 531, 532, 533, 535, 536, 537, 538, 539, 540, 541, 542, 544, 545, 546, 547, 548, 550, 551, 552, 553, 554, 555, 558, 560, 561, 562, 563, 564, 565, 566, 567, 568, 569, 570, 571, 572, 573, 574, 575, 576, 577, 578, 579, 580, 581, 582, 584, 585, 586, 587, 589, 590, 591, 592, 593, 594, 595, 596, 597, 598, 599, 600, 601, 602, 603, 604, 605, 606, 607, 608, 610, 612, 613, 614, 616, 617, 618, 619, 620, 621, 622, 624, 625, 626, 630, 632, 633, 634, 635, 637, 639, 640, 641, 643, 644, 645, 646, 647, 648, 649, 650, 652, 653, 654, 656, 657, 658, 659, 660, 661, 662, 664, 665, 666, 667, 668, 669, 670, 671, 672, 674, 675, 676, 678, 680, 681, 682, 683, 684, 685, 687, 688, 689, 690, 691, 692, 693, 694, 695, 696, 698, 699, 700, 703, 705, 706, 707, 708, 709, 711, 712, 713, 714, 715, 716, 718, 719, 720, 721, 722, 724, 725, 726, 727, 728, 729, 730, 731, 732, 735, 738, 739, 742, 743, 744, 745, 747, 748, 749, 750, 751, 752, 753, 754, 755, 756, 757, 758, 760, 761, 762, 763, 764, 765, 766, 767, 771, 772, 773, 776, 777, 778, 781, 782, 783, 785, 786, 787, 788, 789, 791, 792, 793, 794, 795, 796, 799, 800, 803, 807, 808, 809, 811, 812, 814, 816, 817, 818, 820, 821, 823, 825, 826, 827, 829, 830, 831, 833, 835, 836, 837, 838, 839, 840, 841, 842, 844, 846, 847, 848, 849, 850, 851, 853, 854, 855, 857, 859, 860, 861, 864, 865, 866, 867, 869, 870, 871, 872, 873, 874, 875, 876, 877, 878, 879, 880, 883, 884, 886, 887, 888, 889]
[2, 13, 19, 20, 21, 29, 35, 61, 66, 82, 88, 90, 98, 99, 111, 122, 127, 130, 142, 145, 160, 162, 164, 165, 168, 169, 172, 173, 184, 187, 189, 198, 216, 217, 218, 229, 239, 251, 273, 277, 285, 294, 318, 332, 340, 365, 374, 377, 388, 400, 403, 416, 417, 424, 428, 439, 442, 444, 452, 460, 463, 469, 472, 476, 481, 501, 514, 535, 539, 544, 554, 563, 568, 573, 589, 594, 596, 598, 599, 607, 609, 620, 628, 654, 659, 661, 677, 683, 693, 695, 698, 702, 705, 708, 710, 712, 714, 719, 721, 732, 734, 746, 748, 752, 756, 785, 786, 800, 805, 809, 811, 816, 823, 834, 836, 838, 839, 842, 846, 865, 866, 884]

[0, 3, 4, 5, 6, 7, 8, 9, 10, 11, 12, 14, 15, 16, 17, 19, 20, 21, 22, 23, 24, 25, 26, 27, 28, 29, 30, 31, 32, 33, 35, 36, 37, 38, 39, 40, 41, 42, 43, 44, 45, 46, 47, 48, 49, 50, 51, 53, 55, 57, 58, 59, 60, 61, 62, 63, 64, 66, 67, 68, 69, 70, 71, 72, 73, 74, 75, 77, 78, 79, 80, 81, 82, 83, 85, 86, 87, 88, 90, 91, 92, 93, 94, 95, 96, 97, 98, 99, 100, 102, 103, 104, 105, 106, 107, 108, 109, 110, 111, 112, 113, 114, 118, 119, 120, 122, 123, 124, 125, 126, 127, 128, 129, 130, 131, 132, 134, 135, 136, 137, 138, 139, 140, 141, 142, 143, 144, 145, 146, 147, 148, 149, 150, 151, 152, 153, 154, 155, 156, 157, 158, 159, 160, 162, 163, 164, 165, 166, 167, 168, 169, 170, 171, 172, 173, 174, 175, 176, 177, 178, 179, 180, 181, 182, 183, 184, 185, 189, 190, 192, 193, 194, 195, 197, 198, 199, 200, 201, 202, 203, 204, 205, 206, 207, 209, 210, 211, 212, 214, 215, 216, 217, 218, 219, 220, 221, 222, 223, 224, 225, 227, 228, 229, 230, 231, 232, 233, 234, 235, 236, 237, 239, 240, 241, 242, 243, 245, 246, 247, 248, 249, 250, 251, 252, 253, 254, 255, 256, 257, 259, 260, 261, 263, 265, 266, 268, 270, 271, 272, 273, 274, 275, 276, 278, 279, 280, 281, 282, 283, 284, 285, 286, 287, 289, 290, 291, 292, 293, 294, 295, 296, 297, 298, 300, 301, 302, 304, 305, 306, 307, 308, 309, 311, 312, 313, 314, 316, 317, 318, 319, 321, 322, 324, 325, 326, 327, 328, 329, 330, 332, 333, 334, 335, 336, 337, 338, 339, 341, 342, 343, 344, 345, 346, 347, 348, 349, 351, 352, 354, 356, 357, 358, 359, 360, 361, 363, 364, 365, 366, 367, 368, 369, 371, 372, 373, 374, 375, 376, 377, 378, 379, 380, 381, 382, 384, 385, 386, 387, 388, 389, 390, 393, 394, 395, 396, 398, 399, 401, 402, 403, 404, 405, 406, 407, 408, 409, 410, 411, 412, 413, 414, 416, 417, 418, 419, 420, 421, 422, 423, 424, 425, 427, 430, 431, 432, 433, 434, 436, 438, 439, 440, 441, 443, 444, 446, 447, 449, 450, 451, 452, 453, 454, 455, 456, 457, 458, 459, 460, 461, 462, 463, 465, 466, 467, 468, 470, 471, 472, 473, 474, 475, 476, 477, 478, 479, 480, 481, 482, 484, 485, 487, 488, 489, 490, 491, 492, 493, 495, 496, 497, 498, 499, 500, 501, 502, 503, 504, 505, 506, 508, 509, 510, 511, 512, 514, 515, 516, 517, 518, 519, 520, 521, 522, 523, 524, 525, 526, 527, 528, 529, 530, 531, 532, 533, 534, 535, 536, 537, 538, 539, 540, 541, 542, 543, 544, 545, 546, 547, 548, 550, 551, 552, 553, 554, 555, 558, 559, 560, 561, 562, 563, 564, 565, 566, 567, 568, 569, 570, 571, 572, 573, 574, 575, 576, 577, 578, 579, 580, 581, 582, 584, 585, 586, 587, 588, 589, 590, 591, 592, 593, 594, 595, 596, 597, 598, 599, 600, 601, 602, 603, 604, 605, 606, 607, 608, 610, 612, 613, 614, 615, 616, 617, 618, 619, 620, 621, 622, 623, 624, 625, 626, 627, 628, 629, 630, 631, 632, 633, 634, 635, 636, 637, 639, 640, 641, 643, 644, 645, 646, 647, 648, 649, 650, 651, 652, 653, 654, 655, 656, 657, 658, 659, 660, 661, 662, 664, 665, 666, 667, 668, 669, 670, 671, 672, 674, 675, 676, 677, 678, 680, 681, 682, 683, 684, 685, 687, 688, 689, 690, 691, 692, 693, 694, 695, 696, 698, 699, 700, 702, 703, 705, 706, 707, 708, 709, 710, 711, 712, 713, 714, 715, 716, 717, 718, 719, 720, 721, 722, 724, 725, 726, 727, 728, 729, 730, 731, 732, 734, 735, 737, 738, 739, 741, 742, 743, 744, 745, 746, 747, 748, 749, 750, 751, 752, 753, 754, 755, 756, 757, 758, 759, 760, 761, 762, 763, 764, 765, 766, 767, 769, 771, 772, 773, 775, 776, 777, 778, 779, 781, 782, 783, 784, 785, 786, 787, 788, 789, 791, 792, 793, 794, 795, 796, 797, 799, 800, 802, 803, 805, 806, 807, 808, 809, 811, 812, 813, 814, 816, 817, 818, 820, 821, 823, 825, 826, 827, 829, 830, 831, 833, 834, 835, 836, 837, 838, 839, 840, 841, 842, 844, 845, 846, 847, 848, 849, 850, 851, 852, 853, 854, 855, 856, 857, 859, 860, 861, 863, 864, 865, 866, 867, 868, 869, 870, 871, 872, 873, 874, 875, 876, 877, 878, 879, 880, 881, 883, 884, 885, 886, 887, 888, 889]
[2, 13, 19, 20, 21, 29, 35, 61, 66, 82, 88, 90, 98, 99, 111, 122, 127, 130, 142, 145, 160, 162, 164, 165, 168, 169, 172, 173, 184, 187, 189, 198, 216, 217, 218, 229, 239, 251, 273, 277, 285, 294, 318, 332, 340, 365, 374, 377, 388, 400, 403, 416, 417, 424, 428, 439, 442, 444, 452, 460, 463, 469, 472, 476, 481, 501, 514, 535, 539, 544, 554, 563, 568, 573, 589, 594, 596, 598, 599, 607, 609, 620, 628, 654, 659, 661, 677, 683, 693, 695, 698, 702, 705, 708, 710, 712, 714, 719, 721, 732, 734, 746, 748, 752, 756, 785, 786, 800, 805, 809, 811, 816, 823, 834, 836, 838, 839, 842, 846, 865, 866, 884]

