[185, 200, 385, 445, 463, 492, 521, 582, 592, 612, 613, 625, 702, 711, 732, 736, 806, 812, 835, 847, 869, 885]
[19, 30, 109, 114, 119, 166, 167, 171, 179, 275, 276, 334, 338, 434, 487, 496, 558, 642, 706, 716, 784, 792]

[185, 200, 385, 445, 463, 492, 521, 582, 592, 612, 613, 625, 702, 711, 732, 736, 806, 812, 835, 847, 869, 885]
[2, 9, 16, 19, 22, 30, 36, 52, 72, 80, 87, 92, 93, 106, 109, 111, 114, 119, 120, 142, 146, 162, 165, 166, 167, 171, 174, 179, 180, 181, 183, 201, 207, 211, 215, 225, 237, 241, 247, 254, 275, 276, 290, 294, 296, 299, 303, 310, 311, 324, 329, 334, 338, 340, 346, 355, 372, 377, 391, 407, 434, 441, 446, 465, 469, 472, 487, 491, 496, 506, 510, 529, 553, 554, 558, 563, 585, 597, 608, 609, 618, 628, 629, 630, 636, 641, 642, 649, 655, 656, 659, 660, 666, 674, 690, 698, 706, 712, 716, 733, 734, 747, 752, 760, 766, 770, 784, 790, 792, 793, 795, 810, 815, 816, 832, 840, 852, 863, 868, 879, 884, 889]

[6, 28, 40, 47, 65, 76, 91, 100, 125, 128, 171, 180, 185, 186, 191, 192, 196, 200, 226, 234, 242, 247, 252, 262, 270, 345, 362, 371, 382, 385, 394, 405, 410, 423, 430, 433, 437, 442, 445, 448, 449, 452, 455, 463, 469, 475, 482, 492, 505, 506, 509, 519, 521, 529, 530, 547, 555, 571, 576, 582, 584, 587, 590, 592, 595, 611, 612, 613, 625, 633, 635, 638, 666, 667, 702, 711, 714, 717, 721, 727, 732, 736, 771, 800, 806, 811, 812, 825, 827, 835, 847, 867, 869, 871, 884, 885, 889]
[2, 9, 16, 19, 22, 30, 36, 52, 72, 80, 87, 92, 93, 106, 109, 111, 114, 119, 120, 142, 146, 162, 165, 166, 167, 171, 174, 179, 180, 181, 183, 201, 207, 211, 215, 225, 237, 241, 247, 254, 275, 276, 290, 294, 296, 299, 303, 310, 311, 324, 329, 334, 338, 340, 346, 355, 372, 377, 391, 407, 434, 441, 446, 465, 469, 472, 487, 491, 496, 506, 510, 529, 553, 554, 558, 563, 585, 597, 608, 609, 618, 628, 629, 630, 636, 641, 642, 649, 655, 656, 659, 660, 666, 674, 690, 698, 706, 712, 716, 733, 734, 747, 752, 760, 766, 770, 784, 790, 792, 793, 795, 810, 815, 816, 832, 840, 852, 863, 868, 879, 884, 889]

[6, 10, 13, 18, 19, 28, 40, 47, 50, 55, 65, 76, 81, 91, 100, 111, 115, 121, 123, 125, 128, 130, 160, 165, 169, 170, 171, 180, 181, 184, 185, 186, 191, 192, 195, 196, 199, 200, 205, 208, 209, 216, 226, 234, 240, 242, 247, 252, 256, 262, 270, 273, 278, 307, 310, 320, 328, 334, 336, 345, 362, 371, 382, 385, 394, 401, 405, 410, 412, 423, 425, 430, 433, 437, 439, 440, 442, 445, 448, 449, 452, 454, 455, 456, 463, 464, 469, 475, 477, 482, 484, 492, 493, 504, 505, 506, 509, 515, 519, 520, 521, 529, 530, 547, 555, 556, 559, 565, 571, 576, 582, 584, 587, 590, 592, 595, 611, 612, 613, 618, 625, 633, 635, 638, 643, 654, 663, 664, 666, 667, 688, 689, 695, 702, 707, 711, 713, 714, 717, 721, 725, 727, 732, 736, 738, 761, 771, 777, 798, 800, 806, 807, 808, 811, 812, 825, 827, 834, 835, 846, 847, 867, 869, 870, 871, 874, 876, 881, 882, 884, 885, 889]
[2, 9, 16, 19, 22, 30, 36, 52, 72, 80, 87, 92, 93, 106, 109, 111, 114, 119, 120, 142, 146, 162, 165, 166, 167, 171, 174, 179, 180, 181, 183, 201, 207, 211, 215, 225, 237, 241, 247, 254, 275, 276, 290, 294, 296, 299, 303, 310, 311, 324, 329, 334, 338, 340, 346, 355, 372, 377, 391, 407, 434, 441, 446, 465, 469, 472, 487, 491, 496, 506, 510, 529, 553, 554, 558, 563, 585, 597, 608, 609, 618, 628, 629, 630, 636, 641, 642, 649, 655, 656, 659, 660, 666, 674, 690, 698, 706, 712, 716, 733, 734, 747, 752, 760, 766, 770, 784, 790, 792, 793, 795, 810, 815, 816, 832, 840, 852, 863, 868, 879, 884, 889]

[6, 10, 13, 14, 18, 19, 21, 23, 28, 30, 40, 47, 50, 51, 55, 65, 71, 74, 76, 80, 81, 91, 93, 100, 104, 111, 112, 115, 117, 121, 123, 125, 126, 128, 130, 134, 135, 139, 160, 161, 163, 165, 168, 169, 170, 171, 180, 181, 184, 185, 186, 191, 192, 195, 196, 199, 200, 202, 205, 208, 209, 216, 219, 222, 226, 234, 240, 242, 247, 252, 256, 262, 264, 270, 273, 278, 282, 287, 288, 294, 300, 307, 310, 317, 320, 328, 334, 336, 342, 345, 347, 349, 350, 362, 366, 371, 377, 382, 385, 390, 393, 394, 399, 401, 404, 405, 410, 412, 423, 424, 425, 430, 431, 432, 433, 434, 437, 439, 440, 442, 443, 445, 448, 449, 452, 453, 454, 455, 456, 463, 464, 467, 469, 475, 477, 481, 482, 484, 485, 488, 490, 492, 493, 500, 504, 505, 506, 508, 509, 511, 515, 519, 520, 521, 529, 530, 547, 554, 555, 556, 559, 565, 567, 571, 576, 582, 584, 587, 590, 592, 595, 597, 611, 612, 613, 618, 619, 625, 630, 633, 635, 637, 638, 639, 643, 649, 654, 663, 664, 666, 667, 672, 688, 689, 690, 695, 702, 707, 711, 713, 714, 717, 721, 725, 727, 732, 736, 738, 741, 744, 751, 757, 758, 761, 771, 777, 779, 783, 787, 798, 800, 806, 807, 808, 811, 812, 819, 825, 827, 832, 834, 835, 846, 847, 867, 869, 870, 871, 874, 876, 881, 882, 883, 884, 885, 888, 889]
[2, 9, 16, 19, 22, 30, 36, 52, 72, 80, 87, 92, 93, 106, 109, 111, 114, 119, 120, 142, 146, 162, 165, 166, 167, 171, 174, 179, 180, 181, 183, 201, 207, 211, 215, 225, 237, 241, 247, 254, 275, 276, 290, 294, 296, 299, 303, 310, 311, 324, 329, 334, 338, 340, 346, 355, 372, 377, 391, 407, 434, 441, 446, 465, 469, 472, 487, 491, 496, 506, 510, 529, 553, 554, 558, 563, 585, 597, 608, 609, 618, 628, 629, 630, 636, 641, 642, 649, 655, 656, 659, 660, 666, 674, 690, 698, 706, 712, 716, 733, 734, 747, 752, 760, 766, 770, 784, 790, 792, 793, 795, 810, 815, 816, 832, 840, 852, 863, 868, 879, 884, 889]

[0, 6, 10, 12, 13, 14, 18, 19, 21, 23, 28, 30, 32, 34, 35, 40, 47, 50, 51, 55, 57, 61, 65, 71, 74, 76, 80, 81, 88, 91, 93, 100, 104, 111, 112, 115, 117, 121, 123, 124, 125, 126, 128, 130, 134, 135, 138, 139, 140, 154, 156, 160, 161, 163, 165, 166, 168, 169, 170, 171, 180, 181, 184, 185, 186, 188, 191, 192, 195, 196, 198, 199, 200, 202, 205, 207, 208, 209, 216, 219, 222, 225, 226, 228, 234, 240, 242, 247, 248, 252, 256, 257, 262, 264, 270, 273, 277, 278, 280, 282, 287, 288, 293, 294, 300, 307, 310, 313, 316, 317, 318, 320, 328, 334, 336, 337, 339, 342, 345, 347, 349, 350, 356, 362, 366, 371, 377, 378, 382, 383, 385, 390, 392, 393, 394, 399, 401, 404, 405, 410, 412, 413, 414, 415, 420, 423, 424, 425, 430, 431, 432, 433, 434, 435, 436, 437, 439, 440, 442, 443, 445, 447, 448, 449, 451, 452, 453, 454, 455, 456, 457, 461, 463, 464, 465, 466, 467, 469, 475, 477, 481, 482, 484, 485, 488, 490, 492, 493, 497, 498, 499, 500, 503, 504, 505, 506, 508, 509, 511, 512, 515, 519, 520, 521, 529, 530, 532, 541, 546, 547, 554, 555, 556, 559, 564, 565, 567, 571, 576, 580, 582, 584, 586, 587, 589, 590, 592, 595, 597, 600, 608, 611, 612, 613, 618, 619, 625, 630, 633, 635, 637, 638, 639, 643, 649, 654, 656, 663, 664, 666, 667, 672, 675, 687, 688, 689, 690, 695, 697, 702, 706, 707, 711, 713, 714, 717, 719, 721, 723, 725, 727, 732, 736, 737, 738, 740, 741, 744, 747, 751, 757, 758, 761, 771, 777, 779, 783, 787, 788, 795, 798, 800, 806, 807, 808, 809, 810, 811, 812, 819, 825, 826, 827, 832, 833, 834, 835, 846, 847, 867, 869, 870, 871, 874, 876, 881, 882, 883, 884, 885, 888, 889]
[2, 9, 16, 19, 22, 30, 36, 52, 72, 80, 87, 92, 93, 106, 109, 111, 114, 119, 120, 142, 146, 162, 165, 166, 167, 171, 174, 179, 180, 181, 183, 201, 207, 211, 215, 225, 237, 241, 247, 254, 275, 276, 290, 294, 296, 299, 303, 310, 311, 324, 329, 334, 338, 340, 346, 355, 372, 377, 391, 407, 434, 441, 446, 465, 469, 472, 487, 491, 496, 506, 510, 529, 553, 554, 558, 563, 585, 597, 608, 609, 618, 628, 629, 630, 636, 641, 642, 649, 655, 656, 659, 660, 666, 674, 690, 698, 706, 712, 716, 733, 734, 747, 752, 760, 766, 770, 784, 790, 792, 793, 795, 810, 815, 816, 832, 840, 852, 863, 868, 879, 884, 889]

[0, 1, 6, 7, 8, 10, 12, 13, 14, 18, 19, 21, 23, 27, 28, 30, 32, 34, 35, 38, 40, 47, 48, 49, 50, 51, 55, 57, 61, 65, 66, 71, 74, 76, 80, 81, 86, 88, 91, 93, 100, 104, 111, 112, 115, 116, 117, 121, 123, 124, 125, 126, 127, 128, 130, 134, 135, 138, 139, 140, 145, 148, 154, 156, 158, 160, 161, 163, 165, 166, 168, 169, 170, 171, 172, 180, 181, 184, 185, 186, 188, 190, 191, 192, 195, 196, 198, 199, 200, 202, 205, 207, 208, 209, 215, 216, 219, 221, 222, 225, 226, 228, 231, 234, 236, 238, 240, 241, 242, 245, 246, 247, 248, 252, 256, 257, 261, 262, 263, 264, 270, 273, 277, 278, 280, 282, 287, 288, 293, 294, 300, 307, 310, 313, 316, 317, 318, 320, 321, 323, 328, 330, 332, 334, 336, 337, 339, 342, 345, 347, 349, 350, 351, 356, 360, 362, 366, 371, 373, 374, 376, 377, 378, 382, 383, 385, 388, 389, 390, 392, 393, 394, 399, 400, 401, 404, 405, 410, 411, 412, 413, 414, 415, 420, 423, 424, 425, 430, 431, 432, 433, 434, 435, 436, 437, 439, 440, 442, 443, 444, 445, 447, 448, 449, 451, 452, 453, 454, 455, 456, 457, 460, 461, 463, 464, 465, 466, 467, 469, 475, 477, 481, 482, 484, 485, 487, 488, 490, 492, 493, 495, 497, 498, 499, 500, 503, 504, 505, 506, 508, 509, 511, 512, 515, 519, 520, 521, 529, 530, 532, 539, 541, 546, 547, 549, 550, 553, 554, 555, 556, 559, 564, 565, 567, 570, 571, 576, 579, 580, 582, 584, 586, 587, 589, 590, 592, 595, 597, 598, 600, 604, 608, 611, 612, 613, 615, 618, 619, 625, 628, 630, 632, 633, 635, 637, 638, 639, 643, 645, 649, 652, 654, 655, 656, 660, 663, 664, 666, 667, 672, 675, 687, 688, 689, 690, 695, 697, 702, 706, 707, 708, 711, 712, 713, 714, 717, 719, 721, 723, 725, 727, 729, 730, 732, 736, 737, 738, 740, 741, 744, 745, 747, 748, 751, 753, 757, 758, 759, 761, 763, 765, 768, 771, 775, 777, 779, 783, 787, 788, 795, 798, 800, 806, 807, 808, 809, 810, 811, 812, 819, 820, 825, 826, 827, 829, 832, 833, 834, 835, 846, 847, 856, 859, 867, 869, 870, 871, 872, 874, 876, 881, 882, 883, 884, 885, 888, 889]
[2, 9, 16, 19, 22, 30, 36, 52, 72, 80, 87, 92, 93, 106, 109, 111, 114, 119, 120, 142, 146, 162, 165, 166, 167, 171, 174, 179, 180, 181, 183, 201, 207, 211, 215, 225, 237, 241, 247, 254, 275, 276, 290, 294, 296, 299, 303, 310, 311, 324, 329, 334, 338, 340, 346, 355, 372, 377, 391, 407, 434, 441, 446, 465, 469, 472, 487, 491, 496, 506, 510, 529, 553, 554, 558, 563, 585, 597, 608, 609, 618, 628, 629, 630, 636, 641, 642, 649, 655, 656, 659, 660, 666, 674, 690, 698, 706, 712, 716, 733, 734, 747, 752, 760, 766, 770, 784, 790, 792, 793, 795, 810, 815, 816, 832, 840, 852, 863, 868, 879, 884, 889]

[0, 1, 5, 6, 7, 8, 10, 12, 13, 14, 17, 18, 19, 21, 23, 27, 28, 30, 32, 34, 35, 38, 40, 46, 47, 48, 49, 50, 51, 55, 57, 61, 65, 66, 71, 74, 76, 77, 78, 79, 80, 81, 83, 84, 86, 88, 91, 93, 100, 102, 104, 111, 112, 115, 116, 117, 118, 121, 122, 123, 124, 125, 126, 127, 128, 130, 134, 135, 138, 139, 140, 145, 148, 151, 152, 153, 154, 156, 158, 160, 161, 163, 165, 166, 167, 168, 169, 170, 171, 172, 175, 177, 178, 180, 181, 183, 184, 185, 186, 188, 190, 191, 192, 195, 196, 197, 198, 199, 200, 201, 202, 205, 207, 208, 209, 211, 215, 216, 219, 221, 222, 225, 226, 228, 231, 234, 236, 238, 240, 241, 242, 245, 246, 247, 248, 251, 252, 256, 257, 260, 261, 262, 263, 264, 270, 271, 273, 277, 278, 280, 282, 287, 288, 293, 294, 297, 300, 302, 307, 310, 313, 314, 316, 317, 318, 320, 321, 323, 328, 330, 332, 334, 335, 336, 337, 339, 342, 345, 347, 349, 350, 351, 353, 354, 356, 359, 360, 362, 366, 371, 373, 374, 376, 377, 378, 382, 383, 385, 388, 389, 390, 392, 393, 394, 398, 399, 400, 401, 404, 405, 410, 411, 412, 413, 414, 415, 419, 420, 421, 423, 424, 425, 430, 431, 432, 433, 434, 435, 436, 437, 439, 440, 442, 443, 444, 445, 447, 448, 449, 451, 452, 453, 454, 455, 456, 457, 460, 461, 463, 464, 465, 466, 467, 469, 473, 475, 477, 479, 481, 482, 484, 485, 487, 488, 490, 492, 493, 495, 497, 498, 499, 500, 501, 503, 504, 505, 506, 508, 509, 511, 512, 514, 515, 519, 520, 521, 528, 529, 530, 532, 539, 541, 542, 544, 546, 547, 548, 549, 550, 553, 554, 555, 556, 559, 561, 564, 565, 566, 567, 568, 570, 571, 572, 575, 576, 579, 580, 582, 584, 586, 587, 589, 590, 592, 595, 597, 598, 600, 604, 608, 609, 611, 612, 613, 615, 618, 619, 625, 628, 630, 632, 633, 635, 637, 638, 639, 643, 645, 649, 651, 652, 654, 655, 656, 660, 661, 662, 663, 664, 666, 667, 672, 674, 675, 687, 688, 689, 690, 695, 697, 702, 704, 705, 706, 707, 708, 709, 711, 712, 713, 714, 716, 717, 719, 721, 723, 725, 727, 729, 730, 732, 736, 737, 738, 740, 741, 744, 745, 746, 747, 748, 751, 753, 754, 757, 758, 759, 761, 763, 764, 765, 766, 768, 769, 771, 775, 777, 779, 783, 785, 787, 788, 790, 795, 796, 798, 800, 802, 806, 807, 808, 809, 810, 811, 812, 819, 820, 822, 825, 826, 827, 828, 829, 832, 833, 834, 835, 839, 845, 846, 847, 856, 857, 859, 863, 864, 867, 869, 870, 871, 872, 873, 874, 876, 880, 881, 882, 883, 884, 885, 888, 889]
[2, 9, 16, 19, 22, 30, 36, 52, 72, 80, 87, 92, 93, 106, 109, 111, 114, 119, 120, 142, 146, 162, 165, 166, 167, 171, 174, 179, 180, 181, 183, 201, 207, 211, 215, 225, 237, 241, 247, 254, 275, 276, 290, 294, 296, 299, 303, 310, 311, 324, 329, 334, 338, 340, 346, 355, 372, 377, 391, 407, 434, 441, 446, 465, 469, 472, 487, 491, 496, 506, 510, 529, 553, 554, 558, 563, 585, 597, 608, 609, 618, 628, 629, 630, 636, 641, 642, 649, 655, 656, 659, 660, 666, 674, 690, 698, 706, 712, 716, 733, 734, 747, 752, 760, 766, 770, 784, 790, 792, 793, 795, 810, 815, 816, 832, 840, 852, 863, 868, 879, 884, 889]

[0, 1, 3, 4, 5, 6, 7, 8, 10, 12, 13, 14, 17, 18, 19, 21, 23, 27, 28, 30, 32, 34, 35, 38, 40, 41, 46, 47, 48, 49, 50, 51, 52, 55, 57, 59, 60, 61, 65, 66, 71, 74, 76, 77, 78, 79, 80, 81, 83, 84, 86, 87, 88, 91, 93, 99, 100, 102, 104, 105, 106, 111, 112, 115, 116, 117, 118, 119, 120, 121, 122, 123, 124, 125, 126, 127, 128, 129, 130, 134, 135, 138, 139, 140, 142, 144, 145, 148, 151, 152, 153, 154, 156, 157, 158, 159, 160, 161, 163, 165, 166, 167, 168, 169, 170, 171, 172, 175, 177, 178, 180, 181, 183, 184, 185, 186, 188, 190, 191, 192, 195, 196, 197, 198, 199, 200, 201, 202, 205, 207, 208, 209, 211, 215, 216, 219, 221, 222, 225, 226, 228, 231, 234, 236, 237, 238, 240, 241, 242, 243, 245, 246, 247, 248, 249, 251, 252, 256, 257, 260, 261, 262, 263, 264, 270, 271, 273, 277, 278, 280, 282, 283, 284, 287, 288, 291, 292, 293, 294, 297, 300, 302, 303, 307, 310, 311, 313, 314, 316, 317, 318, 320, 321, 323, 324, 328, 329, 330, 332, 333, 334, 335, 336, 337, 338, 339, 341, 342, 345, 347, 349, 350, 351, 353, 354, 356, 359, 360, 362, 364, 366, 369, 370, 371, 373, 374, 376, 377, 378, 382, 383, 385, 386, 388, 389, 390, 392, 393, 394, 398, 399, 400, 401, 404, 405, 407, 410, 411, 412, 413, 414, 415, 417, 418, 419, 420, 421, 423, 424, 425, 430, 431, 432, 433, 434, 435, 436, 437, 439, 440, 442, 443, 444, 445, 447, 448, 449, 451, 452, 453, 454, 455, 456, 457, 459, 460, 461, 463, 464, 465, 466, 467, 469, 472, 473, 475, 477, 478, 479, 480, 481, 482, 484, 485, 487, 488, 490, 492, 493, 495, 497, 498, 499, 500, 501, 503, 504, 505, 506, 508, 509, 511, 512, 514, 515, 519, 520, 521, 528, 529, 530, 532, 536, 538, 539, 541, 542, 544, 546, 547, 548, 549, 550, 552, 553, 554, 555, 556, 558, 559, 561, 564, 565, 566, 567, 568, 570, 571, 572, 575, 576, 579, 580, 581, 582, 584, 586, 587, 589, 590, 592, 594, 595, 597, 598, 600, 602, 604, 608, 609, 611, 612, 613, 615, 617, 618, 619, 621, 625, 627, 628, 630, 632, 633, 635, 637, 638, 639, 643, 644, 645, 649, 651, 652, 654, 655, 656, 658, 660, 661, 662, 663, 664, 665, 666, 667, 671, 672, 674, 675, 676, 681, 687, 688, 689, 690, 692, 694, 695, 697, 702, 704, 705, 706, 707, 708, 709, 711, 712, 713, 714, 716, 717, 719, 721, 723, 725, 727, 729, 730, 732, 736, 737, 738, 740, 741, 744, 745, 746, 747, 748, 751, 752, 753, 754, 757, 758, 759, 760, 761, 763, 764, 765, 766, 767, 768, 769, 771, 773, 775, 777, 779, 781, 782, 783, 785, 787, 788, 790, 793, 795, 796, 798, 800, 801, 802, 805, 806, 807, 808, 809, 810, 811, 812, 818, 819, 820, 822, 825, 826, 827, 828, 829, 831, 832, 833, 834, 835, 836, 838, 839, 842, 845, 846, 847, 849, 855, 856, 857, 859, 863, 864, 867, 869, 870, 871, 872, 873, 874, 876, 877, 878, 879, 880, 881, 882, 883, 884, 885, 888, 889]
[2, 9, 16, 19, 22, 30, 36, 52, 72, 80, 87, 92, 93, 106, 109, 111, 114, 119, 120, 142, 146, 162, 165, 166, 167, 171, 174, 179, 180, 181, 183, 201, 207, 211, 215, 225, 237, 241, 247, 254, 275, 276, 290, 294, 296, 299, 303, 310, 311, 324, 329, 334, 338, 340, 346, 355, 372, 377, 391, 407, 434, 441, 446, 465, 469, 472, 487, 491, 496, 506, 510, 529, 553, 554, 558, 563, 585, 597, 608, 609, 618, 628, 629, 630, 636, 641, 642, 649, 655, 656, 659, 660, 666, 674, 690, 698, 706, 712, 716, 733, 734, 747, 752, 760, 766, 770, 784, 790, 792, 793, 795, 810, 815, 816, 832, 840, 852, 863, 868, 879, 884, 889]

[0, 1, 2, 3, 4, 5, 6, 7, 8, 10, 12, 13, 14, 17, 18, 19, 21, 23, 24, 27, 28, 30, 32, 34, 35, 37, 38, 40, 41, 42, 45, 46, 47, 48, 49, 50, 51, 52, 55, 57, 59, 60, 61, 65, 66, 71, 73, 74, 76, 77, 78, 79, 80, 81, 83, 84, 86, 87, 88, 91, 93, 94, 95, 98, 99, 100, 102, 104, 105, 106, 108, 109, 111, 112, 115, 116, 117, 118, 119, 120, 121, 122, 123, 124, 125, 126, 127, 128, 129, 130, 133, 134, 135, 138, 139, 140, 141, 142, 144, 145, 146, 148, 150, 151, 152, 153, 154, 155, 156, 157, 158, 159, 160, 161, 163, 164, 165, 166, 167, 168, 169, 170, 171, 172, 175, 177, 178, 180, 181, 183, 184, 185, 186, 188, 190, 191, 192, 195, 196, 197, 198, 199, 200, 201, 202, 205, 206, 207, 208, 209, 211, 215, 216, 219, 221, 222, 225, 226, 228, 230, 231, 234, 236, 237, 238, 240, 241, 242, 243, 245, 246, 247, 248, 249, 250, 251, 252, 253, 256, 257, 259, 260, 261, 262, 263, 264, 265, 269, 270, 271, 272, 273, 277, 278, 280, 282, 283, 284, 285, 287, 288, 289, 291, 292, 293, 294, 295, 297, 300, 302, 303, 307, 310, 311, 312, 313, 314, 316, 317, 318, 320, 321, 323, 324, 328, 329, 330, 332, 333, 334, 335, 336, 337, 338, 339, 340, 341, 342, 345, 346, 347, 348, 349, 350, 351, 353, 354, 356, 359, 360, 362, 364, 365, 366, 369, 370, 371, 372, 373, 374, 376, 377, 378, 382, 383, 385, 386, 388, 389, 390, 392, 393, 394, 398, 399, 400, 401, 404, 405, 407, 409, 410, 411, 412, 413, 414, 415, 417, 418, 419, 420, 421, 423, 424, 425, 426, 430, 431, 432, 433, 434, 435, 436, 437, 439, 440, 442, 443, 444, 445, 446, 447, 448, 449, 451, 452, 453, 454, 455, 456, 457, 458, 459, 460, 461, 462, 463, 464, 465, 466, 467, 468, 469, 472, 473, 475, 476, 477, 478, 479, 480, 481, 482, 484, 485, 487, 488, 489, 490, 491, 492, 493, 494, 495, 496, 497, 498, 499, 500, 501, 503, 504, 505, 506, 508, 509, 511, 512, 514, 515, 516, 519, 520, 521, 528, 529, 530, 532, 535, 536, 537, 538, 539, 540, 541, 542, 544, 546, 547, 548, 549, 550, 551, 552, 553, 554, 555, 556, 557, 558, 559, 561, 564, 565, 566, 567, 568, 570, 571, 572, 573, 575, 576, 579, 580, 581, 582, 584, 586, 587, 588, 589, 590, 592, 594, 595, 597, 598, 600, 602, 604, 608, 609, 611, 612, 613, 615, 616, 617, 618, 619, 621, 625, 627, 628, 630, 632, 633, 635, 637, 638, 639, 643, 644, 645, 646, 649, 651, 652, 654, 655, 656, 657, 658, 660, 661, 662, 663, 664, 665, 666, 667, 671, 672, 674, 675, 676, 679, 681, 687, 688, 689, 690, 692, 694, 695, 697, 699, 701, 702, 704, 705, 706, 707, 708, 709, 711, 712, 713, 714, 716, 717, 718, 719, 721, 722, 723, 725, 727, 728, 729, 730, 732, 736, 737, 738, 740, 741, 744, 745, 746, 747, 748, 749, 751, 752, 753, 754, 757, 758, 759, 760, 761, 762, 763, 764, 765, 766, 767, 768, 769, 771, 773, 775, 776, 777, 779, 781, 782, 783, 785, 787, 788, 790, 793, 794, 795, 796, 797, 798, 800, 801, 802, 803, 804, 805, 806, 807, 808, 809, 810, 811, 812, 818, 819, 820, 821, 822, 825, 826, 827, 828, 829, 830, 831, 832, 833, 834, 835, 836, 838, 839, 842, 843, 845, 846, 847, 849, 851, 855, 856, 857, 859, 863, 864, 865, 866, 867, 869, 870, 871, 872, 873, 874, 876, 877, 878, 879, 880, 881, 882, 883, 884, 885, 888, 889]
[2, 9, 16, 19, 22, 30, 36, 52, 72, 80, 87, 92, 93, 106, 109, 111, 114, 119, 120, 142, 146, 162, 165, 166, 167, 171, 174, 179, 180, 181, 183, 201, 207, 211, 215, 225, 237, 241, 247, 254, 275, 276, 290, 294, 296, 299, 303, 310, 311, 324, 329, 334, 338, 340, 346, 355, 372, 377, 391, 407, 434, 441, 446, 465, 469, 472, 487, 491, 496, 506, 510, 529, 553, 554, 558, 563, 585, 597, 608, 609, 618, 628, 629, 630, 636, 641, 642, 649, 655, 656, 659, 660, 666, 674, 690, 698, 706, 712, 716, 733, 734, 747, 752, 760, 766, 770, 784, 790, 792, 793, 795, 810, 815, 816, 832, 840, 852, 863, 868, 879, 884, 889]

[0, 1, 2, 3, 4, 5, 6, 7, 8, 10, 12, 13, 14, 17, 18, 19, 20, 21, 23, 24, 25, 26, 27, 28, 30, 32, 33, 34, 35, 37, 38, 39, 40, 41, 42, 45, 46, 47, 48, 49, 50, 51, 52, 55, 56, 57, 59, 60, 61, 62, 65, 66, 71, 73, 74, 75, 76, 77, 78, 79, 80, 81, 83, 84, 86, 87, 88, 91, 93, 94, 95, 98, 99, 100, 102, 104, 105, 106, 108, 109, 110, 111, 112, 115, 116, 117, 118, 119, 120, 121, 122, 123, 124, 125, 126, 127, 128, 129, 130, 131, 133, 134, 135, 136, 138, 139, 140, 141, 142, 144, 145, 146, 148, 150, 151, 152, 153, 154, 155, 156, 157, 158, 159, 160, 161, 163, 164, 165, 166, 167, 168, 169, 170, 171, 172, 173, 174, 175, 177, 178, 180, 181, 183, 184, 185, 186, 188, 190, 191, 192, 193, 195, 196, 197, 198, 199, 200, 201, 202, 204, 205, 206, 207, 208, 209, 211, 214, 215, 216, 217, 218, 219, 221, 222, 223, 224, 225, 226, 228, 230, 231, 233, 234, 236, 237, 238, 240, 241, 242, 243, 245, 246, 247, 248, 249, 250, 251, 252, 253, 256, 257, 258, 259, 260, 261, 262, 263, 264, 265, 267, 268, 269, 270, 271, 272, 273, 276, 277, 278, 279, 280, 282, 283, 284, 285, 287, 288, 289, 291, 292, 293, 294, 295, 297, 300, 302, 303, 304, 307, 310, 311, 312, 313, 314, 315, 316, 317, 318, 319, 320, 321, 323, 324, 328, 329, 330, 331, 332, 333, 334, 335, 336, 337, 338, 339, 340, 341, 342, 343, 345, 346, 347, 348, 349, 350, 351, 353, 354, 356, 359, 360, 362, 364, 365, 366, 369, 370, 371, 372, 373, 374, 375, 376, 377, 378, 381, 382, 383, 385, 386, 388, 389, 390, 392, 393, 394, 395, 396, 397, 398, 399, 400, 401, 404, 405, 407, 409, 410, 411, 412, 413, 414, 415, 417, 418, 419, 420, 421, 422, 423, 424, 425, 426, 427, 428, 430, 431, 432, 433, 434, 435, 436, 437, 439, 440, 442, 443, 444, 445, 446, 447, 448, 449, 450, 451, 452, 453, 454, 455, 456, 457, 458, 459, 460, 461, 462, 463, 464, 465, 466, 467, 468, 469, 471, 472, 473, 475, 476, 477, 478, 479, 480, 481, 482, 483, 484, 485, 487, 488, 489, 490, 491, 492, 493, 494, 495, 496, 497, 498, 499, 500, 501, 502, 503, 504, 505, 506, 508, 509, 510, 511, 512, 514, 515, 516, 519, 520, 521, 523, 525, 528, 529, 530, 531, 532, 534, 535, 536, 537, 538, 539, 540, 541, 542, 543, 544, 545, 546, 547, 548, 549, 550, 551, 552, 553, 554, 555, 556, 557, 558, 559, 561, 562, 564, 565, 566, 567, 568, 570, 571, 572, 573, 575, 576, 579, 580, 581, 582, 584, 586, 587, 588, 589, 590, 592, 594, 595, 597, 598, 599, 600, 602, 604, 607, 608, 609, 611, 612, 613, 615, 616, 617, 618, 619, 621, 622, 624, 625, 627, 628, 630, 631, 632, 633, 635, 636, 637, 638, 639, 643, 644, 645, 646, 647, 649, 651, 652, 653, 654, 655, 656, 657, 658, 660, 661, 662, 663, 664, 665, 666, 667, 668, 671, 672, 674, 675, 676, 679, 681, 682, 685, 687, 688, 689, 690, 691, 692, 694, 695, 697, 699, 701, 702, 703, 704, 705, 706, 707, 708, 709, 710, 711, 712, 713, 714, 715, 716, 717, 718, 719, 721, 722, 723, 725, 726, 727, 728, 729, 730, 732, 736, 737, 738, 740, 741, 744, 745, 746, 747, 748, 749, 751, 752, 753, 754, 756, 757, 758, 759, 760, 761, 762, 763, 764, 765, 766, 767, 768, 769, 771, 773, 774, 775, 776, 777, 779, 781, 782, 783, 784, 785, 787, 788, 790, 791, 793, 794, 795, 796, 797, 798, 800, 801, 802, 803, 804, 805, 806, 807, 808, 809, 810, 811, 812, 815, 817, 818, 819, 820, 821, 822, 824, 825, 826, 827, 828, 829, 830, 831, 832, 833, 834, 835, 836, 838, 839, 840, 841, 842, 843, 845, 846, 847, 849, 850, 851, 854, 855, 856, 857, 859, 861, 862, 863, 864, 865, 866, 867, 869, 870, 871, 872, 873, 874, 876, 877, 878, 879, 880, 881, 882, 883, 884, 885, 886, 888, 889]
[2, 9, 16, 19, 22, 30, 36, 52, 72, 80, 87, 92, 93, 106, 109, 111, 114, 119, 120, 142, 146, 162, 165, 166, 167, 171, 174, 179, 180, 181, 183, 201, 207, 211, 215, 225, 237, 241, 247, 254, 275, 276, 290, 294, 296, 299, 303, 310, 311, 324, 329, 334, 338, 340, 346, 355, 372, 377, 391, 407, 434, 441, 446, 465, 469, 472, 487, 491, 496, 506, 510, 529, 553, 554, 558, 563, 585, 597, 608, 609, 618, 628, 629, 630, 636, 641, 642, 649, 655, 656, 659, 660, 666, 674, 690, 698, 706, 712, 716, 733, 734, 747, 752, 760, 766, 770, 784, 790, 792, 793, 795, 810, 815, 816, 832, 840, 852, 863, 868, 879, 884, 889]

[0, 1, 2, 3, 4, 5, 6, 7, 8, 10, 11, 12, 13, 14, 15, 17, 18, 19, 20, 21, 23, 24, 25, 26, 27, 28, 30, 31, 32, 33, 34, 35, 36, 37, 38, 39, 40, 41, 42, 43, 45, 46, 47, 48, 49, 50, 51, 52, 53, 55, 56, 57, 58, 59, 60, 61, 62, 65, 66, 67, 68, 71, 73, 74, 75, 76, 77, 78, 79, 80, 81, 83, 84, 85, 86, 87, 88, 89, 91, 93, 94, 95, 96, 98, 99, 100, 102, 104, 105, 106, 107, 108, 109, 110, 111, 112, 113, 115, 116, 117, 118, 119, 120, 121, 122, 123, 124, 125, 126, 127, 128, 129, 130, 131, 132, 133, 134, 135, 136, 137, 138, 139, 140, 141, 142, 144, 145, 146, 148, 150, 151, 152, 153, 154, 155, 156, 157, 158, 159, 160, 161, 162, 163, 164, 165, 166, 167, 168, 169, 170, 171, 172, 173, 174, 175, 177, 178, 180, 181, 183, 184, 185, 186, 187, 188, 189, 190, 191, 192, 193, 195, 196, 197, 198, 199, 200, 201, 202, 204, 205, 206, 207, 208, 209, 211, 214, 215, 216, 217, 218, 219, 220, 221, 222, 223, 224, 225, 226, 227, 228, 229, 230, 231, 233, 234, 235, 236, 237, 238, 239, 240, 241, 242, 243, 245, 246, 247, 248, 249, 250, 251, 252, 253, 254, 256, 257, 258, 259, 260, 261, 262, 263, 264, 265, 266, 267, 268, 269, 270, 271, 272, 273, 275, 276, 277, 278, 279, 280, 282, 283, 284, 285, 286, 287, 288, 289, 290, 291, 292, 293, 294, 295, 297, 298, 299, 300, 301, 302, 303, 304, 307, 310, 311, 312, 313, 314, 315, 316, 317, 318, 319, 320, 321, 322, 323, 324, 328, 329, 330, 331, 332, 333, 334, 335, 336, 337, 338, 339, 340, 341, 342, 343, 344, 345, 346, 347, 348, 349, 350, 351, 352, 353, 354, 356, 357, 358, 359, 360, 362, 364, 365, 366, 369, 370, 371, 372, 373, 374, 375, 376, 377, 378, 381, 382, 383, 385, 386, 388, 389, 390, 392, 393, 394, 395, 396, 397, 398, 399, 400, 401, 404, 405, 407, 408, 409, 410, 411, 412, 413, 414, 415, 416, 417, 418, 419, 420, 421, 422, 423, 424, 425, 426, 427, 428, 429, 430, 431, 432, 433, 434, 435, 436, 437, 439, 440, 441, 442, 443, 444, 445, 446, 447, 448, 449, 450, 451, 452, 453, 454, 455, 456, 457, 458, 459, 460, 461, 462, 463, 464, 465, 466, 467, 468, 469, 470, 471, 472, 473, 475, 476, 477, 478, 479, 480, 481, 482, 483, 484, 485, 487, 488, 489, 490, 491, 492, 493, 494, 495, 496, 497, 498, 499, 500, 501, 502, 503, 504, 505, 506, 508, 509, 510, 511, 512, 514, 515, 516, 517, 519, 520, 521, 523, 525, 527, 528, 529, 530, 531, 532, 534, 535, 536, 537, 538, 539, 540, 541, 542, 543, 544, 545, 546, 547, 548, 549, 550, 551, 552, 553, 554, 555, 556, 557, 558, 559, 560, 561, 562, 563, 564, 565, 566, 567, 568, 570, 571, 572, 573, 575, 576, 579, 580, 581, 582, 583, 584, 586, 587, 588, 589, 590, 591, 592, 593, 594, 595, 597, 598, 599, 600, 601, 602, 603, 604, 606, 607, 608, 609, 611, 612, 613, 614, 615, 616, 617, 618, 619, 621, 622, 624, 625, 626, 627, 628, 630, 631, 632, 633, 634, 635, 636, 637, 638, 639, 642, 643, 644, 645, 646, 647, 649, 650, 651, 652, 653, 654, 655, 656, 657, 658, 660, 661, 662, 663, 664, 665, 666, 667, 668, 671, 672, 673, 674, 675, 676, 677, 678, 679, 681, 682, 683, 684, 685, 686, 687, 688, 689, 690, 691, 692, 694, 695, 697, 698, 699, 701, 702, 703, 704, 705, 706, 707, 708, 709, 710, 711, 712, 713, 714, 715, 716, 717, 718, 719, 720, 721, 722, 723, 725, 726, 727, 728, 729, 730, 732, 733, 734, 736, 737, 738, 739, 740, 741, 743, 744, 745, 746, 747, 748, 749, 751, 752, 753, 754, 756, 757, 758, 759, 760, 761, 762, 763, 764, 765, 766, 767, 768, 769, 771, 772, 773, 774, 775, 776, 777, 779, 780, 781, 782, 783, 784, 785, 787, 788, 790, 791, 792, 793, 794, 795, 796, 797, 798, 799, 800, 801, 802, 803, 804, 805, 806, 807, 808, 809, 810, 811, 812, 815, 817, 818, 819, 820, 821, 822, 823, 824, 825, 826, 827, 828, 829, 830, 831, 832, 833, 834, 835, 836, 838, 839, 840, 841, 842, 843, 844, 845, 846, 847, 848, 849, 850, 851, 852, 854, 855, 856, 857, 859, 861, 862, 863, 864, 865, 866, 867, 869, 870, 871, 872, 873, 874, 876, 877, 878, 879, 880, 881, 882, 883, 884, 885, 886, 887, 888, 889]
[2, 9, 16, 19, 22, 30, 36, 52, 72, 80, 87, 92, 93, 106, 109, 111, 114, 119, 120, 142, 146, 162, 165, 166, 167, 171, 174, 179, 180, 181, 183, 201, 207, 211, 215, 225, 237, 241, 247, 254, 275, 276, 290, 294, 296, 299, 303, 310, 311, 324, 329, 334, 338, 340, 346, 355, 372, 377, 391, 407, 434, 441, 446, 465, 469, 472, 487, 491, 496, 506, 510, 529, 553, 554, 558, 563, 585, 597, 608, 609, 618, 628, 629, 630, 636, 641, 642, 649, 655, 656, 659, 660, 666, 674, 690, 698, 706, 712, 716, 733, 734, 747, 752, 760, 766, 770, 784, 790, 792, 793, 795, 810, 815, 816, 832, 840, 852, 863, 868, 879, 884, 889]

