[6, 7, 13, 129, 209, 228, 238, 292, 359, 436, 496, 509, 526, 543, 582, 601, 682, 689, 744, 787, 805, 888]
[64, 122, 239, 278, 304, 319, 339, 354, 357, 376, 422, 549, 610, 621, 695, 743, 767, 807, 825, 849, 873, 879]

[6, 7, 13, 129, 209, 228, 238, 292, 359, 436, 496, 509, 526, 543, 582, 601, 682, 689, 744, 787, 805, 888]
[5, 16, 35, 47, 49, 60, 62, 63, 64, 69, 75, 94, 102, 109, 121, 122, 132, 142, 145, 162, 166, 175, 186, 202, 216, 218, 237, 239, 249, 258, 263, 264, 278, 280, 285, 304, 311, 315, 317, 319, 323, 326, 339, 343, 350, 354, 357, 358, 376, 382, 386, 397, 404, 405, 406, 419, 422, 458, 460, 461, 468, 469, 478, 479, 499, 506, 510, 512, 535, 549, 552, 555, 558, 564, 567, 576, 578, 610, 621, 632, 643, 644, 656, 658, 678, 691, 695, 696, 701, 704, 725, 735, 743, 749, 752, 760, 767, 778, 785, 793, 799, 801, 806, 807, 812, 825, 832, 835, 839, 843, 849, 852, 854, 861, 862, 864, 867, 872, 873, 877, 879, 883]

[1, 6, 7, 13, 14, 17, 23, 34, 43, 47, 70, 93, 103, 129, 132, 139, 141, 153, 155, 167, 173, 175, 177, 209, 220, 225, 228, 237, 238, 243, 244, 260, 273, 274, 292, 298, 312, 314, 325, 332, 359, 384, 407, 426, 428, 435, 436, 443, 450, 453, 456, 482, 484, 487, 496, 504, 507, 509, 516, 521, 524, 525, 526, 543, 552, 558, 567, 580, 582, 597, 601, 638, 682, 685, 687, 688, 689, 697, 704, 726, 744, 753, 754, 771, 783, 785, 787, 796, 805, 846, 848, 854, 867, 877, 879, 884, 888]
[5, 16, 35, 47, 49, 60, 62, 63, 64, 69, 75, 94, 102, 109, 121, 122, 132, 142, 145, 162, 166, 175, 186, 202, 216, 218, 237, 239, 249, 258, 263, 264, 278, 280, 285, 304, 311, 315, 317, 319, 323, 326, 339, 343, 350, 354, 357, 358, 376, 382, 386, 397, 404, 405, 406, 419, 422, 458, 460, 461, 468, 469, 478, 479, 499, 506, 510, 512, 535, 549, 552, 555, 558, 564, 567, 576, 578, 610, 621, 632, 643, 644, 656, 658, 678, 691, 695, 696, 701, 704, 725, 735, 743, 749, 752, 760, 767, 778, 785, 793, 799, 801, 806, 807, 812, 825, 832, 835, 839, 843, 849, 852, 854, 861, 862, 864, 867, 872, 873, 877, 879, 883]

[1, 6, 7, 13, 14, 17, 21, 23, 24, 34, 37, 43, 47, 65, 67, 70, 93, 96, 102, 103, 117, 122, 123, 129, 132, 139, 141, 150, 153, 155, 158, 159, 164, 166, 167, 169, 171, 173, 175, 177, 209, 220, 225, 228, 231, 237, 238, 243, 244, 254, 257, 260, 273, 274, 284, 286, 287, 292, 298, 302, 312, 314, 320, 325, 332, 341, 355, 358, 359, 360, 363, 382, 384, 387, 389, 404, 405, 407, 417, 426, 428, 432, 435, 436, 438, 443, 445, 450, 453, 456, 462, 470, 482, 484, 487, 495, 496, 502, 504, 507, 509, 512, 516, 519, 521, 524, 525, 526, 543, 550, 552, 558, 559, 567, 569, 579, 580, 581, 582, 587, 593, 597, 601, 625, 627, 628, 638, 643, 649, 652, 671, 677, 682, 685, 687, 688, 689, 697, 700, 704, 712, 726, 730, 744, 751, 753, 754, 759, 771, 772, 783, 785, 787, 791, 793, 795, 796, 805, 807, 833, 836, 846, 848, 854, 857, 867, 873, 877, 879, 884, 885, 888]
[5, 16, 35, 47, 49, 60, 62, 63, 64, 69, 75, 94, 102, 109, 121, 122, 132, 142, 145, 162, 166, 175, 186, 202, 216, 218, 237, 239, 249, 258, 263, 264, 278, 280, 285, 304, 311, 315, 317, 319, 323, 326, 339, 343, 350, 354, 357, 358, 376, 382, 386, 397, 404, 405, 406, 419, 422, 458, 460, 461, 468, 469, 478, 479, 499, 506, 510, 512, 535, 549, 552, 555, 558, 564, 567, 576, 578, 610, 621, 632, 643, 644, 656, 658, 678, 691, 695, 696, 701, 704, 725, 735, 743, 749, 752, 760, 767, 778, 785, 793, 799, 801, 806, 807, 812, 825, 832, 835, 839, 843, 849, 852, 854, 861, 862, 864, 867, 872, 873, 877, 879, 883]

[1, 3, 6, 7, 11, 13, 14, 17, 21, 23, 24, 34, 37, 43, 47, 53, 57, 58, 61, 65, 67, 70, 73, 80, 93, 94, 96, 102, 103, 105, 117, 122, 123, 129, 132, 139, 141, 150, 153, 155, 158, 159, 160, 164, 165, 166, 167, 169, 171, 173, 175, 177, 181, 188, 192, 195, 201, 203, 209, 215, 220, 225, 228, 231, 237, 238, 243, 244, 248, 254, 257, 260, 273, 274, 277, 284, 286, 287, 292, 295, 297, 298, 300, 302, 312, 314, 316, 319, 320, 325, 331, 332, 341, 344, 355, 356, 358, 359, 360, 363, 375, 382, 384, 386, 387, 388, 389, 390, 398, 404, 405, 406, 407, 417, 420, 426, 428, 432, 435, 436, 438, 443, 445, 448, 450, 453, 456, 462, 469, 470, 471, 477, 482, 484, 487, 491, 495, 496, 497, 502, 504, 507, 508, 509, 512, 516, 519, 521, 524, 525, 526, 528, 540, 543, 550, 552, 557, 558, 559, 567, 569, 579, 580, 581, 582, 587, 593, 597, 601, 606, 625, 627, 628, 633, 638, 641, 643, 649, 652, 671, 674, 677, 680, 682, 685, 687, 688, 689, 697, 700, 701, 702, 704, 712, 717, 724, 726, 730, 739, 744, 751, 753, 754, 759, 762, 763, 765, 769, 771, 772, 778, 783, 785, 787, 791, 793, 795, 796, 801, 805, 807, 814, 816, 821, 822, 828, 833, 836, 837, 846, 848, 849, 851, 854, 857, 858, 861, 867, 871, 873, 877, 878, 879, 881, 884, 885, 888]
[5, 16, 35, 47, 49, 60, 62, 63, 64, 69, 75, 94, 102, 109, 121, 122, 132, 142, 145, 162, 166, 175, 186, 202, 216, 218, 237, 239, 249, 258, 263, 264, 278, 280, 285, 304, 311, 315, 317, 319, 323, 326, 339, 343, 350, 354, 357, 358, 376, 382, 386, 397, 404, 405, 406, 419, 422, 458, 460, 461, 468, 469, 478, 479, 499, 506, 510, 512, 535, 549, 552, 555, 558, 564, 567, 576, 578, 610, 621, 632, 643, 644, 656, 658, 678, 691, 695, 696, 701, 704, 725, 735, 743, 749, 752, 760, 767, 778, 785, 793, 799, 801, 806, 807, 812, 825, 832, 835, 839, 843, 849, 852, 854, 861, 862, 864, 867, 872, 873, 877, 879, 883]

[1, 2, 3, 6, 7, 10, 11, 13, 14, 17, 21, 23, 24, 32, 34, 37, 38, 43, 46, 47, 48, 53, 57, 58, 61, 62, 63, 65, 67, 70, 73, 80, 83, 84, 93, 94, 96, 98, 102, 103, 105, 117, 122, 123, 129, 132, 137, 139, 141, 148, 150, 151, 153, 155, 158, 159, 160, 164, 165, 166, 167, 169, 170, 171, 173, 175, 176, 177, 181, 188, 192, 193, 195, 201, 203, 204, 209, 212, 215, 220, 225, 228, 231, 234, 237, 238, 239, 243, 244, 248, 252, 254, 257, 260, 270, 273, 274, 275, 277, 284, 286, 287, 292, 295, 297, 298, 300, 302, 311, 312, 314, 316, 319, 320, 321, 325, 331, 332, 334, 336, 341, 343, 344, 349, 355, 356, 358, 359, 360, 362, 363, 365, 368, 371, 375, 382, 384, 385, 386, 387, 388, 389, 390, 398, 404, 405, 406, 407, 417, 420, 426, 428, 430, 432, 435, 436, 438, 439, 443, 445, 448, 450, 451, 452, 453, 456, 461, 462, 469, 470, 471, 477, 482, 483, 484, 487, 491, 495, 496, 497, 502, 504, 506, 507, 508, 509, 512, 516, 519, 521, 524, 525, 526, 528, 533, 534, 535, 538, 540, 543, 544, 545, 550, 551, 552, 557, 558, 559, 561, 563, 564, 567, 569, 570, 573, 579, 580, 581, 582, 587, 591, 593, 597, 599, 601, 603, 606, 625, 627, 628, 633, 635, 636, 638, 641, 642, 643, 646, 649, 651, 652, 660, 671, 674, 677, 680, 682, 685, 687, 688, 689, 697, 700, 701, 702, 704, 705, 710, 712, 713, 717, 724, 726, 730, 739, 743, 744, 751, 753, 754, 759, 762, 763, 765, 769, 771, 772, 775, 778, 780, 783, 785, 787, 788, 790, 791, 793, 795, 796, 801, 803, 805, 807, 814, 816, 819, 821, 822, 827, 828, 833, 836, 837, 846, 848, 849, 851, 854, 857, 858, 861, 867, 871, 873, 877, 878, 879, 880, 881, 884, 885, 888]
[5, 16, 35, 47, 49, 60, 62, 63, 64, 69, 75, 94, 102, 109, 121, 122, 132, 142, 145, 162, 166, 175, 186, 202, 216, 218, 237, 239, 249, 258, 263, 264, 278, 280, 285, 304, 311, 315, 317, 319, 323, 326, 339, 343, 350, 354, 357, 358, 376, 382, 386, 397, 404, 405, 406, 419, 422, 458, 460, 461, 468, 469, 478, 479, 499, 506, 510, 512, 535, 549, 552, 555, 558, 564, 567, 576, 578, 610, 621, 632, 643, 644, 656, 658, 678, 691, 695, 696, 701, 704, 725, 735, 743, 749, 752, 760, 767, 778, 785, 793, 799, 801, 806, 807, 812, 825, 832, 835, 839, 843, 849, 852, 854, 861, 862, 864, 867, 872, 873, 877, 879, 883]

[1, 2, 3, 6, 7, 10, 11, 13, 14, 16, 17, 21, 22, 23, 24, 27, 32, 34, 37, 38, 43, 46, 47, 48, 53, 57, 58, 61, 62, 63, 65, 67, 70, 73, 80, 83, 84, 89, 90, 93, 94, 96, 98, 102, 103, 104, 105, 108, 111, 117, 122, 123, 124, 129, 132, 137, 139, 141, 148, 150, 151, 153, 155, 157, 158, 159, 160, 161, 162, 164, 165, 166, 167, 169, 170, 171, 172, 173, 175, 176, 177, 179, 181, 188, 192, 193, 195, 196, 198, 201, 203, 204, 207, 209, 212, 215, 217, 220, 225, 228, 231, 234, 235, 237, 238, 239, 243, 244, 246, 248, 252, 254, 257, 260, 269, 270, 273, 274, 275, 277, 282, 284, 285, 286, 287, 292, 295, 296, 297, 298, 300, 302, 311, 312, 314, 316, 319, 320, 321, 324, 325, 329, 331, 332, 334, 336, 340, 341, 342, 343, 344, 349, 355, 356, 358, 359, 360, 362, 363, 365, 368, 371, 375, 378, 382, 384, 385, 386, 387, 388, 389, 390, 393, 398, 400, 403, 404, 405, 406, 407, 417, 420, 422, 426, 428, 430, 431, 432, 435, 436, 438, 439, 443, 445, 447, 448, 450, 451, 452, 453, 456, 457, 461, 462, 465, 468, 469, 470, 471, 477, 478, 482, 483, 484, 485, 487, 491, 494, 495, 496, 497, 499, 502, 504, 506, 507, 508, 509, 512, 513, 516, 519, 521, 524, 525, 526, 527, 528, 533, 534, 535, 538, 540, 543, 544, 545, 547, 549, 550, 551, 552, 554, 557, 558, 559, 561, 563, 564, 567, 569, 570, 573, 579, 580, 581, 582, 587, 591, 593, 596, 597, 599, 601, 603, 604, 606, 614, 618, 619, 625, 627, 628, 631, 633, 635, 636, 638, 641, 642, 643, 646, 649, 651, 652, 660, 671, 672, 674, 676, 677, 680, 681, 682, 685, 686, 687, 688, 689, 690, 697, 700, 701, 702, 704, 705, 708, 710, 711, 712, 713, 717, 718, 724, 726, 728, 730, 736, 739, 743, 744, 746, 751, 753, 754, 759, 760, 761, 762, 763, 765, 769, 771, 772, 774, 775, 776, 778, 780, 781, 783, 785, 787, 788, 790, 791, 793, 795, 796, 801, 803, 805, 807, 810, 812, 814, 816, 819, 821, 822, 826, 827, 828, 833, 836, 837, 843, 846, 848, 849, 851, 854, 855, 857, 858, 859, 861, 867, 871, 873, 877, 878, 879, 880, 881, 884, 885, 888]
[5, 16, 35, 47, 49, 60, 62, 63, 64, 69, 75, 94, 102, 109, 121, 122, 132, 142, 145, 162, 166, 175, 186, 202, 216, 218, 237, 239, 249, 258, 263, 264, 278, 280, 285, 304, 311, 315, 317, 319, 323, 326, 339, 343, 350, 354, 357, 358, 376, 382, 386, 397, 404, 405, 406, 419, 422, 458, 460, 461, 468, 469, 478, 479, 499, 506, 510, 512, 535, 549, 552, 555, 558, 564, 567, 576, 578, 610, 621, 632, 643, 644, 656, 658, 678, 691, 695, 696, 701, 704, 725, 735, 743, 749, 752, 760, 767, 778, 785, 793, 799, 801, 806, 807, 812, 825, 832, 835, 839, 843, 849, 852, 854, 861, 862, 864, 867, 872, 873, 877, 879, 883]

[1, 2, 3, 4, 6, 7, 10, 11, 13, 14, 16, 17, 21, 22, 23, 24, 27, 28, 29, 32, 33, 34, 37, 38, 43, 46, 47, 48, 53, 54, 57, 58, 61, 62, 63, 64, 65, 67, 68, 69, 70, 71, 73, 78, 80, 83, 84, 89, 90, 93, 94, 96, 98, 99, 102, 103, 104, 105, 108, 109, 111, 112, 117, 122, 123, 124, 129, 132, 133, 137, 139, 141, 143, 148, 150, 151, 153, 154, 155, 157, 158, 159, 160, 161, 162, 163, 164, 165, 166, 167, 168, 169, 170, 171, 172, 173, 174, 175, 176, 177, 179, 181, 184, 188, 192, 193, 194, 195, 196, 198, 200, 201, 203, 204, 207, 209, 212, 213, 215, 217, 218, 220, 221, 225, 228, 231, 234, 235, 237, 238, 239, 243, 244, 246, 248, 251, 252, 254, 257, 258, 260, 263, 264, 266, 269, 270, 273, 274, 275, 277, 282, 284, 285, 286, 287, 292, 293, 295, 296, 297, 298, 300, 302, 303, 311, 312, 314, 316, 319, 320, 321, 324, 325, 329, 331, 332, 334, 336, 340, 341, 342, 343, 344, 345, 349, 353, 355, 356, 358, 359, 360, 362, 363, 365, 368, 369, 371, 375, 378, 382, 384, 385, 386, 387, 388, 389, 390, 393, 394, 398, 400, 403, 404, 405, 406, 407, 417, 420, 422, 425, 426, 428, 430, 431, 432, 435, 436, 438, 439, 443, 445, 446, 447, 448, 450, 451, 452, 453, 455, 456, 457, 461, 462, 463, 465, 466, 468, 469, 470, 471, 477, 478, 479, 480, 481, 482, 483, 484, 485, 487, 489, 491, 494, 495, 496, 497, 499, 502, 504, 506, 507, 508, 509, 510, 512, 513, 515, 516, 519, 521, 524, 525, 526, 527, 528, 533, 534, 535, 538, 540, 543, 544, 545, 547, 549, 550, 551, 552, 553, 554, 557, 558, 559, 561, 563, 564, 567, 569, 570, 571, 573, 576, 577, 578, 579, 580, 581, 582, 587, 591, 593, 596, 597, 599, 601, 603, 604, 606, 614, 618, 619, 620, 625, 627, 628, 631, 632, 633, 635, 636, 637, 638, 639, 641, 642, 643, 646, 649, 651, 652, 655, 660, 671, 672, 674, 676, 677, 680, 681, 682, 685, 686, 687, 688, 689, 690, 691, 692, 697, 700, 701, 702, 704, 705, 708, 710, 711, 712, 713, 717, 718, 722, 724, 726, 728, 730, 736, 737, 739, 741, 743, 744, 746, 751, 753, 754, 755, 759, 760, 761, 762, 763, 765, 766, 769, 771, 772, 774, 775, 776, 778, 780, 781, 783, 785, 787, 788, 790, 791, 793, 795, 796, 801, 803, 804, 805, 807, 810, 812, 814, 815, 816, 819, 821, 822, 824, 825, 826, 827, 828, 829, 830, 831, 833, 836, 837, 843, 846, 848, 849, 851, 854, 855, 857, 858, 859, 860, 861, 866, 867, 871, 873, 874, 877, 878, 879, 880, 881, 884, 885, 886, 888]
[5, 16, 35, 47, 49, 60, 62, 63, 64, 69, 75, 94, 102, 109, 121, 122, 132, 142, 145, 162, 166, 175, 186, 202, 216, 218, 237, 239, 249, 258, 263, 264, 278, 280, 285, 304, 311, 315, 317, 319, 323, 326, 339, 343, 350, 354, 357, 358, 376, 382, 386, 397, 404, 405, 406, 419, 422, 458, 460, 461, 468, 469, 478, 479, 499, 506, 510, 512, 535, 549, 552, 555, 558, 564, 567, 576, 578, 610, 621, 632, 643, 644, 656, 658, 678, 691, 695, 696, 701, 704, 725, 735, 743, 749, 752, 760, 767, 778, 785, 793, 799, 801, 806, 807, 812, 825, 832, 835, 839, 843, 849, 852, 854, 861, 862, 864, 867, 872, 873, 877, 879, 883]

[1, 2, 3, 4, 6, 7, 8, 10, 11, 13, 14, 16, 17, 21, 22, 23, 24, 27, 28, 29, 32, 33, 34, 37, 38, 43, 46, 47, 48, 51, 52, 53, 54, 56, 57, 58, 61, 62, 63, 64, 65, 67, 68, 69, 70, 71, 73, 78, 80, 83, 84, 87, 88, 89, 90, 93, 94, 96, 97, 98, 99, 102, 103, 104, 105, 107, 108, 109, 111, 112, 115, 117, 118, 122, 123, 124, 129, 132, 133, 136, 137, 139, 141, 143, 148, 150, 151, 153, 154, 155, 157, 158, 159, 160, 161, 162, 163, 164, 165, 166, 167, 168, 169, 170, 171, 172, 173, 174, 175, 176, 177, 178, 179, 181, 184, 186, 187, 188, 192, 193, 194, 195, 196, 197, 198, 199, 200, 201, 203, 204, 207, 208, 209, 212, 213, 215, 217, 218, 220, 221, 225, 228, 231, 232, 234, 235, 237, 238, 239, 243, 244, 246, 248, 251, 252, 254, 257, 258, 260, 263, 264, 266, 269, 270, 273, 274, 275, 277, 281, 282, 284, 285, 286, 287, 292, 293, 294, 295, 296, 297, 298, 300, 302, 303, 304, 310, 311, 312, 313, 314, 316, 319, 320, 321, 322, 324, 325, 329, 331, 332, 334, 335, 336, 340, 341, 342, 343, 344, 345, 346, 347, 349, 353, 355, 356, 358, 359, 360, 362, 363, 364, 365, 367, 368, 369, 371, 375, 376, 378, 380, 382, 384, 385, 386, 387, 388, 389, 390, 392, 393, 394, 398, 400, 402, 403, 404, 405, 406, 407, 411, 413, 414, 417, 420, 422, 424, 425, 426, 428, 430, 431, 432, 434, 435, 436, 437, 438, 439, 441, 443, 445, 446, 447, 448, 450, 451, 452, 453, 455, 456, 457, 458, 461, 462, 463, 465, 466, 468, 469, 470, 471, 477, 478, 479, 480, 481, 482, 483, 484, 485, 487, 488, 489, 490, 491, 492, 494, 495, 496, 497, 499, 501, 502, 504, 506, 507, 508, 509, 510, 512, 513, 515, 516, 519, 521, 524, 525, 526, 527, 528, 533, 534, 535, 537, 538, 540, 543, 544, 545, 547, 549, 550, 551, 552, 553, 554, 557, 558, 559, 561, 562, 563, 564, 567, 569, 570, 571, 573, 576, 577, 578, 579, 580, 581, 582, 584, 587, 591, 592, 593, 596, 597, 599, 601, 602, 603, 604, 606, 607, 609, 613, 614, 617, 618, 619, 620, 622, 624, 625, 627, 628, 631, 632, 633, 635, 636, 637, 638, 639, 641, 642, 643, 646, 648, 649, 651, 652, 655, 660, 661, 665, 671, 672, 674, 675, 676, 677, 679, 680, 681, 682, 684, 685, 686, 687, 688, 689, 690, 691, 692, 693, 694, 697, 700, 701, 702, 704, 705, 708, 710, 711, 712, 713, 716, 717, 718, 722, 724, 726, 728, 730, 732, 735, 736, 737, 738, 739, 741, 743, 744, 746, 751, 753, 754, 755, 758, 759, 760, 761, 762, 763, 765, 766, 769, 770, 771, 772, 774, 775, 776, 777, 778, 780, 781, 783, 785, 787, 788, 790, 791, 793, 794, 795, 796, 801, 803, 804, 805, 807, 810, 811, 812, 814, 815, 816, 818, 819, 821, 822, 824, 825, 826, 827, 828, 829, 830, 831, 833, 836, 837, 840, 843, 846, 848, 849, 851, 853, 854, 855, 857, 858, 859, 860, 861, 866, 867, 869, 871, 873, 874, 877, 878, 879, 880, 881, 884, 885, 886, 888]
[5, 16, 35, 47, 49, 60, 62, 63, 64, 69, 75, 94, 102, 109, 121, 122, 132, 142, 145, 162, 166, 175, 186, 202, 216, 218, 237, 239, 249, 258, 263, 264, 278, 280, 285, 304, 311, 315, 317, 319, 323, 326, 339, 343, 350, 354, 357, 358, 376, 382, 386, 397, 404, 405, 406, 419, 422, 458, 460, 461, 468, 469, 478, 479, 499, 506, 510, 512, 535, 549, 552, 555, 558, 564, 567, 576, 578, 610, 621, 632, 643, 644, 656, 658, 678, 691, 695, 696, 701, 704, 725, 735, 743, 749, 752, 760, 767, 778, 785, 793, 799, 801, 806, 807, 812, 825, 832, 835, 839, 843, 849, 852, 854, 861, 862, 864, 867, 872, 873, 877, 879, 883]

[0, 1, 2, 3, 4, 6, 7, 8, 9, 10, 11, 13, 14, 16, 17, 21, 22, 23, 24, 27, 28, 29, 32, 33, 34, 35, 37, 38, 40, 43, 46, 47, 48, 50, 51, 52, 53, 54, 56, 57, 58, 60, 61, 62, 63, 64, 65, 66, 67, 68, 69, 70, 71, 73, 75, 78, 79, 80, 81, 82, 83, 84, 86, 87, 88, 89, 90, 93, 94, 96, 97, 98, 99, 102, 103, 104, 105, 106, 107, 108, 109, 111, 112, 115, 116, 117, 118, 121, 122, 123, 124, 129, 131, 132, 133, 136, 137, 139, 140, 141, 143, 144, 148, 150, 151, 152, 153, 154, 155, 156, 157, 158, 159, 160, 161, 162, 163, 164, 165, 166, 167, 168, 169, 170, 171, 172, 173, 174, 175, 176, 177, 178, 179, 181, 184, 185, 186, 187, 188, 189, 190, 192, 193, 194, 195, 196, 197, 198, 199, 200, 201, 203, 204, 205, 206, 207, 208, 209, 210, 212, 213, 215, 217, 218, 220, 221, 222, 225, 227, 228, 231, 232, 234, 235, 237, 238, 239, 242, 243, 244, 246, 248, 251, 252, 254, 257, 258, 260, 263, 264, 266, 269, 270, 273, 274, 275, 276, 277, 281, 282, 284, 285, 286, 287, 289, 290, 291, 292, 293, 294, 295, 296, 297, 298, 300, 302, 303, 304, 310, 311, 312, 313, 314, 316, 319, 320, 321, 322, 324, 325, 328, 329, 330, 331, 332, 334, 335, 336, 340, 341, 342, 343, 344, 345, 346, 347, 348, 349, 350, 351, 353, 355, 356, 358, 359, 360, 362, 363, 364, 365, 367, 368, 369, 371, 372, 375, 376, 378, 380, 382, 384, 385, 386, 387, 388, 389, 390, 392, 393, 394, 396, 398, 400, 402, 403, 404, 405, 406, 407, 409, 411, 413, 414, 415, 417, 419, 420, 421, 422, 423, 424, 425, 426, 428, 429, 430, 431, 432, 434, 435, 436, 437, 438, 439, 441, 443, 445, 446, 447, 448, 450, 451, 452, 453, 455, 456, 457, 458, 459, 461, 462, 463, 465, 466, 468, 469, 470, 471, 473, 474, 477, 478, 479, 480, 481, 482, 483, 484, 485, 487, 488, 489, 490, 491, 492, 494, 495, 496, 497, 499, 500, 501, 502, 504, 506, 507, 508, 509, 510, 512, 513, 514, 515, 516, 518, 519, 521, 524, 525, 526, 527, 528, 529, 533, 534, 535, 537, 538, 540, 543, 544, 545, 547, 548, 549, 550, 551, 552, 553, 554, 557, 558, 559, 561, 562, 563, 564, 567, 569, 570, 571, 573, 574, 576, 577, 578, 579, 580, 581, 582, 584, 587, 591, 592, 593, 596, 597, 599, 601, 602, 603, 604, 606, 607, 609, 613, 614, 615, 617, 618, 619, 620, 621, 622, 624, 625, 627, 628, 630, 631, 632, 633, 635, 636, 637, 638, 639, 640, 641, 642, 643, 645, 646, 648, 649, 651, 652, 655, 660, 661, 665, 666, 667, 670, 671, 672, 674, 675, 676, 677, 679, 680, 681, 682, 683, 684, 685, 686, 687, 688, 689, 690, 691, 692, 693, 694, 697, 700, 701, 702, 704, 705, 707, 708, 710, 711, 712, 713, 716, 717, 718, 719, 722, 724, 725, 726, 727, 728, 730, 731, 732, 735, 736, 737, 738, 739, 741, 743, 744, 746, 749, 750, 751, 753, 754, 755, 758, 759, 760, 761, 762, 763, 764, 765, 766, 769, 770, 771, 772, 774, 775, 776, 777, 778, 780, 781, 783, 785, 787, 788, 790, 791, 792, 793, 794, 795, 796, 799, 801, 803, 804, 805, 807, 810, 811, 812, 814, 815, 816, 818, 819, 821, 822, 824, 825, 826, 827, 828, 829, 830, 831, 833, 836, 837, 840, 843, 846, 848, 849, 850, 851, 852, 853, 854, 855, 857, 858, 859, 860, 861, 863, 866, 867, 869, 870, 871, 873, 874, 877, 878, 879, 880, 881, 883, 884, 885, 886, 888]
[5, 16, 35, 47, 49, 60, 62, 63, 64, 69, 75, 94, 102, 109, 121, 122, 132, 142, 145, 162, 166, 175, 186, 202, 216, 218, 237, 239, 249, 258, 263, 264, 278, 280, 285, 304, 311, 315, 317, 319, 323, 326, 339, 343, 350, 354, 357, 358, 376, 382, 386, 397, 404, 405, 406, 419, 422, 458, 460, 461, 468, 469, 478, 479, 499, 506, 510, 512, 535, 549, 552, 555, 558, 564, 567, 576, 578, 610, 621, 632, 643, 644, 656, 658, 678, 691, 695, 696, 701, 704, 725, 735, 743, 749, 752, 760, 767, 778, 785, 793, 799, 801, 806, 807, 812, 825, 832, 835, 839, 843, 849, 852, 854, 861, 862, 864, 867, 872, 873, 877, 879, 883]

[0, 1, 2, 3, 4, 5, 6, 7, 8, 9, 10, 11, 13, 14, 15, 16, 17, 19, 21, 22, 23, 24, 26, 27, 28, 29, 32, 33, 34, 35, 37, 38, 39, 40, 43, 46, 47, 48, 50, 51, 52, 53, 54, 56, 57, 58, 60, 61, 62, 63, 64, 65, 66, 67, 68, 69, 70, 71, 73, 75, 77, 78, 79, 80, 81, 82, 83, 84, 85, 86, 87, 88, 89, 90, 93, 94, 96, 97, 98, 99, 102, 103, 104, 105, 106, 107, 108, 109, 111, 112, 114, 115, 116, 117, 118, 121, 122, 123, 124, 126, 128, 129, 130, 131, 132, 133, 136, 137, 139, 140, 141, 143, 144, 145, 146, 148, 150, 151, 152, 153, 154, 155, 156, 157, 158, 159, 160, 161, 162, 163, 164, 165, 166, 167, 168, 169, 170, 171, 172, 173, 174, 175, 176, 177, 178, 179, 181, 183, 184, 185, 186, 187, 188, 189, 190, 191, 192, 193, 194, 195, 196, 197, 198, 199, 200, 201, 203, 204, 205, 206, 207, 208, 209, 210, 212, 213, 214, 215, 217, 218, 220, 221, 222, 223, 225, 227, 228, 231, 232, 234, 235, 236, 237, 238, 239, 242, 243, 244, 246, 248, 249, 251, 252, 253, 254, 255, 257, 258, 260, 263, 264, 266, 269, 270, 273, 274, 275, 276, 277, 279, 281, 282, 284, 285, 286, 287, 288, 289, 290, 291, 292, 293, 294, 295, 296, 297, 298, 300, 301, 302, 303, 304, 306, 310, 311, 312, 313, 314, 315, 316, 319, 320, 321, 322, 324, 325, 328, 329, 330, 331, 332, 334, 335, 336, 337, 340, 341, 342, 343, 344, 345, 346, 347, 348, 349, 350, 351, 353, 354, 355, 356, 357, 358, 359, 360, 362, 363, 364, 365, 366, 367, 368, 369, 371, 372, 375, 376, 377, 378, 380, 382, 383, 384, 385, 386, 387, 388, 389, 390, 391, 392, 393, 394, 396, 398, 399, 400, 401, 402, 403, 404, 405, 406, 407, 409, 411, 413, 414, 415, 417, 419, 420, 421, 422, 423, 424, 425, 426, 428, 429, 430, 431, 432, 434, 435, 436, 437, 438, 439, 441, 442, 443, 445, 446, 447, 448, 450, 451, 452, 453, 455, 456, 457, 458, 459, 461, 462, 463, 465, 466, 468, 469, 470, 471, 472, 473, 474, 475, 477, 478, 479, 480, 481, 482, 483, 484, 485, 487, 488, 489, 490, 491, 492, 493, 494, 495, 496, 497, 499, 500, 501, 502, 504, 506, 507, 508, 509, 510, 512, 513, 514, 515, 516, 517, 518, 519, 521, 522, 524, 525, 526, 527, 528, 529, 532, 533, 534, 535, 536, 537, 538, 540, 542, 543, 544, 545, 547, 548, 549, 550, 551, 552, 553, 554, 555, 557, 558, 559, 560, 561, 562, 563, 564, 565, 567, 569, 570, 571, 572, 573, 574, 576, 577, 578, 579, 580, 581, 582, 584, 587, 590, 591, 592, 593, 596, 597, 598, 599, 601, 602, 603, 604, 605, 606, 607, 609, 610, 611, 613, 614, 615, 616, 617, 618, 619, 620, 621, 622, 623, 624, 625, 627, 628, 629, 630, 631, 632, 633, 635, 636, 637, 638, 639, 640, 641, 642, 643, 645, 646, 648, 649, 651, 652, 655, 660, 661, 663, 664, 665, 666, 667, 668, 670, 671, 672, 673, 674, 675, 676, 677, 679, 680, 681, 682, 683, 684, 685, 686, 687, 688, 689, 690, 691, 692, 693, 694, 697, 698, 700, 701, 702, 703, 704, 705, 707, 708, 710, 711, 712, 713, 716, 717, 718, 719, 720, 721, 722, 724, 725, 726, 727, 728, 729, 730, 731, 732, 733, 735, 736, 737, 738, 739, 740, 741, 743, 744, 746, 747, 749, 750, 751, 753, 754, 755, 758, 759, 760, 761, 762, 763, 764, 765, 766, 769, 770, 771, 772, 774, 775, 776, 777, 778, 780, 781, 783, 785, 786, 787, 788, 790, 791, 792, 793, 794, 795, 796, 799, 801, 802, 803, 804, 805, 807, 808, 810, 811, 812, 814, 815, 816, 818, 819, 821, 822, 824, 825, 826, 827, 828, 829, 830, 831, 832, 833, 834, 836, 837, 840, 841, 843, 844, 846, 847, 848, 849, 850, 851, 852, 853, 854, 855, 857, 858, 859, 860, 861, 862, 863, 866, 867, 869, 870, 871, 872, 873, 874, 876, 877, 878, 879, 880, 881, 883, 884, 885, 886, 888]
[5, 16, 35, 47, 49, 60, 62, 63, 64, 69, 75, 94, 102, 109, 121, 122, 132, 142, 145, 162, 166, 175, 186, 202, 216, 218, 237, 239, 249, 258, 263, 264, 278, 280, 285, 304, 311, 315, 317, 319, 323, 326, 339, 343, 350, 354, 357, 358, 376, 382, 386, 397, 404, 405, 406, 419, 422, 458, 460, 461, 468, 469, 478, 479, 499, 506, 510, 512, 535, 549, 552, 555, 558, 564, 567, 576, 578, 610, 621, 632, 643, 644, 656, 658, 678, 691, 695, 696, 701, 704, 725, 735, 743, 749, 752, 760, 767, 778, 785, 793, 799, 801, 806, 807, 812, 825, 832, 835, 839, 843, 849, 852, 854, 861, 862, 864, 867, 872, 873, 877, 879, 883]

[0, 1, 2, 3, 4, 5, 6, 7, 8, 9, 10, 11, 13, 14, 15, 16, 17, 19, 21, 22, 23, 24, 26, 27, 28, 29, 32, 33, 34, 35, 36, 37, 38, 39, 40, 43, 44, 46, 47, 48, 50, 51, 52, 53, 54, 56, 57, 58, 60, 61, 62, 63, 64, 65, 66, 67, 68, 69, 70, 71, 72, 73, 74, 75, 77, 78, 79, 80, 81, 82, 83, 84, 85, 86, 87, 88, 89, 90, 91, 92, 93, 94, 95, 96, 97, 98, 99, 100, 102, 103, 104, 105, 106, 107, 108, 109, 110, 111, 112, 113, 114, 115, 116, 117, 118, 119, 120, 121, 122, 123, 124, 125, 126, 128, 129, 130, 131, 132, 133, 135, 136, 137, 138, 139, 140, 141, 142, 143, 144, 145, 146, 148, 149, 150, 151, 152, 153, 154, 155, 156, 157, 158, 159, 160, 161, 162, 163, 164, 165, 166, 167, 168, 169, 170, 171, 172, 173, 174, 175, 176, 177, 178, 179, 181, 183, 184, 185, 186, 187, 188, 189, 190, 191, 192, 193, 194, 195, 196, 197, 198, 199, 200, 201, 203, 204, 205, 206, 207, 208, 209, 210, 212, 213, 214, 215, 217, 218, 220, 221, 222, 223, 225, 227, 228, 231, 232, 234, 235, 236, 237, 238, 239, 240, 242, 243, 244, 246, 248, 249, 250, 251, 252, 253, 254, 255, 256, 257, 258, 260, 262, 263, 264, 265, 266, 269, 270, 272, 273, 274, 275, 276, 277, 279, 280, 281, 282, 284, 285, 286, 287, 288, 289, 290, 291, 292, 293, 294, 295, 296, 297, 298, 300, 301, 302, 303, 304, 305, 306, 307, 310, 311, 312, 313, 314, 315, 316, 319, 320, 321, 322, 324, 325, 326, 328, 329, 330, 331, 332, 333, 334, 335, 336, 337, 339, 340, 341, 342, 343, 344, 345, 346, 347, 348, 349, 350, 351, 352, 353, 354, 355, 356, 357, 358, 359, 360, 362, 363, 364, 365, 366, 367, 368, 369, 370, 371, 372, 373, 375, 376, 377, 378, 380, 382, 383, 384, 385, 386, 387, 388, 389, 390, 391, 392, 393, 394, 395, 396, 398, 399, 400, 401, 402, 403, 404, 405, 406, 407, 408, 409, 410, 411, 413, 414, 415, 416, 417, 418, 419, 420, 421, 422, 423, 424, 425, 426, 427, 428, 429, 430, 431, 432, 433, 434, 435, 436, 437, 438, 439, 440, 441, 442, 443, 444, 445, 446, 447, 448, 449, 450, 451, 452, 453, 454, 455, 456, 457, 458, 459, 461, 462, 463, 465, 466, 468, 469, 470, 471, 472, 473, 474, 475, 477, 478, 479, 480, 481, 482, 483, 484, 485, 487, 488, 489, 490, 491, 492, 493, 494, 495, 496, 497, 498, 499, 500, 501, 502, 503, 504, 506, 507, 508, 509, 510, 512, 513, 514, 515, 516, 517, 518, 519, 521, 522, 524, 525, 526, 527, 528, 529, 530, 531, 532, 533, 534, 535, 536, 537, 538, 539, 540, 542, 543, 544, 545, 547, 548, 549, 550, 551, 552, 553, 554, 555, 556, 557, 558, 559, 560, 561, 562, 563, 564, 565, 567, 568, 569, 570, 571, 572, 573, 574, 576, 577, 578, 579, 580, 581, 582, 583, 584, 587, 589, 590, 591, 592, 593, 596, 597, 598, 599, 601, 602, 603, 604, 605, 606, 607, 609, 610, 611, 613, 614, 615, 616, 617, 618, 619, 620, 621, 622, 623, 624, 625, 627, 628, 629, 630, 631, 632, 633, 635, 636, 637, 638, 639, 640, 641, 642, 643, 644, 645, 646, 647, 648, 649, 650, 651, 652, 653, 655, 656, 660, 661, 663, 664, 665, 666, 667, 668, 669, 670, 671, 672, 673, 674, 675, 676, 677, 679, 680, 681, 682, 683, 684, 685, 686, 687, 688, 689, 690, 691, 692, 693, 694, 697, 698, 700, 701, 702, 703, 704, 705, 707, 708, 709, 710, 711, 712, 713, 716, 717, 718, 719, 720, 721, 722, 723, 724, 725, 726, 727, 728, 729, 730, 731, 732, 733, 735, 736, 737, 738, 739, 740, 741, 742, 743, 744, 746, 747, 749, 750, 751, 752, 753, 754, 755, 758, 759, 760, 761, 762, 763, 764, 765, 766, 768, 769, 770, 771, 772, 774, 775, 776, 777, 778, 779, 780, 781, 783, 785, 786, 787, 788, 789, 790, 791, 792, 793, 794, 795, 796, 798, 799, 801, 802, 803, 804, 805, 807, 808, 810, 811, 812, 814, 815, 816, 817, 818, 819, 821, 822, 824, 825, 826, 827, 828, 829, 830, 831, 832, 833, 834, 835, 836, 837, 838, 839, 840, 841, 843, 844, 845, 846, 847, 848, 849, 850, 851, 852, 853, 854, 855, 857, 858, 859, 860, 861, 862, 863, 866, 867, 869, 870, 871, 872, 873, 874, 875, 876, 877, 878, 879, 880, 881, 882, 883, 884, 885, 886, 887, 888, 889]
[5, 16, 35, 47, 49, 60, 62, 63, 64, 69, 75, 94, 102, 109, 121, 122, 132, 142, 145, 162, 166, 175, 186, 202, 216, 218, 237, 239, 249, 258, 263, 264, 278, 280, 285, 304, 311, 315, 317, 319, 323, 326, 339, 343, 350, 354, 357, 358, 376, 382, 386, 397, 404, 405, 406, 419, 422, 458, 460, 461, 468, 469, 478, 479, 499, 506, 510, 512, 535, 549, 552, 555, 558, 564, 567, 576, 578, 610, 621, 632, 643, 644, 656, 658, 678, 691, 695, 696, 701, 704, 725, 735, 743, 749, 752, 760, 767, 778, 785, 793, 799, 801, 806, 807, 812, 825, 832, 835, 839, 843, 849, 852, 854, 861, 862, 864, 867, 872, 873, 877, 879, 883]

