[6, 109, 137, 145, 193, 208, 211, 248, 252, 269, 552, 556, 595, 602, 605, 619, 633, 664, 756, 795, 816, 838]
[5, 20, 77, 190, 225, 267, 290, 296, 315, 325, 433, 470, 498, 530, 531, 543, 597, 609, 702, 711, 804, 876]

[6, 109, 137, 145, 193, 208, 211, 248, 252, 269, 552, 556, 595, 602, 605, 619, 633, 664, 756, 795, 816, 838]
[5, 20, 27, 32, 36, 42, 58, 68, 77, 88, 91, 94, 99, 100, 104, 106, 118, 135, 140, 163, 172, 185, 190, 191, 192, 197, 202, 205, 209, 215, 221, 225, 239, 249, 260, 267, 290, 291, 296, 301, 303, 313, 315, 319, 325, 327, 329, 336, 358, 359, 370, 377, 379, 380, 388, 394, 395, 401, 404, 415, 418, 427, 433, 435, 436, 448, 449, 459, 470, 472, 489, 493, 498, 505, 512, 515, 517, 530, 531, 543, 545, 558, 568, 572, 574, 580, 594, 597, 609, 611, 621, 634, 654, 666, 668, 677, 686, 690, 691, 702, 711, 712, 726, 727, 729, 737, 749, 750, 759, 763, 773, 774, 776, 794, 800, 804, 821, 847, 853, 875, 876, 883]

[0, 2, 6, 8, 24, 50, 67, 82, 84, 86, 91, 92, 94, 95, 97, 105, 109, 113, 127, 128, 137, 145, 171, 193, 202, 203, 204, 205, 208, 211, 217, 234, 239, 240, 248, 251, 252, 269, 277, 333, 346, 351, 358, 367, 370, 376, 413, 419, 421, 430, 444, 458, 473, 477, 478, 487, 489, 498, 518, 519, 521, 524, 530, 538, 541, 549, 552, 556, 566, 595, 602, 603, 605, 619, 633, 635, 643, 660, 663, 664, 671, 690, 697, 698, 753, 756, 757, 766, 795, 804, 816, 830, 838, 851, 858, 871, 879]
[5, 20, 27, 32, 36, 42, 58, 68, 77, 88, 91, 94, 99, 100, 104, 106, 118, 135, 140, 163, 172, 185, 190, 191, 192, 197, 202, 205, 209, 215, 221, 225, 239, 249, 260, 267, 290, 291, 296, 301, 303, 313, 315, 319, 325, 327, 329, 336, 358, 359, 370, 377, 379, 380, 388, 394, 395, 401, 404, 415, 418, 427, 433, 435, 436, 448, 449, 459, 470, 472, 489, 493, 498, 505, 512, 515, 517, 530, 531, 543, 545, 558, 568, 572, 574, 580, 594, 597, 609, 611, 621, 634, 654, 666, 668, 677, 686, 690, 691, 702, 711, 712, 726, 727, 729, 737, 749, 750, 759, 763, 773, 774, 776, 794, 800, 804, 821, 847, 853, 875, 876, 883]

[0, 2, 4, 6, 8, 15, 23, 24, 28, 30, 32, 36, 41, 50, 67, 68, 69, 76, 82, 84, 86, 91, 92, 94, 95, 97, 105, 109, 113, 118, 124, 127, 128, 136, 137, 138, 142, 143, 145, 167, 171, 173, 182, 193, 195, 198, 201, 202, 203, 204, 205, 208, 211, 217, 234, 239, 240, 241, 248, 249, 251, 252, 259, 269, 275, 277, 300, 301, 308, 321, 333, 346, 351, 358, 365, 367, 370, 376, 388, 390, 403, 410, 411, 413, 419, 421, 430, 438, 441, 443, 444, 457, 458, 473, 476, 477, 478, 487, 489, 496, 498, 506, 511, 518, 519, 521, 524, 528, 530, 532, 535, 538, 541, 549, 552, 556, 566, 572, 578, 579, 595, 602, 603, 605, 612, 619, 628, 630, 633, 635, 643, 644, 649, 660, 663, 664, 671, 681, 690, 697, 698, 709, 712, 714, 750, 753, 756, 757, 758, 766, 778, 780, 782, 789, 795, 804, 805, 816, 821, 824, 830, 837, 838, 839, 840, 845, 847, 851, 858, 859, 871, 877, 879, 880]
[5, 20, 27, 32, 36, 42, 58, 68, 77, 88, 91, 94, 99, 100, 104, 106, 118, 135, 140, 163, 172, 185, 190, 191, 192, 197, 202, 205, 209, 215, 221, 225, 239, 249, 260, 267, 290, 291, 296, 301, 303, 313, 315, 319, 325, 327, 329, 336, 358, 359, 370, 377, 379, 380, 388, 394, 395, 401, 404, 415, 418, 427, 433, 435, 436, 448, 449, 459, 470, 472, 489, 493, 498, 505, 512, 515, 517, 530, 531, 543, 545, 558, 568, 572, 574, 580, 594, 597, 609, 611, 621, 634, 654, 666, 668, 677, 686, 690, 691, 702, 711, 712, 726, 727, 729, 737, 749, 750, 759, 763, 773, 774, 776, 794, 800, 804, 821, 847, 853, 875, 876, 883]

[0, 1, 2, 3, 4, 6, 8, 13, 15, 17, 18, 20, 21, 23, 24, 28, 30, 32, 36, 37, 41, 50, 61, 62, 66, 67, 68, 69, 73, 76, 82, 84, 86, 91, 92, 94, 95, 97, 105, 109, 113, 114, 118, 124, 127, 128, 130, 136, 137, 138, 142, 143, 145, 163, 167, 171, 173, 174, 182, 185, 193, 195, 197, 198, 201, 202, 203, 204, 205, 207, 208, 209, 211, 214, 217, 221, 231, 234, 239, 240, 241, 248, 249, 251, 252, 259, 269, 273, 275, 277, 281, 300, 301, 308, 317, 319, 321, 323, 325, 328, 331, 333, 342, 346, 349, 351, 355, 358, 361, 365, 367, 370, 376, 386, 388, 390, 396, 403, 407, 410, 411, 413, 419, 421, 430, 438, 441, 443, 444, 453, 455, 456, 457, 458, 473, 476, 477, 478, 485, 486, 487, 488, 489, 492, 496, 498, 501, 506, 511, 518, 519, 521, 524, 528, 530, 531, 532, 535, 538, 541, 549, 552, 556, 566, 567, 569, 572, 578, 579, 581, 595, 597, 602, 603, 605, 607, 610, 612, 615, 619, 628, 630, 633, 635, 639, 643, 644, 649, 650, 653, 660, 662, 663, 664, 670, 671, 681, 689, 690, 697, 698, 703, 709, 712, 714, 721, 726, 731, 738, 741, 748, 750, 753, 756, 757, 758, 763, 766, 778, 779, 780, 782, 789, 794, 795, 804, 805, 816, 821, 824, 825, 830, 832, 835, 837, 838, 839, 840, 843, 845, 847, 851, 858, 859, 871, 877, 879, 880, 882]
[5, 20, 27, 32, 36, 42, 58, 68, 77, 88, 91, 94, 99, 100, 104, 106, 118, 135, 140, 163, 172, 185, 190, 191, 192, 197, 202, 205, 209, 215, 221, 225, 239, 249, 260, 267, 290, 291, 296, 301, 303, 313, 315, 319, 325, 327, 329, 336, 358, 359, 370, 377, 379, 380, 388, 394, 395, 401, 404, 415, 418, 427, 433, 435, 436, 448, 449, 459, 470, 472, 489, 493, 498, 505, 512, 515, 517, 530, 531, 543, 545, 558, 568, 572, 574, 580, 594, 597, 609, 611, 621, 634, 654, 666, 668, 677, 686, 690, 691, 702, 711, 712, 726, 727, 729, 737, 749, 750, 759, 763, 773, 774, 776, 794, 800, 804, 821, 847, 853, 875, 876, 883]

[0, 1, 2, 3, 4, 6, 8, 9, 13, 15, 17, 18, 20, 21, 23, 24, 26, 28, 30, 32, 33, 36, 37, 41, 50, 61, 62, 63, 66, 67, 68, 69, 73, 76, 81, 82, 84, 86, 87, 91, 92, 94, 95, 97, 105, 107, 108, 109, 113, 114, 118, 119, 120, 123, 124, 127, 128, 130, 136, 137, 138, 142, 143, 145, 152, 158, 159, 163, 165, 167, 171, 173, 174, 178, 179, 182, 185, 189, 193, 195, 196, 197, 198, 201, 202, 203, 204, 205, 207, 208, 209, 211, 214, 217, 221, 230, 231, 234, 239, 240, 241, 248, 249, 251, 252, 254, 255, 259, 260, 267, 269, 273, 275, 277, 281, 300, 301, 303, 305, 308, 314, 317, 319, 321, 323, 325, 328, 329, 331, 333, 342, 346, 347, 349, 351, 355, 358, 361, 365, 367, 370, 376, 386, 388, 390, 396, 397, 403, 407, 410, 411, 413, 417, 419, 421, 425, 428, 430, 438, 441, 443, 444, 448, 453, 455, 456, 457, 458, 469, 473, 476, 477, 478, 480, 481, 485, 486, 487, 488, 489, 491, 492, 495, 496, 498, 500, 501, 506, 511, 512, 513, 515, 517, 518, 519, 520, 521, 524, 527, 528, 529, 530, 531, 532, 533, 535, 538, 539, 541, 542, 549, 552, 554, 556, 566, 567, 569, 572, 578, 579, 581, 582, 586, 594, 595, 597, 602, 603, 605, 607, 609, 610, 612, 615, 616, 618, 619, 628, 630, 633, 635, 639, 640, 643, 644, 647, 649, 650, 653, 660, 662, 663, 664, 670, 671, 681, 684, 689, 690, 694, 697, 698, 699, 700, 703, 704, 707, 709, 712, 714, 715, 721, 726, 731, 738, 741, 747, 748, 750, 753, 755, 756, 757, 758, 761, 763, 766, 767, 778, 779, 780, 782, 789, 794, 795, 804, 805, 811, 813, 816, 819, 821, 824, 825, 830, 832, 835, 837, 838, 839, 840, 843, 845, 847, 851, 858, 859, 871, 876, 877, 879, 880, 882, 889]
[5, 20, 27, 32, 36, 42, 58, 68, 77, 88, 91, 94, 99, 100, 104, 106, 118, 135, 140, 163, 172, 185, 190, 191, 192, 197, 202, 205, 209, 215, 221, 225, 239, 249, 260, 267, 290, 291, 296, 301, 303, 313, 315, 319, 325, 327, 329, 336, 358, 359, 370, 377, 379, 380, 388, 394, 395, 401, 404, 415, 418, 427, 433, 435, 436, 448, 449, 459, 470, 472, 489, 493, 498, 505, 512, 515, 517, 530, 531, 543, 545, 558, 568, 572, 574, 580, 594, 597, 609, 611, 621, 634, 654, 666, 668, 677, 686, 690, 691, 702, 711, 712, 726, 727, 729, 737, 749, 750, 759, 763, 773, 774, 776, 794, 800, 804, 821, 847, 853, 875, 876, 883]

[0, 1, 2, 3, 4, 6, 8, 9, 13, 15, 17, 18, 20, 21, 23, 24, 26, 28, 30, 32, 33, 35, 36, 37, 40, 41, 45, 47, 50, 52, 61, 62, 63, 66, 67, 68, 69, 73, 76, 81, 82, 84, 86, 87, 91, 92, 94, 95, 97, 98, 105, 106, 107, 108, 109, 112, 113, 114, 118, 119, 120, 123, 124, 127, 128, 129, 130, 136, 137, 138, 141, 142, 143, 145, 152, 157, 158, 159, 162, 163, 165, 167, 169, 171, 173, 174, 178, 179, 180, 182, 185, 186, 189, 193, 195, 196, 197, 198, 201, 202, 203, 204, 205, 207, 208, 209, 211, 212, 214, 217, 221, 223, 224, 227, 230, 231, 234, 239, 240, 241, 245, 246, 248, 249, 251, 252, 254, 255, 257, 259, 260, 267, 269, 273, 275, 277, 281, 285, 293, 300, 301, 302, 303, 305, 308, 310, 314, 317, 318, 319, 320, 321, 323, 325, 326, 328, 329, 331, 333, 342, 346, 347, 349, 351, 354, 355, 358, 360, 361, 364, 365, 367, 370, 372, 376, 386, 387, 388, 390, 396, 397, 398, 400, 403, 406, 407, 409, 410, 411, 413, 417, 419, 421, 425, 426, 428, 430, 434, 438, 439, 441, 443, 444, 448, 453, 455, 456, 457, 458, 469, 473, 476, 477, 478, 480, 481, 483, 485, 486, 487, 488, 489, 491, 492, 493, 495, 496, 498, 500, 501, 506, 508, 511, 512, 513, 515, 517, 518, 519, 520, 521, 522, 524, 527, 528, 529, 530, 531, 532, 533, 534, 535, 536, 538, 539, 541, 542, 547, 549, 552, 554, 555, 556, 562, 566, 567, 568, 569, 572, 578, 579, 581, 582, 585, 586, 593, 594, 595, 597, 599, 602, 603, 605, 607, 609, 610, 612, 615, 616, 618, 619, 623, 628, 630, 633, 635, 639, 640, 642, 643, 644, 647, 648, 649, 650, 653, 659, 660, 662, 663, 664, 670, 671, 679, 681, 684, 689, 690, 694, 697, 698, 699, 700, 703, 704, 707, 709, 712, 714, 715, 721, 725, 726, 731, 738, 741, 747, 748, 750, 752, 753, 755, 756, 757, 758, 761, 763, 764, 766, 767, 774, 775, 778, 779, 780, 782, 789, 792, 794, 795, 804, 805, 810, 811, 813, 816, 817, 819, 821, 824, 825, 830, 832, 835, 837, 838, 839, 840, 843, 845, 847, 851, 852, 858, 859, 861, 862, 863, 867, 870, 871, 875, 876, 877, 878, 879, 880, 882, 889]
[5, 20, 27, 32, 36, 42, 58, 68, 77, 88, 91, 94, 99, 100, 104, 106, 118, 135, 140, 163, 172, 185, 190, 191, 192, 197, 202, 205, 209, 215, 221, 225, 239, 249, 260, 267, 290, 291, 296, 301, 303, 313, 315, 319, 325, 327, 329, 336, 358, 359, 370, 377, 379, 380, 388, 394, 395, 401, 404, 415, 418, 427, 433, 435, 436, 448, 449, 459, 470, 472, 489, 493, 498, 505, 512, 515, 517, 530, 531, 543, 545, 558, 568, 572, 574, 580, 594, 597, 609, 611, 621, 634, 654, 666, 668, 677, 686, 690, 691, 702, 711, 712, 726, 727, 729, 737, 749, 750, 759, 763, 773, 774, 776, 794, 800, 804, 821, 847, 853, 875, 876, 883]

[0, 1, 2, 3, 4, 6, 7, 8, 9, 13, 15, 17, 18, 20, 21, 23, 24, 25, 26, 28, 30, 32, 33, 35, 36, 37, 40, 41, 45, 47, 48, 50, 52, 57, 58, 61, 62, 63, 65, 66, 67, 68, 69, 73, 76, 80, 81, 82, 84, 86, 87, 88, 89, 91, 92, 94, 95, 97, 98, 105, 106, 107, 108, 109, 112, 113, 114, 115, 117, 118, 119, 120, 123, 124, 127, 128, 129, 130, 131, 132, 136, 137, 138, 141, 142, 143, 145, 146, 152, 157, 158, 159, 162, 163, 164, 165, 167, 169, 171, 173, 174, 178, 179, 180, 182, 185, 186, 189, 193, 195, 196, 197, 198, 201, 202, 203, 204, 205, 207, 208, 209, 211, 212, 214, 217, 220, 221, 223, 224, 227, 230, 231, 234, 236, 238, 239, 240, 241, 242, 245, 246, 247, 248, 249, 251, 252, 253, 254, 255, 257, 259, 260, 266, 267, 269, 270, 273, 275, 277, 281, 285, 293, 295, 300, 301, 302, 303, 305, 306, 308, 310, 313, 314, 317, 318, 319, 320, 321, 323, 325, 326, 328, 329, 331, 333, 341, 342, 344, 346, 347, 348, 349, 351, 354, 355, 358, 360, 361, 364, 365, 366, 367, 370, 372, 376, 378, 384, 386, 387, 388, 390, 396, 397, 398, 400, 402, 403, 406, 407, 409, 410, 411, 413, 415, 417, 419, 421, 425, 426, 428, 430, 434, 437, 438, 439, 441, 443, 444, 446, 447, 448, 449, 450, 453, 455, 456, 457, 458, 459, 463, 469, 473, 475, 476, 477, 478, 480, 481, 483, 485, 486, 487, 488, 489, 490, 491, 492, 493, 494, 495, 496, 498, 500, 501, 506, 508, 511, 512, 513, 515, 517, 518, 519, 520, 521, 522, 524, 527, 528, 529, 530, 531, 532, 533, 534, 535, 536, 538, 539, 540, 541, 542, 547, 549, 552, 553, 554, 555, 556, 562, 565, 566, 567, 568, 569, 572, 576, 578, 579, 581, 582, 585, 586, 593, 594, 595, 597, 599, 600, 602, 603, 605, 606, 607, 609, 610, 611, 612, 613, 615, 616, 618, 619, 620, 623, 624, 628, 630, 633, 635, 639, 640, 642, 643, 644, 647, 648, 649, 650, 653, 654, 658, 659, 660, 662, 663, 664, 670, 671, 679, 681, 684, 689, 690, 694, 697, 698, 699, 700, 703, 704, 707, 709, 712, 714, 715, 716, 721, 725, 726, 727, 731, 732, 735, 738, 741, 747, 748, 750, 752, 753, 755, 756, 757, 758, 759, 761, 763, 764, 766, 767, 769, 774, 775, 777, 778, 779, 780, 782, 789, 792, 793, 794, 795, 799, 804, 805, 807, 809, 810, 811, 813, 816, 817, 819, 821, 823, 824, 825, 830, 832, 835, 836, 837, 838, 839, 840, 843, 845, 847, 851, 852, 853, 857, 858, 859, 861, 862, 863, 867, 870, 871, 875, 876, 877, 878, 879, 880, 881, 882, 884, 885, 888, 889]
[5, 20, 27, 32, 36, 42, 58, 68, 77, 88, 91, 94, 99, 100, 104, 106, 118, 135, 140, 163, 172, 185, 190, 191, 192, 197, 202, 205, 209, 215, 221, 225, 239, 249, 260, 267, 290, 291, 296, 301, 303, 313, 315, 319, 325, 327, 329, 336, 358, 359, 370, 377, 379, 380, 388, 394, 395, 401, 404, 415, 418, 427, 433, 435, 436, 448, 449, 459, 470, 472, 489, 493, 498, 505, 512, 515, 517, 530, 531, 543, 545, 558, 568, 572, 574, 580, 594, 597, 609, 611, 621, 634, 654, 666, 668, 677, 686, 690, 691, 702, 711, 712, 726, 727, 729, 737, 749, 750, 759, 763, 773, 774, 776, 794, 800, 804, 821, 847, 853, 875, 876, 883]

[0, 1, 2, 3, 4, 6, 7, 8, 9, 13, 15, 17, 18, 20, 21, 23, 24, 25, 26, 28, 29, 30, 32, 33, 34, 35, 36, 37, 40, 41, 43, 45, 47, 48, 50, 52, 54, 57, 58, 61, 62, 63, 65, 66, 67, 68, 69, 73, 76, 78, 80, 81, 82, 84, 86, 87, 88, 89, 91, 92, 93, 94, 95, 97, 98, 99, 101, 105, 106, 107, 108, 109, 112, 113, 114, 115, 117, 118, 119, 120, 122, 123, 124, 127, 128, 129, 130, 131, 132, 136, 137, 138, 139, 141, 142, 143, 145, 146, 148, 150, 152, 153, 157, 158, 159, 162, 163, 164, 165, 167, 169, 171, 173, 174, 178, 179, 180, 182, 185, 186, 187, 189, 193, 195, 196, 197, 198, 201, 202, 203, 204, 205, 207, 208, 209, 211, 212, 214, 217, 220, 221, 223, 224, 227, 228, 229, 230, 231, 234, 236, 238, 239, 240, 241, 242, 243, 245, 246, 247, 248, 249, 251, 252, 253, 254, 255, 257, 259, 260, 266, 267, 269, 270, 273, 275, 276, 277, 281, 282, 285, 291, 292, 293, 295, 297, 300, 301, 302, 303, 305, 306, 307, 308, 310, 311, 313, 314, 317, 318, 319, 320, 321, 323, 325, 326, 328, 329, 331, 333, 336, 341, 342, 344, 346, 347, 348, 349, 351, 354, 355, 358, 360, 361, 364, 365, 366, 367, 370, 372, 376, 378, 379, 383, 384, 386, 387, 388, 390, 395, 396, 397, 398, 400, 402, 403, 404, 406, 407, 409, 410, 411, 413, 415, 417, 419, 421, 425, 426, 428, 430, 431, 434, 437, 438, 439, 441, 443, 444, 446, 447, 448, 449, 450, 453, 455, 456, 457, 458, 459, 461, 463, 465, 466, 469, 473, 474, 475, 476, 477, 478, 480, 481, 483, 485, 486, 487, 488, 489, 490, 491, 492, 493, 494, 495, 496, 498, 499, 500, 501, 506, 508, 511, 512, 513, 515, 517, 518, 519, 520, 521, 522, 524, 527, 528, 529, 530, 531, 532, 533, 534, 535, 536, 537, 538, 539, 540, 541, 542, 544, 545, 547, 549, 552, 553, 554, 555, 556, 557, 562, 563, 564, 565, 566, 567, 568, 569, 571, 572, 573, 576, 578, 579, 581, 582, 585, 586, 589, 591, 593, 594, 595, 597, 599, 600, 601, 602, 603, 605, 606, 607, 608, 609, 610, 611, 612, 613, 615, 616, 618, 619, 620, 621, 623, 624, 628, 630, 632, 633, 634, 635, 637, 639, 640, 642, 643, 644, 645, 647, 648, 649, 650, 653, 654, 657, 658, 659, 660, 662, 663, 664, 665, 669, 670, 671, 677, 679, 680, 681, 684, 689, 690, 691, 694, 696, 697, 698, 699, 700, 703, 704, 707, 709, 712, 714, 715, 716, 718, 719, 721, 724, 725, 726, 727, 731, 732, 735, 738, 739, 741, 745, 747, 748, 750, 752, 753, 755, 756, 757, 758, 759, 760, 761, 763, 764, 766, 767, 769, 774, 775, 776, 777, 778, 779, 780, 782, 789, 790, 791, 792, 793, 794, 795, 799, 804, 805, 807, 809, 810, 811, 813, 816, 817, 819, 821, 823, 824, 825, 826, 827, 830, 832, 833, 834, 835, 836, 837, 838, 839, 840, 843, 845, 846, 847, 851, 852, 853, 857, 858, 859, 861, 862, 863, 867, 870, 871, 872, 873, 874, 875, 876, 877, 878, 879, 880, 881, 882, 884, 885, 886, 888, 889]
[5, 20, 27, 32, 36, 42, 58, 68, 77, 88, 91, 94, 99, 100, 104, 106, 118, 135, 140, 163, 172, 185, 190, 191, 192, 197, 202, 205, 209, 215, 221, 225, 239, 249, 260, 267, 290, 291, 296, 301, 303, 313, 315, 319, 325, 327, 329, 336, 358, 359, 370, 377, 379, 380, 388, 394, 395, 401, 404, 415, 418, 427, 433, 435, 436, 448, 449, 459, 470, 472, 489, 493, 498, 505, 512, 515, 517, 530, 531, 543, 545, 558, 568, 572, 574, 580, 594, 597, 609, 611, 621, 634, 654, 666, 668, 677, 686, 690, 691, 702, 711, 712, 726, 727, 729, 737, 749, 750, 759, 763, 773, 774, 776, 794, 800, 804, 821, 847, 853, 875, 876, 883]

[0, 1, 2, 3, 4, 6, 7, 8, 9, 13, 14, 15, 17, 18, 20, 21, 23, 24, 25, 26, 28, 29, 30, 32, 33, 34, 35, 36, 37, 39, 40, 41, 43, 44, 45, 46, 47, 48, 49, 50, 52, 54, 57, 58, 61, 62, 63, 65, 66, 67, 68, 69, 72, 73, 74, 75, 76, 78, 80, 81, 82, 84, 86, 87, 88, 89, 90, 91, 92, 93, 94, 95, 97, 98, 99, 101, 102, 105, 106, 107, 108, 109, 111, 112, 113, 114, 115, 117, 118, 119, 120, 122, 123, 124, 127, 128, 129, 130, 131, 132, 134, 136, 137, 138, 139, 141, 142, 143, 145, 146, 148, 150, 152, 153, 156, 157, 158, 159, 161, 162, 163, 164, 165, 166, 167, 168, 169, 170, 171, 173, 174, 177, 178, 179, 180, 182, 185, 186, 187, 189, 193, 195, 196, 197, 198, 201, 202, 203, 204, 205, 207, 208, 209, 210, 211, 212, 214, 216, 217, 220, 221, 222, 223, 224, 225, 227, 228, 229, 230, 231, 234, 235, 236, 238, 239, 240, 241, 242, 243, 245, 246, 247, 248, 249, 251, 252, 253, 254, 255, 257, 258, 259, 260, 263, 266, 267, 269, 270, 273, 275, 276, 277, 281, 282, 285, 286, 287, 291, 292, 293, 295, 297, 299, 300, 301, 302, 303, 305, 306, 307, 308, 310, 311, 313, 314, 317, 318, 319, 320, 321, 323, 325, 326, 328, 329, 331, 332, 333, 334, 336, 341, 342, 344, 346, 347, 348, 349, 351, 353, 354, 355, 356, 358, 360, 361, 363, 364, 365, 366, 367, 368, 370, 371, 372, 376, 378, 379, 383, 384, 386, 387, 388, 390, 395, 396, 397, 398, 399, 400, 401, 402, 403, 404, 405, 406, 407, 409, 410, 411, 413, 415, 417, 419, 420, 421, 424, 425, 426, 427, 428, 430, 431, 434, 435, 437, 438, 439, 441, 443, 444, 446, 447, 448, 449, 450, 453, 455, 456, 457, 458, 459, 461, 463, 465, 466, 469, 473, 474, 475, 476, 477, 478, 479, 480, 481, 483, 485, 486, 487, 488, 489, 490, 491, 492, 493, 494, 495, 496, 498, 499, 500, 501, 503, 505, 506, 508, 511, 512, 513, 515, 517, 518, 519, 520, 521, 522, 523, 524, 527, 528, 529, 530, 531, 532, 533, 534, 535, 536, 537, 538, 539, 540, 541, 542, 544, 545, 547, 549, 552, 553, 554, 555, 556, 557, 562, 563, 564, 565, 566, 567, 568, 569, 571, 572, 573, 576, 578, 579, 581, 582, 585, 586, 589, 591, 593, 594, 595, 596, 597, 598, 599, 600, 601, 602, 603, 605, 606, 607, 608, 609, 610, 611, 612, 613, 614, 615, 616, 618, 619, 620, 621, 622, 623, 624, 625, 628, 630, 632, 633, 634, 635, 637, 639, 640, 642, 643, 644, 645, 647, 648, 649, 650, 653, 654, 657, 658, 659, 660, 662, 663, 664, 665, 666, 669, 670, 671, 676, 677, 679, 680, 681, 682, 684, 688, 689, 690, 691, 692, 694, 696, 697, 698, 699, 700, 703, 704, 706, 707, 709, 712, 713, 714, 715, 716, 718, 719, 721, 722, 723, 724, 725, 726, 727, 729, 731, 732, 733, 735, 738, 739, 741, 745, 746, 747, 748, 750, 752, 753, 755, 756, 757, 758, 759, 760, 761, 762, 763, 764, 766, 767, 768, 769, 772, 773, 774, 775, 776, 777, 778, 779, 780, 782, 789, 790, 791, 792, 793, 794, 795, 799, 801, 804, 805, 806, 807, 809, 810, 811, 813, 815, 816, 817, 818, 819, 821, 822, 823, 824, 825, 826, 827, 830, 832, 833, 834, 835, 836, 837, 838, 839, 840, 842, 843, 844, 845, 846, 847, 848, 851, 852, 853, 856, 857, 858, 859, 860, 861, 862, 863, 866, 867, 868, 870, 871, 872, 873, 874, 875, 876, 877, 878, 879, 880, 881, 882, 884, 885, 886, 888, 889]
[5, 20, 27, 32, 36, 42, 58, 68, 77, 88, 91, 94, 99, 100, 104, 106, 118, 135, 140, 163, 172, 185, 190, 191, 192, 197, 202, 205, 209, 215, 221, 225, 239, 249, 260, 267, 290, 291, 296, 301, 303, 313, 315, 319, 325, 327, 329, 336, 358, 359, 370, 377, 379, 380, 388, 394, 395, 401, 404, 415, 418, 427, 433, 435, 436, 448, 449, 459, 470, 472, 489, 493, 498, 505, 512, 515, 517, 530, 531, 543, 545, 558, 568, 572, 574, 580, 594, 597, 609, 611, 621, 634, 654, 666, 668, 677, 686, 690, 691, 702, 711, 712, 726, 727, 729, 737, 749, 750, 759, 763, 773, 774, 776, 794, 800, 804, 821, 847, 853, 875, 876, 883]

[0, 1, 2, 3, 4, 6, 7, 8, 9, 12, 13, 14, 15, 17, 18, 19, 20, 21, 23, 24, 25, 26, 28, 29, 30, 31, 32, 33, 34, 35, 36, 37, 39, 40, 41, 42, 43, 44, 45, 46, 47, 48, 49, 50, 51, 52, 54, 57, 58, 61, 62, 63, 65, 66, 67, 68, 69, 70, 72, 73, 74, 75, 76, 78, 79, 80, 81, 82, 84, 85, 86, 87, 88, 89, 90, 91, 92, 93, 94, 95, 97, 98, 99, 101, 102, 103, 105, 106, 107, 108, 109, 111, 112, 113, 114, 115, 116, 117, 118, 119, 120, 122, 123, 124, 127, 128, 129, 130, 131, 132, 134, 136, 137, 138, 139, 141, 142, 143, 145, 146, 148, 150, 152, 153, 156, 157, 158, 159, 160, 161, 162, 163, 164, 165, 166, 167, 168, 169, 170, 171, 173, 174, 176, 177, 178, 179, 180, 182, 185, 186, 187, 189, 190, 192, 193, 195, 196, 197, 198, 201, 202, 203, 204, 205, 206, 207, 208, 209, 210, 211, 212, 214, 216, 217, 220, 221, 222, 223, 224, 225, 227, 228, 229, 230, 231, 234, 235, 236, 238, 239, 240, 241, 242, 243, 245, 246, 247, 248, 249, 251, 252, 253, 254, 255, 257, 258, 259, 260, 263, 265, 266, 267, 268, 269, 270, 271, 273, 275, 276, 277, 280, 281, 282, 285, 286, 287, 290, 291, 292, 293, 295, 296, 297, 298, 299, 300, 301, 302, 303, 305, 306, 307, 308, 309, 310, 311, 312, 313, 314, 317, 318, 319, 320, 321, 323, 324, 325, 326, 328, 329, 330, 331, 332, 333, 334, 335, 336, 339, 341, 342, 344, 346, 347, 348, 349, 351, 353, 354, 355, 356, 358, 360, 361, 363, 364, 365, 366, 367, 368, 370, 371, 372, 376, 378, 379, 380, 382, 383, 384, 385, 386, 387, 388, 390, 393, 394, 395, 396, 397, 398, 399, 400, 401, 402, 403, 404, 405, 406, 407, 409, 410, 411, 413, 414, 415, 417, 419, 420, 421, 422, 424, 425, 426, 427, 428, 430, 431, 434, 435, 436, 437, 438, 439, 441, 443, 444, 445, 446, 447, 448, 449, 450, 452, 453, 455, 456, 457, 458, 459, 460, 461, 462, 463, 465, 466, 469, 470, 471, 473, 474, 475, 476, 477, 478, 479, 480, 481, 483, 485, 486, 487, 488, 489, 490, 491, 492, 493, 494, 495, 496, 498, 499, 500, 501, 503, 505, 506, 508, 509, 510, 511, 512, 513, 514, 515, 517, 518, 519, 520, 521, 522, 523, 524, 527, 528, 529, 530, 531, 532, 533, 534, 535, 536, 537, 538, 539, 540, 541, 542, 544, 545, 547, 549, 552, 553, 554, 555, 556, 557, 558, 560, 562, 563, 564, 565, 566, 567, 568, 569, 571, 572, 573, 574, 576, 577, 578, 579, 581, 582, 585, 586, 587, 589, 591, 593, 594, 595, 596, 597, 598, 599, 600, 601, 602, 603, 605, 606, 607, 608, 609, 610, 611, 612, 613, 614, 615, 616, 618, 619, 620, 621, 622, 623, 624, 625, 628, 630, 632, 633, 634, 635, 637, 639, 640, 642, 643, 644, 645, 647, 648, 649, 650, 652, 653, 654, 656, 657, 658, 659, 660, 662, 663, 664, 665, 666, 667, 669, 670, 671, 676, 677, 678, 679, 680, 681, 682, 684, 686, 687, 688, 689, 690, 691, 692, 693, 694, 696, 697, 698, 699, 700, 701, 702, 703, 704, 706, 707, 709, 711, 712, 713, 714, 715, 716, 717, 718, 719, 721, 722, 723, 724, 725, 726, 727, 729, 731, 732, 733, 734, 735, 736, 738, 739, 741, 742, 745, 746, 747, 748, 749, 750, 752, 753, 755, 756, 757, 758, 759, 760, 761, 762, 763, 764, 766, 767, 768, 769, 772, 773, 774, 775, 776, 777, 778, 779, 780, 782, 784, 785, 789, 790, 791, 792, 793, 794, 795, 796, 798, 799, 801, 804, 805, 806, 807, 809, 810, 811, 813, 815, 816, 817, 818, 819, 821, 822, 823, 824, 825, 826, 827, 830, 832, 833, 834, 835, 836, 837, 838, 839, 840, 841, 842, 843, 844, 845, 846, 847, 848, 849, 850, 851, 852, 853, 854, 856, 857, 858, 859, 860, 861, 862, 863, 864, 866, 867, 868, 870, 871, 872, 873, 874, 875, 876, 877, 878, 879, 880, 881, 882, 884, 885, 886, 887, 888, 889]
[5, 20, 27, 32, 36, 42, 58, 68, 77, 88, 91, 94, 99, 100, 104, 106, 118, 135, 140, 163, 172, 185, 190, 191, 192, 197, 202, 205, 209, 215, 221, 225, 239, 249, 260, 267, 290, 291, 296, 301, 303, 313, 315, 319, 325, 327, 329, 336, 358, 359, 370, 377, 379, 380, 388, 394, 395, 401, 404, 415, 418, 427, 433, 435, 436, 448, 449, 459, 470, 472, 489, 493, 498, 505, 512, 515, 517, 530, 531, 543, 545, 558, 568, 572, 574, 580, 594, 597, 609, 611, 621, 634, 654, 666, 668, 677, 686, 690, 691, 702, 711, 712, 726, 727, 729, 737, 749, 750, 759, 763, 773, 774, 776, 794, 800, 804, 821, 847, 853, 875, 876, 883]

[0, 1, 2, 3, 4, 5, 6, 7, 8, 9, 11, 12, 13, 14, 15, 16, 17, 18, 19, 20, 21, 23, 24, 25, 26, 28, 29, 30, 31, 32, 33, 34, 35, 36, 37, 39, 40, 41, 42, 43, 44, 45, 46, 47, 48, 49, 50, 51, 52, 54, 57, 58, 59, 60, 61, 62, 63, 64, 65, 66, 67, 68, 69, 70, 71, 72, 73, 74, 75, 76, 78, 79, 80, 81, 82, 83, 84, 85, 86, 87, 88, 89, 90, 91, 92, 93, 94, 95, 96, 97, 98, 99, 100, 101, 102, 103, 105, 106, 107, 108, 109, 111, 112, 113, 114, 115, 116, 117, 118, 119, 120, 122, 123, 124, 126, 127, 128, 129, 130, 131, 132, 134, 136, 137, 138, 139, 140, 141, 142, 143, 144, 145, 146, 148, 149, 150, 151, 152, 153, 154, 156, 157, 158, 159, 160, 161, 162, 163, 164, 165, 166, 167, 168, 169, 170, 171, 173, 174, 176, 177, 178, 179, 180, 181, 182, 184, 185, 186, 187, 189, 190, 191, 192, 193, 195, 196, 197, 198, 199, 201, 202, 203, 204, 205, 206, 207, 208, 209, 210, 211, 212, 214, 215, 216, 217, 218, 219, 220, 221, 222, 223, 224, 225, 226, 227, 228, 229, 230, 231, 234, 235, 236, 237, 238, 239, 240, 241, 242, 243, 244, 245, 246, 247, 248, 249, 250, 251, 252, 253, 254, 255, 257, 258, 259, 260, 263, 265, 266, 267, 268, 269, 270, 271, 272, 273, 274, 275, 276, 277, 279, 280, 281, 282, 284, 285, 286, 287, 288, 290, 291, 292, 293, 294, 295, 296, 297, 298, 299, 300, 301, 302, 303, 305, 306, 307, 308, 309, 310, 311, 312, 313, 314, 315, 317, 318, 319, 320, 321, 323, 324, 325, 326, 328, 329, 330, 331, 332, 333, 334, 335, 336, 339, 341, 342, 344, 346, 347, 348, 349, 350, 351, 352, 353, 354, 355, 356, 357, 358, 360, 361, 363, 364, 365, 366, 367, 368, 370, 371, 372, 376, 377, 378, 379, 380, 381, 382, 383, 384, 385, 386, 387, 388, 390, 391, 392, 393, 394, 395, 396, 397, 398, 399, 400, 401, 402, 403, 404, 405, 406, 407, 409, 410, 411, 413, 414, 415, 417, 418, 419, 420, 421, 422, 423, 424, 425, 426, 427, 428, 430, 431, 433, 434, 435, 436, 437, 438, 439, 441, 443, 444, 445, 446, 447, 448, 449, 450, 451, 452, 453, 454, 455, 456, 457, 458, 459, 460, 461, 462, 463, 465, 466, 467, 469, 470, 471, 472, 473, 474, 475, 476, 477, 478, 479, 480, 481, 483, 485, 486, 487, 488, 489, 490, 491, 492, 493, 494, 495, 496, 497, 498, 499, 500, 501, 503, 505, 506, 508, 509, 510, 511, 512, 513, 514, 515, 517, 518, 519, 520, 521, 522, 523, 524, 525, 527, 528, 529, 530, 531, 532, 533, 534, 535, 536, 537, 538, 539, 540, 541, 542, 544, 545, 547, 548, 549, 552, 553, 554, 555, 556, 557, 558, 560, 562, 563, 564, 565, 566, 567, 568, 569, 570, 571, 572, 573, 574, 575, 576, 577, 578, 579, 581, 582, 583, 585, 586, 587, 589, 591, 593, 594, 595, 596, 597, 598, 599, 600, 601, 602, 603, 605, 606, 607, 608, 609, 610, 611, 612, 613, 614, 615, 616, 617, 618, 619, 620, 621, 622, 623, 624, 625, 626, 627, 628, 630, 632, 633, 634, 635, 636, 637, 639, 640, 642, 643, 644, 645, 647, 648, 649, 650, 652, 653, 654, 656, 657, 658, 659, 660, 662, 663, 664, 665, 666, 667, 668, 669, 670, 671, 672, 673, 674, 676, 677, 678, 679, 680, 681, 682, 684, 685, 686, 687, 688, 689, 690, 691, 692, 693, 694, 695, 696, 697, 698, 699, 700, 701, 702, 703, 704, 705, 706, 707, 709, 710, 711, 712, 713, 714, 715, 716, 717, 718, 719, 721, 722, 723, 724, 725, 726, 727, 728, 729, 731, 732, 733, 734, 735, 736, 737, 738, 739, 740, 741, 742, 743, 744, 745, 746, 747, 748, 749, 750, 752, 753, 755, 756, 757, 758, 759, 760, 761, 762, 763, 764, 766, 767, 768, 769, 770, 771, 772, 773, 774, 775, 776, 777, 778, 779, 780, 781, 782, 784, 785, 788, 789, 790, 791, 792, 793, 794, 795, 796, 798, 799, 801, 804, 805, 806, 807, 808, 809, 810, 811, 813, 814, 815, 816, 817, 818, 819, 821, 822, 823, 824, 825, 826, 827, 830, 831, 832, 833, 834, 835, 836, 837, 838, 839, 840, 841, 842, 843, 844, 845, 846, 847, 848, 849, 850, 851, 852, 853, 854, 856, 857, 858, 859, 860, 861, 862, 863, 864, 865, 866, 867, 868, 870, 871, 872, 873, 874, 875, 876, 877, 878, 879, 880, 881, 882, 884, 885, 886, 887, 888, 889]
[5, 20, 27, 32, 36, 42, 58, 68, 77, 88, 91, 94, 99, 100, 104, 106, 118, 135, 140, 163, 172, 185, 190, 191, 192, 197, 202, 205, 209, 215, 221, 225, 239, 249, 260, 267, 290, 291, 296, 301, 303, 313, 315, 319, 325, 327, 329, 336, 358, 359, 370, 377, 379, 380, 388, 394, 395, 401, 404, 415, 418, 427, 433, 435, 436, 448, 449, 459, 470, 472, 489, 493, 498, 505, 512, 515, 517, 530, 531, 543, 545, 558, 568, 572, 574, 580, 594, 597, 609, 611, 621, 634, 654, 666, 668, 677, 686, 690, 691, 702, 711, 712, 726, 727, 729, 737, 749, 750, 759, 763, 773, 774, 776, 794, 800, 804, 821, 847, 853, 875, 876, 883]

