[69, 107, 125, 129, 134, 172, 189, 242, 381, 386, 405, 422, 455, 538, 556, 557, 578, 591, 608, 656, 675, 780]
[5, 17, 40, 60, 211, 219, 224, 252, 258, 276, 314, 325, 327, 367, 380, 382, 431, 460, 598, 771, 798, 833]

[69, 107, 125, 129, 134, 172, 189, 242, 381, 386, 405, 422, 455, 538, 556, 557, 578, 591, 608, 656, 675, 780]
[5, 9, 17, 24, 40, 47, 58, 60, 68, 80, 87, 93, 94, 98, 119, 123, 128, 130, 156, 158, 161, 168, 171, 184, 205, 208, 211, 219, 224, 226, 229, 233, 241, 249, 252, 254, 258, 276, 284, 287, 288, 314, 317, 321, 322, 325, 326, 327, 333, 355, 356, 358, 359, 366, 367, 380, 382, 395, 400, 423, 430, 431, 432, 435, 437, 440, 445, 453, 460, 461, 462, 468, 477, 524, 534, 539, 544, 551, 561, 575, 594, 598, 616, 629, 633, 641, 643, 657, 676, 686, 696, 715, 716, 752, 753, 755, 758, 763, 764, 766, 771, 772, 781, 788, 798, 800, 806, 818, 819, 820, 828, 831, 833, 837, 844, 849, 861, 862, 868, 874, 875, 889]

[1, 15, 32, 52, 56, 68, 69, 79, 82, 107, 117, 125, 129, 134, 135, 167, 172, 174, 189, 196, 205, 210, 225, 228, 237, 240, 242, 249, 252, 257, 260, 283, 321, 338, 339, 349, 350, 368, 381, 386, 405, 414, 422, 438, 442, 455, 482, 497, 517, 518, 538, 551, 555, 556, 557, 568, 578, 584, 591, 592, 607, 608, 613, 621, 624, 625, 638, 641, 650, 653, 656, 659, 672, 675, 679, 681, 688, 694, 710, 725, 730, 740, 753, 759, 760, 772, 780, 791, 794, 807, 808, 823, 825, 829, 832, 838, 851]
[5, 9, 17, 24, 40, 47, 58, 60, 68, 80, 87, 93, 94, 98, 119, 123, 128, 130, 156, 158, 161, 168, 171, 184, 205, 208, 211, 219, 224, 226, 229, 233, 241, 249, 252, 254, 258, 276, 284, 287, 288, 314, 317, 321, 322, 325, 326, 327, 333, 355, 356, 358, 359, 366, 367, 380, 382, 395, 400, 423, 430, 431, 432, 435, 437, 440, 445, 453, 460, 461, 462, 468, 477, 524, 534, 539, 544, 551, 561, 575, 594, 598, 616, 629, 633, 641, 643, 657, 676, 686, 696, 715, 716, 752, 753, 755, 758, 763, 764, 766, 771, 772, 781, 788, 798, 800, 806, 818, 819, 820, 828, 831, 833, 837, 844, 849, 861, 862, 868, 874, 875, 889]

[1, 15, 32, 39, 42, 44, 50, 51, 52, 56, 67, 68, 69, 71, 79, 82, 103, 107, 114, 117, 125, 129, 134, 135, 142, 148, 153, 162, 163, 167, 172, 174, 188, 189, 193, 196, 205, 207, 210, 217, 225, 228, 237, 240, 242, 249, 252, 257, 260, 277, 281, 283, 285, 291, 295, 301, 312, 320, 321, 322, 338, 339, 346, 349, 350, 352, 355, 360, 368, 381, 386, 396, 405, 410, 414, 415, 422, 433, 438, 442, 449, 455, 467, 470, 476, 482, 497, 514, 517, 518, 529, 535, 538, 547, 549, 551, 555, 556, 557, 566, 568, 578, 582, 584, 587, 591, 592, 594, 606, 607, 608, 610, 613, 621, 624, 625, 632, 638, 641, 650, 653, 656, 659, 661, 672, 675, 678, 679, 681, 688, 693, 694, 698, 708, 710, 717, 725, 730, 735, 740, 743, 747, 751, 753, 759, 760, 769, 772, 773, 777, 780, 782, 784, 786, 791, 794, 802, 807, 808, 811, 823, 825, 829, 832, 837, 838, 851, 854, 875, 877, 879, 881]
[5, 9, 17, 24, 40, 47, 58, 60, 68, 80, 87, 93, 94, 98, 119, 123, 128, 130, 156, 158, 161, 168, 171, 184, 205, 208, 211, 219, 224, 226, 229, 233, 241, 249, 252, 254, 258, 276, 284, 287, 288, 314, 317, 321, 322, 325, 326, 327, 333, 355, 356, 358, 359, 366, 367, 380, 382, 395, 400, 423, 430, 431, 432, 435, 437, 440, 445, 453, 460, 461, 462, 468, 477, 524, 534, 539, 544, 551, 561, 575, 594, 598, 616, 629, 633, 641, 643, 657, 676, 686, 696, 715, 716, 752, 753, 755, 758, 763, 764, 766, 771, 772, 781, 788, 798, 800, 806, 818, 819, 820, 828, 831, 833, 837, 844, 849, 861, 862, 868, 874, 875, 889]

[1, 2, 11, 15, 32, 33, 39, 42, 44, 50, 51, 52, 56, 58, 65, 67, 68, 69, 71, 76, 79, 82, 84, 103, 104, 106, 107, 114, 117, 125, 129, 132, 134, 135, 142, 148, 153, 158, 162, 163, 167, 172, 174, 187, 188, 189, 193, 196, 198, 199, 205, 206, 207, 210, 217, 225, 228, 232, 237, 238, 240, 242, 243, 246, 249, 252, 254, 257, 258, 260, 265, 277, 281, 283, 285, 288, 291, 295, 301, 307, 312, 318, 320, 321, 322, 330, 332, 337, 338, 339, 345, 346, 349, 350, 352, 355, 357, 358, 360, 368, 370, 371, 375, 376, 378, 381, 386, 388, 390, 394, 396, 404, 405, 410, 414, 415, 417, 422, 424, 425, 433, 438, 442, 449, 455, 467, 470, 473, 476, 482, 494, 497, 514, 517, 518, 529, 530, 531, 535, 538, 542, 547, 549, 551, 554, 555, 556, 557, 560, 561, 566, 568, 578, 582, 584, 587, 591, 592, 594, 603, 606, 607, 608, 609, 610, 613, 614, 621, 624, 625, 632, 638, 641, 642, 650, 653, 654, 656, 659, 661, 669, 672, 674, 675, 678, 679, 681, 686, 688, 693, 694, 698, 699, 708, 710, 717, 725, 730, 731, 734, 735, 740, 743, 747, 749, 751, 753, 759, 760, 761, 769, 772, 773, 777, 780, 782, 784, 786, 787, 791, 794, 797, 800, 802, 807, 808, 811, 823, 824, 825, 829, 832, 837, 838, 839, 848, 849, 851, 853, 854, 870, 875, 876, 877, 879, 880, 881]
[5, 9, 17, 24, 40, 47, 58, 60, 68, 80, 87, 93, 94, 98, 119, 123, 128, 130, 156, 158, 161, 168, 171, 184, 205, 208, 211, 219, 224, 226, 229, 233, 241, 249, 252, 254, 258, 276, 284, 287, 288, 314, 317, 321, 322, 325, 326, 327, 333, 355, 356, 358, 359, 366, 367, 380, 382, 395, 400, 423, 430, 431, 432, 435, 437, 440, 445, 453, 460, 461, 462, 468, 477, 524, 534, 539, 544, 551, 561, 575, 594, 598, 616, 629, 633, 641, 643, 657, 676, 686, 696, 715, 716, 752, 753, 755, 758, 763, 764, 766, 771, 772, 781, 788, 798, 800, 806, 818, 819, 820, 828, 831, 833, 837, 844, 849, 861, 862, 868, 874, 875, 889]

[1, 2, 4, 11, 15, 27, 32, 33, 37, 39, 42, 44, 49, 50, 51, 52, 54, 56, 58, 60, 65, 67, 68, 69, 71, 72, 76, 79, 82, 84, 90, 92, 100, 102, 103, 104, 106, 107, 114, 117, 125, 129, 132, 134, 135, 137, 139, 142, 143, 148, 153, 158, 162, 163, 164, 165, 167, 172, 174, 182, 187, 188, 189, 191, 193, 196, 198, 199, 205, 206, 207, 210, 211, 216, 217, 225, 228, 232, 236, 237, 238, 240, 242, 243, 246, 247, 249, 252, 254, 257, 258, 259, 260, 265, 268, 270, 275, 277, 281, 283, 285, 288, 291, 295, 301, 303, 307, 312, 317, 318, 320, 321, 322, 326, 330, 332, 337, 338, 339, 345, 346, 349, 350, 352, 353, 355, 357, 358, 360, 363, 368, 370, 371, 375, 376, 378, 381, 386, 388, 390, 394, 396, 399, 404, 405, 407, 409, 410, 414, 415, 417, 422, 424, 425, 433, 438, 442, 449, 451, 455, 467, 470, 471, 473, 476, 481, 482, 494, 497, 499, 502, 504, 514, 517, 518, 529, 530, 531, 533, 535, 538, 542, 546, 547, 549, 551, 554, 555, 556, 557, 560, 561, 566, 568, 570, 571, 573, 578, 582, 584, 585, 587, 589, 591, 592, 594, 596, 601, 603, 605, 606, 607, 608, 609, 610, 613, 614, 616, 621, 623, 624, 625, 629, 632, 635, 638, 641, 642, 650, 653, 654, 656, 658, 659, 661, 664, 669, 670, 672, 674, 675, 678, 679, 681, 682, 684, 686, 688, 689, 692, 693, 694, 695, 697, 698, 699, 708, 710, 717, 718, 725, 730, 731, 734, 735, 740, 743, 747, 749, 751, 753, 754, 755, 759, 760, 761, 769, 772, 773, 777, 780, 782, 784, 786, 787, 790, 791, 792, 794, 797, 800, 801, 802, 804, 807, 808, 810, 811, 823, 824, 825, 827, 829, 832, 834, 837, 838, 839, 848, 849, 851, 853, 854, 861, 866, 870, 875, 876, 877, 879, 880, 881]
[5, 9, 17, 24, 40, 47, 58, 60, 68, 80, 87, 93, 94, 98, 119, 123, 128, 130, 156, 158, 161, 168, 171, 184, 205, 208, 211, 219, 224, 226, 229, 233, 241, 249, 252, 254, 258, 276, 284, 287, 288, 314, 317, 321, 322, 325, 326, 327, 333, 355, 356, 358, 359, 366, 367, 380, 382, 395, 400, 423, 430, 431, 432, 435, 437, 440, 445, 453, 460, 461, 462, 468, 477, 524, 534, 539, 544, 551, 561, 575, 594, 598, 616, 629, 633, 641, 643, 657, 676, 686, 696, 715, 716, 752, 753, 755, 758, 763, 764, 766, 771, 772, 781, 788, 798, 800, 806, 818, 819, 820, 828, 831, 833, 837, 844, 849, 861, 862, 868, 874, 875, 889]

[1, 2, 4, 6, 11, 12, 15, 20, 23, 27, 32, 33, 35, 37, 39, 40, 42, 44, 45, 46, 49, 50, 51, 52, 53, 54, 56, 58, 59, 60, 65, 67, 68, 69, 71, 72, 73, 75, 76, 78, 79, 82, 84, 90, 92, 93, 98, 99, 100, 102, 103, 104, 105, 106, 107, 114, 117, 125, 129, 132, 134, 135, 137, 139, 142, 143, 148, 153, 154, 155, 156, 158, 161, 162, 163, 164, 165, 166, 167, 168, 172, 174, 182, 187, 188, 189, 191, 193, 196, 198, 199, 205, 206, 207, 210, 211, 216, 217, 219, 225, 228, 232, 233, 236, 237, 238, 240, 242, 243, 246, 247, 249, 252, 254, 256, 257, 258, 259, 260, 265, 266, 267, 268, 270, 275, 277, 281, 283, 285, 288, 291, 295, 296, 301, 303, 305, 307, 312, 314, 317, 318, 320, 321, 322, 326, 330, 331, 332, 337, 338, 339, 345, 346, 349, 350, 352, 353, 355, 357, 358, 360, 363, 367, 368, 370, 371, 372, 375, 376, 378, 379, 381, 383, 386, 388, 390, 394, 396, 399, 404, 405, 407, 408, 409, 410, 414, 415, 417, 418, 422, 424, 425, 426, 433, 436, 438, 442, 449, 451, 455, 466, 467, 468, 470, 471, 473, 476, 479, 481, 482, 493, 494, 497, 498, 499, 501, 502, 504, 513, 514, 517, 518, 528, 529, 530, 531, 533, 535, 538, 540, 542, 546, 547, 549, 550, 551, 554, 555, 556, 557, 559, 560, 561, 563, 564, 566, 568, 569, 570, 571, 573, 578, 582, 584, 585, 587, 589, 591, 592, 594, 596, 600, 601, 603, 605, 606, 607, 608, 609, 610, 613, 614, 615, 616, 621, 622, 623, 624, 625, 629, 632, 634, 635, 638, 641, 642, 650, 653, 654, 656, 658, 659, 661, 664, 668, 669, 670, 671, 672, 673, 674, 675, 676, 678, 679, 681, 682, 684, 686, 688, 689, 692, 693, 694, 695, 697, 698, 699, 708, 710, 717, 718, 725, 730, 731, 733, 734, 735, 740, 741, 743, 747, 749, 750, 751, 752, 753, 754, 755, 756, 759, 760, 761, 763, 769, 772, 773, 777, 780, 782, 784, 786, 787, 790, 791, 792, 793, 794, 797, 800, 801, 802, 804, 807, 808, 810, 811, 814, 817, 821, 822, 823, 824, 825, 827, 829, 832, 834, 837, 838, 839, 848, 849, 851, 853, 854, 858, 860, 861, 866, 870, 875, 876, 877, 879, 880, 881]
[5, 9, 17, 24, 40, 47, 58, 60, 68, 80, 87, 93, 94, 98, 119, 123, 128, 130, 156, 158, 161, 168, 171, 184, 205, 208, 211, 219, 224, 226, 229, 233, 241, 249, 252, 254, 258, 276, 284, 287, 288, 314, 317, 321, 322, 325, 326, 327, 333, 355, 356, 358, 359, 366, 367, 380, 382, 395, 400, 423, 430, 431, 432, 435, 437, 440, 445, 453, 460, 461, 462, 468, 477, 524, 534, 539, 544, 551, 561, 575, 594, 598, 616, 629, 633, 641, 643, 657, 676, 686, 696, 715, 716, 752, 753, 755, 758, 763, 764, 766, 771, 772, 781, 788, 798, 800, 806, 818, 819, 820, 828, 831, 833, 837, 844, 849, 861, 862, 868, 874, 875, 889]

[1, 2, 3, 4, 6, 11, 12, 15, 20, 23, 25, 27, 32, 33, 34, 35, 37, 39, 40, 42, 44, 45, 46, 49, 50, 51, 52, 53, 54, 56, 58, 59, 60, 65, 67, 68, 69, 71, 72, 73, 75, 76, 78, 79, 82, 84, 87, 90, 91, 92, 93, 96, 97, 98, 99, 100, 102, 103, 104, 105, 106, 107, 113, 114, 117, 118, 125, 129, 132, 134, 135, 137, 139, 142, 143, 148, 153, 154, 155, 156, 158, 161, 162, 163, 164, 165, 166, 167, 168, 172, 174, 180, 182, 187, 188, 189, 191, 193, 194, 196, 197, 198, 199, 203, 204, 205, 206, 207, 209, 210, 211, 212, 213, 216, 217, 218, 219, 225, 228, 231, 232, 233, 235, 236, 237, 238, 240, 242, 243, 246, 247, 249, 252, 254, 256, 257, 258, 259, 260, 265, 266, 267, 268, 269, 270, 271, 272, 275, 277, 278, 281, 283, 285, 286, 288, 291, 295, 296, 298, 301, 302, 303, 304, 305, 307, 309, 312, 314, 317, 318, 320, 321, 322, 324, 326, 328, 330, 331, 332, 337, 338, 339, 344, 345, 346, 349, 350, 352, 353, 355, 356, 357, 358, 360, 363, 367, 368, 370, 371, 372, 375, 376, 378, 379, 381, 383, 385, 386, 388, 390, 394, 396, 398, 399, 402, 404, 405, 406, 407, 408, 409, 410, 412, 414, 415, 417, 418, 422, 423, 424, 425, 426, 431, 433, 436, 437, 438, 442, 449, 451, 453, 454, 455, 456, 462, 466, 467, 468, 469, 470, 471, 473, 474, 476, 477, 479, 480, 481, 482, 490, 493, 494, 497, 498, 499, 501, 502, 504, 508, 513, 514, 515, 517, 518, 519, 523, 528, 529, 530, 531, 533, 534, 535, 537, 538, 540, 542, 546, 547, 548, 549, 550, 551, 552, 554, 555, 556, 557, 559, 560, 561, 563, 564, 566, 568, 569, 570, 571, 573, 578, 580, 581, 582, 584, 585, 586, 587, 589, 591, 592, 594, 596, 600, 601, 603, 605, 606, 607, 608, 609, 610, 613, 614, 615, 616, 621, 622, 623, 624, 625, 629, 632, 634, 635, 638, 641, 642, 650, 653, 654, 656, 658, 659, 661, 662, 664, 668, 669, 670, 671, 672, 673, 674, 675, 676, 678, 679, 681, 682, 684, 686, 688, 689, 692, 693, 694, 695, 696, 697, 698, 699, 703, 708, 710, 717, 718, 725, 730, 731, 733, 734, 735, 740, 741, 743, 747, 748, 749, 750, 751, 752, 753, 754, 755, 756, 757, 759, 760, 761, 763, 769, 772, 773, 777, 778, 780, 782, 784, 786, 787, 790, 791, 792, 793, 794, 796, 797, 798, 800, 801, 802, 804, 807, 808, 809, 810, 811, 813, 814, 815, 816, 817, 819, 821, 822, 823, 824, 825, 827, 828, 829, 832, 834, 837, 838, 839, 848, 849, 851, 853, 854, 856, 858, 860, 861, 862, 866, 867, 868, 870, 875, 876, 877, 879, 880, 881, 885, 888]
[5, 9, 17, 24, 40, 47, 58, 60, 68, 80, 87, 93, 94, 98, 119, 123, 128, 130, 156, 158, 161, 168, 171, 184, 205, 208, 211, 219, 224, 226, 229, 233, 241, 249, 252, 254, 258, 276, 284, 287, 288, 314, 317, 321, 322, 325, 326, 327, 333, 355, 356, 358, 359, 366, 367, 380, 382, 395, 400, 423, 430, 431, 432, 435, 437, 440, 445, 453, 460, 461, 462, 468, 477, 524, 534, 539, 544, 551, 561, 575, 594, 598, 616, 629, 633, 641, 643, 657, 676, 686, 696, 715, 716, 752, 753, 755, 758, 763, 764, 766, 771, 772, 781, 788, 798, 800, 806, 818, 819, 820, 828, 831, 833, 837, 844, 849, 861, 862, 868, 874, 875, 889]

[1, 2, 3, 4, 6, 9, 11, 12, 13, 15, 20, 21, 23, 25, 27, 32, 33, 34, 35, 37, 39, 40, 42, 44, 45, 46, 48, 49, 50, 51, 52, 53, 54, 56, 58, 59, 60, 64, 65, 67, 68, 69, 71, 72, 73, 75, 76, 77, 78, 79, 80, 82, 84, 87, 90, 91, 92, 93, 96, 97, 98, 99, 100, 102, 103, 104, 105, 106, 107, 108, 113, 114, 115, 117, 118, 125, 126, 128, 129, 132, 134, 135, 136, 137, 139, 142, 143, 144, 148, 153, 154, 155, 156, 158, 161, 162, 163, 164, 165, 166, 167, 168, 172, 174, 176, 178, 180, 182, 187, 188, 189, 191, 193, 194, 196, 197, 198, 199, 202, 203, 204, 205, 206, 207, 209, 210, 211, 212, 213, 216, 217, 218, 219, 223, 225, 228, 230, 231, 232, 233, 235, 236, 237, 238, 240, 242, 243, 244, 246, 247, 249, 252, 254, 256, 257, 258, 259, 260, 262, 263, 265, 266, 267, 268, 269, 270, 271, 272, 274, 275, 277, 278, 281, 282, 283, 284, 285, 286, 287, 288, 291, 292, 295, 296, 298, 301, 302, 303, 304, 305, 307, 309, 311, 312, 313, 314, 315, 316, 317, 318, 320, 321, 322, 324, 326, 328, 330, 331, 332, 334, 337, 338, 339, 340, 344, 345, 346, 349, 350, 352, 353, 355, 356, 357, 358, 360, 363, 367, 368, 370, 371, 372, 375, 376, 377, 378, 379, 381, 383, 385, 386, 388, 390, 393, 394, 395, 396, 397, 398, 399, 402, 404, 405, 406, 407, 408, 409, 410, 411, 412, 414, 415, 417, 418, 422, 423, 424, 425, 426, 427, 431, 433, 434, 436, 437, 438, 440, 442, 446, 449, 451, 453, 454, 455, 456, 461, 462, 463, 466, 467, 468, 469, 470, 471, 472, 473, 474, 475, 476, 477, 479, 480, 481, 482, 485, 486, 490, 491, 493, 494, 496, 497, 498, 499, 501, 502, 503, 504, 506, 508, 509, 513, 514, 515, 517, 518, 519, 523, 528, 529, 530, 531, 532, 533, 534, 535, 537, 538, 540, 542, 544, 545, 546, 547, 548, 549, 550, 551, 552, 553, 554, 555, 556, 557, 559, 560, 561, 563, 564, 566, 568, 569, 570, 571, 573, 574, 578, 580, 581, 582, 583, 584, 585, 586, 587, 589, 591, 592, 594, 596, 597, 600, 601, 603, 605, 606, 607, 608, 609, 610, 613, 614, 615, 616, 621, 622, 623, 624, 625, 628, 629, 631, 632, 633, 634, 635, 638, 640, 641, 642, 650, 653, 654, 656, 658, 659, 661, 662, 664, 665, 668, 669, 670, 671, 672, 673, 674, 675, 676, 678, 679, 681, 682, 684, 686, 688, 689, 692, 693, 694, 695, 696, 697, 698, 699, 703, 706, 708, 710, 717, 718, 723, 725, 730, 731, 733, 734, 735, 740, 741, 743, 747, 748, 749, 750, 751, 752, 753, 754, 755, 756, 757, 759, 760, 761, 763, 769, 772, 773, 777, 778, 780, 781, 782, 784, 786, 787, 788, 789, 790, 791, 792, 793, 794, 796, 797, 798, 800, 801, 802, 804, 807, 808, 809, 810, 811, 812, 813, 814, 815, 816, 817, 819, 821, 822, 823, 824, 825, 826, 827, 828, 829, 832, 834, 835, 837, 838, 839, 842, 846, 848, 849, 851, 853, 854, 856, 858, 860, 861, 862, 866, 867, 868, 870, 875, 876, 877, 878, 879, 880, 881, 885, 888]
[5, 9, 17, 24, 40, 47, 58, 60, 68, 80, 87, 93, 94, 98, 119, 123, 128, 130, 156, 158, 161, 168, 171, 184, 205, 208, 211, 219, 224, 226, 229, 233, 241, 249, 252, 254, 258, 276, 284, 287, 288, 314, 317, 321, 322, 325, 326, 327, 333, 355, 356, 358, 359, 366, 367, 380, 382, 395, 400, 423, 430, 431, 432, 435, 437, 440, 445, 453, 460, 461, 462, 468, 477, 524, 534, 539, 544, 551, 561, 575, 594, 598, 616, 629, 633, 641, 643, 657, 676, 686, 696, 715, 716, 752, 753, 755, 758, 763, 764, 766, 771, 772, 781, 788, 798, 800, 806, 818, 819, 820, 828, 831, 833, 837, 844, 849, 861, 862, 868, 874, 875, 889]

[1, 2, 3, 4, 5, 6, 7, 9, 10, 11, 12, 13, 15, 20, 21, 23, 25, 27, 29, 30, 32, 33, 34, 35, 37, 38, 39, 40, 42, 44, 45, 46, 48, 49, 50, 51, 52, 53, 54, 56, 58, 59, 60, 61, 64, 65, 67, 68, 69, 71, 72, 73, 75, 76, 77, 78, 79, 80, 81, 82, 84, 86, 87, 90, 91, 92, 93, 95, 96, 97, 98, 99, 100, 102, 103, 104, 105, 106, 107, 108, 112, 113, 114, 115, 117, 118, 120, 125, 126, 128, 129, 131, 132, 134, 135, 136, 137, 139, 142, 143, 144, 148, 153, 154, 155, 156, 158, 159, 161, 162, 163, 164, 165, 166, 167, 168, 169, 170, 172, 174, 176, 178, 180, 181, 182, 185, 187, 188, 189, 191, 192, 193, 194, 195, 196, 197, 198, 199, 202, 203, 204, 205, 206, 207, 208, 209, 210, 211, 212, 213, 215, 216, 217, 218, 219, 223, 224, 225, 228, 230, 231, 232, 233, 234, 235, 236, 237, 238, 239, 240, 242, 243, 244, 246, 247, 249, 251, 252, 254, 256, 257, 258, 259, 260, 262, 263, 265, 266, 267, 268, 269, 270, 271, 272, 274, 275, 276, 277, 278, 279, 281, 282, 283, 284, 285, 286, 287, 288, 291, 292, 295, 296, 298, 301, 302, 303, 304, 305, 307, 309, 310, 311, 312, 313, 314, 315, 316, 317, 318, 320, 321, 322, 324, 326, 328, 330, 331, 332, 334, 337, 338, 339, 340, 341, 342, 344, 345, 346, 349, 350, 351, 352, 353, 354, 355, 356, 357, 358, 360, 363, 367, 368, 370, 371, 372, 375, 376, 377, 378, 379, 381, 383, 385, 386, 388, 390, 391, 393, 394, 395, 396, 397, 398, 399, 401, 402, 404, 405, 406, 407, 408, 409, 410, 411, 412, 413, 414, 415, 417, 418, 422, 423, 424, 425, 426, 427, 428, 429, 431, 433, 434, 436, 437, 438, 439, 440, 442, 444, 446, 449, 451, 453, 454, 455, 456, 461, 462, 463, 464, 465, 466, 467, 468, 469, 470, 471, 472, 473, 474, 475, 476, 477, 479, 480, 481, 482, 485, 486, 487, 490, 491, 493, 494, 495, 496, 497, 498, 499, 500, 501, 502, 503, 504, 506, 507, 508, 509, 513, 514, 515, 517, 518, 519, 523, 528, 529, 530, 531, 532, 533, 534, 535, 537, 538, 540, 542, 544, 545, 546, 547, 548, 549, 550, 551, 552, 553, 554, 555, 556, 557, 559, 560, 561, 563, 564, 565, 566, 567, 568, 569, 570, 571, 573, 574, 577, 578, 580, 581, 582, 583, 584, 585, 586, 587, 589, 591, 592, 594, 596, 597, 598, 600, 601, 603, 605, 606, 607, 608, 609, 610, 612, 613, 614, 615, 616, 621, 622, 623, 624, 625, 628, 629, 631, 632, 633, 634, 635, 638, 639, 640, 641, 642, 650, 653, 654, 656, 658, 659, 661, 662, 663, 664, 665, 668, 669, 670, 671, 672, 673, 674, 675, 676, 678, 679, 681, 682, 684, 685, 686, 688, 689, 692, 693, 694, 695, 696, 697, 698, 699, 703, 706, 707, 708, 709, 710, 714, 715, 717, 718, 721, 723, 725, 727, 730, 731, 733, 734, 735, 739, 740, 741, 742, 743, 745, 747, 748, 749, 750, 751, 752, 753, 754, 755, 756, 757, 759, 760, 761, 763, 765, 767, 768, 769, 770, 772, 773, 775, 776, 777, 778, 780, 781, 782, 784, 786, 787, 788, 789, 790, 791, 792, 793, 794, 796, 797, 798, 800, 801, 802, 804, 806, 807, 808, 809, 810, 811, 812, 813, 814, 815, 816, 817, 819, 821, 822, 823, 824, 825, 826, 827, 828, 829, 831, 832, 834, 835, 837, 838, 839, 842, 846, 848, 849, 851, 853, 854, 855, 856, 858, 859, 860, 861, 862, 866, 867, 868, 870, 875, 876, 877, 878, 879, 880, 881, 884, 885, 888, 889]
[5, 9, 17, 24, 40, 47, 58, 60, 68, 80, 87, 93, 94, 98, 119, 123, 128, 130, 156, 158, 161, 168, 171, 184, 205, 208, 211, 219, 224, 226, 229, 233, 241, 249, 252, 254, 258, 276, 284, 287, 288, 314, 317, 321, 322, 325, 326, 327, 333, 355, 356, 358, 359, 366, 367, 380, 382, 395, 400, 423, 430, 431, 432, 435, 437, 440, 445, 453, 460, 461, 462, 468, 477, 524, 534, 539, 544, 551, 561, 575, 594, 598, 616, 629, 633, 641, 643, 657, 676, 686, 696, 715, 716, 752, 753, 755, 758, 763, 764, 766, 771, 772, 781, 788, 798, 800, 806, 818, 819, 820, 828, 831, 833, 837, 844, 849, 861, 862, 868, 874, 875, 889]

[1, 2, 3, 4, 5, 6, 7, 8, 9, 10, 11, 12, 13, 15, 18, 20, 21, 23, 25, 27, 29, 30, 32, 33, 34, 35, 37, 38, 39, 40, 41, 42, 43, 44, 45, 46, 48, 49, 50, 51, 52, 53, 54, 56, 57, 58, 59, 60, 61, 64, 65, 66, 67, 68, 69, 70, 71, 72, 73, 74, 75, 76, 77, 78, 79, 80, 81, 82, 84, 86, 87, 90, 91, 92, 93, 95, 96, 97, 98, 99, 100, 102, 103, 104, 105, 106, 107, 108, 109, 111, 112, 113, 114, 115, 117, 118, 119, 120, 121, 124, 125, 126, 127, 128, 129, 131, 132, 134, 135, 136, 137, 138, 139, 142, 143, 144, 147, 148, 149, 153, 154, 155, 156, 157, 158, 159, 161, 162, 163, 164, 165, 166, 167, 168, 169, 170, 172, 174, 176, 178, 180, 181, 182, 183, 185, 186, 187, 188, 189, 191, 192, 193, 194, 195, 196, 197, 198, 199, 200, 202, 203, 204, 205, 206, 207, 208, 209, 210, 211, 212, 213, 214, 215, 216, 217, 218, 219, 221, 223, 224, 225, 226, 228, 230, 231, 232, 233, 234, 235, 236, 237, 238, 239, 240, 242, 243, 244, 246, 247, 249, 250, 251, 252, 253, 254, 255, 256, 257, 258, 259, 260, 262, 263, 265, 266, 267, 268, 269, 270, 271, 272, 274, 275, 276, 277, 278, 279, 281, 282, 283, 284, 285, 286, 287, 288, 291, 292, 294, 295, 296, 297, 298, 301, 302, 303, 304, 305, 307, 308, 309, 310, 311, 312, 313, 314, 315, 316, 317, 318, 320, 321, 322, 324, 326, 327, 328, 330, 331, 332, 334, 335, 337, 338, 339, 340, 341, 342, 344, 345, 346, 348, 349, 350, 351, 352, 353, 354, 355, 356, 357, 358, 360, 363, 365, 367, 368, 370, 371, 372, 375, 376, 377, 378, 379, 381, 383, 385, 386, 388, 390, 391, 392, 393, 394, 395, 396, 397, 398, 399, 401, 402, 404, 405, 406, 407, 408, 409, 410, 411, 412, 413, 414, 415, 416, 417, 418, 419, 422, 423, 424, 425, 426, 427, 428, 429, 430, 431, 433, 434, 436, 437, 438, 439, 440, 442, 444, 446, 447, 449, 451, 453, 454, 455, 456, 461, 462, 463, 464, 465, 466, 467, 468, 469, 470, 471, 472, 473, 474, 475, 476, 477, 478, 479, 480, 481, 482, 485, 486, 487, 488, 490, 491, 492, 493, 494, 495, 496, 497, 498, 499, 500, 501, 502, 503, 504, 506, 507, 508, 509, 510, 513, 514, 515, 517, 518, 519, 521, 523, 528, 529, 530, 531, 532, 533, 534, 535, 537, 538, 540, 542, 543, 544, 545, 546, 547, 548, 549, 550, 551, 552, 553, 554, 555, 556, 557, 559, 560, 561, 563, 564, 565, 566, 567, 568, 569, 570, 571, 572, 573, 574, 576, 577, 578, 580, 581, 582, 583, 584, 585, 586, 587, 589, 590, 591, 592, 593, 594, 596, 597, 598, 600, 601, 602, 603, 605, 606, 607, 608, 609, 610, 612, 613, 614, 615, 616, 617, 619, 620, 621, 622, 623, 624, 625, 628, 629, 631, 632, 633, 634, 635, 636, 638, 639, 640, 641, 642, 643, 644, 648, 650, 652, 653, 654, 655, 656, 658, 659, 661, 662, 663, 664, 665, 668, 669, 670, 671, 672, 673, 674, 675, 676, 678, 679, 681, 682, 684, 685, 686, 688, 689, 691, 692, 693, 694, 695, 696, 697, 698, 699, 702, 703, 705, 706, 707, 708, 709, 710, 714, 715, 716, 717, 718, 719, 720, 721, 723, 725, 726, 727, 730, 731, 733, 734, 735, 736, 737, 739, 740, 741, 742, 743, 744, 745, 747, 748, 749, 750, 751, 752, 753, 754, 755, 756, 757, 759, 760, 761, 763, 765, 766, 767, 768, 769, 770, 771, 772, 773, 775, 776, 777, 778, 780, 781, 782, 784, 786, 787, 788, 789, 790, 791, 792, 793, 794, 796, 797, 798, 800, 801, 802, 804, 806, 807, 808, 809, 810, 811, 812, 813, 814, 815, 816, 817, 818, 819, 820, 821, 822, 823, 824, 825, 826, 827, 828, 829, 831, 832, 833, 834, 835, 837, 838, 839, 842, 843, 846, 848, 849, 851, 853, 854, 855, 856, 858, 859, 860, 861, 862, 866, 867, 868, 870, 872, 875, 876, 877, 878, 879, 880, 881, 882, 884, 885, 888, 889]
[5, 9, 17, 24, 40, 47, 58, 60, 68, 80, 87, 93, 94, 98, 119, 123, 128, 130, 156, 158, 161, 168, 171, 184, 205, 208, 211, 219, 224, 226, 229, 233, 241, 249, 252, 254, 258, 276, 284, 287, 288, 314, 317, 321, 322, 325, 326, 327, 333, 355, 356, 358, 359, 366, 367, 380, 382, 395, 400, 423, 430, 431, 432, 435, 437, 440, 445, 453, 460, 461, 462, 468, 477, 524, 534, 539, 544, 551, 561, 575, 594, 598, 616, 629, 633, 641, 643, 657, 676, 686, 696, 715, 716, 752, 753, 755, 758, 763, 764, 766, 771, 772, 781, 788, 798, 800, 806, 818, 819, 820, 828, 831, 833, 837, 844, 849, 861, 862, 868, 874, 875, 889]

[1, 2, 3, 4, 5, 6, 7, 8, 9, 10, 11, 12, 13, 15, 18, 20, 21, 22, 23, 25, 27, 28, 29, 30, 31, 32, 33, 34, 35, 36, 37, 38, 39, 40, 41, 42, 43, 44, 45, 46, 48, 49, 50, 51, 52, 53, 54, 56, 57, 58, 59, 60, 61, 64, 65, 66, 67, 68, 69, 70, 71, 72, 73, 74, 75, 76, 77, 78, 79, 80, 81, 82, 83, 84, 86, 87, 88, 90, 91, 92, 93, 95, 96, 97, 98, 99, 100, 102, 103, 104, 105, 106, 107, 108, 109, 110, 111, 112, 113, 114, 115, 117, 118, 119, 120, 121, 124, 125, 126, 127, 128, 129, 130, 131, 132, 134, 135, 136, 137, 138, 139, 142, 143, 144, 146, 147, 148, 149, 152, 153, 154, 155, 156, 157, 158, 159, 161, 162, 163, 164, 165, 166, 167, 168, 169, 170, 172, 174, 175, 176, 178, 180, 181, 182, 183, 185, 186, 187, 188, 189, 191, 192, 193, 194, 195, 196, 197, 198, 199, 200, 201, 202, 203, 204, 205, 206, 207, 208, 209, 210, 211, 212, 213, 214, 215, 216, 217, 218, 219, 220, 221, 222, 223, 224, 225, 226, 228, 229, 230, 231, 232, 233, 234, 235, 236, 237, 238, 239, 240, 241, 242, 243, 244, 245, 246, 247, 249, 250, 251, 252, 253, 254, 255, 256, 257, 258, 259, 260, 261, 262, 263, 265, 266, 267, 268, 269, 270, 271, 272, 274, 275, 276, 277, 278, 279, 281, 282, 283, 284, 285, 286, 287, 288, 290, 291, 292, 294, 295, 296, 297, 298, 301, 302, 303, 304, 305, 306, 307, 308, 309, 310, 311, 312, 313, 314, 315, 316, 317, 318, 320, 321, 322, 323, 324, 326, 327, 328, 329, 330, 331, 332, 334, 335, 337, 338, 339, 340, 341, 342, 344, 345, 346, 347, 348, 349, 350, 351, 352, 353, 354, 355, 356, 357, 358, 360, 363, 365, 366, 367, 368, 369, 370, 371, 372, 374, 375, 376, 377, 378, 379, 380, 381, 382, 383, 384, 385, 386, 387, 388, 389, 390, 391, 392, 393, 394, 395, 396, 397, 398, 399, 401, 402, 404, 405, 406, 407, 408, 409, 410, 411, 412, 413, 414, 415, 416, 417, 418, 419, 420, 421, 422, 423, 424, 425, 426, 427, 428, 429, 430, 431, 432, 433, 434, 435, 436, 437, 438, 439, 440, 441, 442, 444, 445, 446, 447, 448, 449, 450, 451, 452, 453, 454, 455, 456, 458, 460, 461, 462, 463, 464, 465, 466, 467, 468, 469, 470, 471, 472, 473, 474, 475, 476, 477, 478, 479, 480, 481, 482, 483, 484, 485, 486, 487, 488, 490, 491, 492, 493, 494, 495, 496, 497, 498, 499, 500, 501, 502, 503, 504, 506, 507, 508, 509, 510, 512, 513, 514, 515, 516, 517, 518, 519, 520, 521, 523, 524, 527, 528, 529, 530, 531, 532, 533, 534, 535, 536, 537, 538, 540, 541, 542, 543, 544, 545, 546, 547, 548, 549, 550, 551, 552, 553, 554, 555, 556, 557, 559, 560, 561, 563, 564, 565, 566, 567, 568, 569, 570, 571, 572, 573, 574, 576, 577, 578, 579, 580, 581, 582, 583, 584, 585, 586, 587, 589, 590, 591, 592, 593, 594, 595, 596, 597, 598, 600, 601, 602, 603, 605, 606, 607, 608, 609, 610, 612, 613, 614, 615, 616, 617, 618, 619, 620, 621, 622, 623, 624, 625, 628, 629, 630, 631, 632, 633, 634, 635, 636, 637, 638, 639, 640, 641, 642, 643, 644, 646, 647, 648, 650, 652, 653, 654, 655, 656, 658, 659, 660, 661, 662, 663, 664, 665, 667, 668, 669, 670, 671, 672, 673, 674, 675, 676, 678, 679, 681, 682, 684, 685, 686, 688, 689, 690, 691, 692, 693, 694, 695, 696, 697, 698, 699, 701, 702, 703, 705, 706, 707, 708, 709, 710, 712, 713, 714, 715, 716, 717, 718, 719, 720, 721, 723, 725, 726, 727, 730, 731, 733, 734, 735, 736, 737, 738, 739, 740, 741, 742, 743, 744, 745, 746, 747, 748, 749, 750, 751, 752, 753, 754, 755, 756, 757, 758, 759, 760, 761, 763, 765, 766, 767, 768, 769, 770, 771, 772, 773, 775, 776, 777, 778, 780, 781, 782, 784, 785, 786, 787, 788, 789, 790, 791, 792, 793, 794, 795, 796, 797, 798, 800, 801, 802, 804, 805, 806, 807, 808, 809, 810, 811, 812, 813, 814, 815, 816, 817, 818, 819, 820, 821, 822, 823, 824, 825, 826, 827, 828, 829, 831, 832, 833, 834, 835, 837, 838, 839, 840, 841, 842, 843, 844, 846, 847, 848, 849, 851, 853, 854, 855, 856, 857, 858, 859, 860, 861, 862, 864, 866, 867, 868, 870, 872, 873, 875, 876, 877, 878, 879, 880, 881, 882, 883, 884, 885, 886, 887, 888, 889]
[5, 9, 17, 24, 40, 47, 58, 60, 68, 80, 87, 93, 94, 98, 119, 123, 128, 130, 156, 158, 161, 168, 171, 184, 205, 208, 211, 219, 224, 226, 229, 233, 241, 249, 252, 254, 258, 276, 284, 287, 288, 314, 317, 321, 322, 325, 326, 327, 333, 355, 356, 358, 359, 366, 367, 380, 382, 395, 400, 423, 430, 431, 432, 435, 437, 440, 445, 453, 460, 461, 462, 468, 477, 524, 534, 539, 544, 551, 561, 575, 594, 598, 616, 629, 633, 641, 643, 657, 676, 686, 696, 715, 716, 752, 753, 755, 758, 763, 764, 766, 771, 772, 781, 788, 798, 800, 806, 818, 819, 820, 828, 831, 833, 837, 844, 849, 861, 862, 868, 874, 875, 889]

