[2, 50, 103, 127, 269, 287, 321, 339, 382, 404, 416, 517, 519, 525, 573, 736, 765, 770, 781, 798, 804, 849]
[60, 129, 139, 153, 166, 204, 249, 271, 282, 368, 383, 406, 424, 453, 567, 580, 618, 639, 679, 759, 826, 841]

[2, 50, 103, 127, 269, 287, 321, 339, 382, 404, 416, 517, 519, 525, 573, 736, 765, 770, 781, 798, 804, 849]
[7, 16, 45, 57, 60, 79, 88, 92, 94, 114, 128, 129, 138, 139, 141, 147, 153, 166, 173, 177, 196, 200, 201, 204, 222, 227, 236, 245, 246, 248, 249, 258, 271, 282, 285, 295, 301, 314, 315, 328, 334, 338, 340, 346, 348, 368, 370, 383, 389, 406, 424, 431, 433, 434, 443, 453, 455, 461, 462, 469, 472, 481, 488, 494, 505, 513, 523, 531, 537, 538, 541, 543, 548, 560, 567, 574, 576, 580, 593, 605, 613, 618, 627, 639, 642, 649, 659, 660, 669, 679, 683, 686, 689, 690, 691, 693, 703, 710, 741, 752, 759, 760, 762, 766, 772, 776, 780, 784, 785, 799, 814, 826, 831, 841, 843, 850, 852, 854, 855, 877, 880, 889]

[2, 3, 9, 28, 30, 36, 37, 38, 40, 50, 67, 84, 87, 103, 127, 156, 160, 173, 178, 185, 194, 207, 214, 216, 227, 229, 230, 234, 260, 269, 287, 294, 303, 305, 306, 321, 322, 329, 335, 339, 357, 360, 382, 384, 386, 388, 397, 401, 403, 404, 416, 418, 439, 468, 474, 478, 489, 490, 491, 512, 517, 519, 525, 555, 568, 570, 573, 576, 603, 648, 654, 659, 674, 689, 698, 702, 707, 712, 719, 721, 726, 736, 749, 751, 755, 760, 765, 770, 781, 792, 798, 801, 804, 830, 849, 850, 883]
[7, 16, 45, 57, 60, 79, 88, 92, 94, 114, 128, 129, 138, 139, 141, 147, 153, 166, 173, 177, 196, 200, 201, 204, 222, 227, 236, 245, 246, 248, 249, 258, 271, 282, 285, 295, 301, 314, 315, 328, 334, 338, 340, 346, 348, 368, 370, 383, 389, 406, 424, 431, 433, 434, 443, 453, 455, 461, 462, 469, 472, 481, 488, 494, 505, 513, 523, 531, 537, 538, 541, 543, 548, 560, 567, 574, 576, 580, 593, 605, 613, 618, 627, 639, 642, 649, 659, 660, 669, 679, 683, 686, 689, 690, 691, 693, 703, 710, 741, 752, 759, 760, 762, 766, 772, 776, 780, 784, 785, 799, 814, 826, 831, 841, 843, 850, 852, 854, 855, 877, 880, 889]

[0, 2, 3, 5, 9, 13, 26, 28, 30, 36, 37, 38, 40, 50, 66, 67, 77, 83, 84, 87, 94, 99, 103, 105, 108, 122, 125, 127, 128, 129, 148, 156, 160, 163, 173, 178, 181, 185, 194, 206, 207, 214, 216, 226, 227, 229, 230, 234, 238, 242, 249, 253, 254, 260, 262, 269, 287, 294, 303, 305, 306, 307, 320, 321, 322, 328, 329, 335, 339, 341, 343, 348, 349, 357, 359, 360, 368, 382, 384, 386, 388, 391, 395, 397, 399, 400, 401, 403, 404, 408, 410, 413, 414, 416, 418, 439, 442, 444, 454, 468, 474, 478, 489, 490, 491, 502, 508, 512, 517, 519, 520, 525, 543, 547, 555, 556, 568, 570, 573, 576, 585, 598, 603, 611, 616, 648, 654, 659, 665, 674, 687, 689, 698, 702, 707, 711, 712, 713, 714, 719, 721, 726, 735, 736, 747, 749, 751, 752, 755, 760, 765, 768, 770, 773, 781, 791, 792, 798, 801, 804, 819, 823, 830, 834, 845, 848, 849, 850, 859, 883, 887, 888]
[7, 16, 45, 57, 60, 79, 88, 92, 94, 114, 128, 129, 138, 139, 141, 147, 153, 166, 173, 177, 196, 200, 201, 204, 222, 227, 236, 245, 246, 248, 249, 258, 271, 282, 285, 295, 301, 314, 315, 328, 334, 338, 340, 346, 348, 368, 370, 383, 389, 406, 424, 431, 433, 434, 443, 453, 455, 461, 462, 469, 472, 481, 488, 494, 505, 513, 523, 531, 537, 538, 541, 543, 548, 560, 567, 574, 576, 580, 593, 605, 613, 618, 627, 639, 642, 649, 659, 660, 669, 679, 683, 686, 689, 690, 691, 693, 703, 710, 741, 752, 759, 760, 762, 766, 772, 776, 780, 784, 785, 799, 814, 826, 831, 841, 843, 850, 852, 854, 855, 877, 880, 889]

[0, 2, 3, 5, 9, 10, 13, 26, 28, 30, 36, 37, 38, 40, 44, 50, 55, 66, 67, 77, 83, 84, 87, 94, 99, 101, 103, 105, 108, 109, 114, 122, 125, 127, 128, 129, 144, 148, 150, 156, 158, 160, 163, 164, 169, 173, 178, 180, 181, 185, 194, 206, 207, 214, 216, 218, 226, 227, 229, 230, 233, 234, 238, 242, 248, 249, 251, 252, 253, 254, 259, 260, 262, 265, 266, 268, 269, 286, 287, 294, 297, 303, 305, 306, 307, 309, 318, 320, 321, 322, 327, 328, 329, 335, 338, 339, 341, 343, 348, 349, 350, 357, 359, 360, 368, 382, 384, 386, 388, 389, 391, 395, 397, 399, 400, 401, 402, 403, 404, 408, 410, 413, 414, 416, 418, 430, 439, 442, 444, 451, 454, 463, 466, 468, 474, 478, 489, 490, 491, 499, 502, 508, 512, 517, 519, 520, 525, 543, 544, 547, 554, 555, 556, 563, 568, 570, 573, 576, 580, 583, 585, 586, 598, 603, 611, 613, 616, 629, 634, 636, 638, 648, 654, 658, 659, 665, 669, 674, 676, 679, 681, 682, 687, 689, 691, 698, 702, 706, 707, 711, 712, 713, 714, 717, 719, 721, 726, 735, 736, 739, 741, 747, 748, 749, 751, 752, 755, 760, 762, 765, 766, 768, 770, 773, 781, 790, 791, 792, 798, 799, 800, 801, 804, 809, 811, 819, 820, 823, 830, 833, 834, 837, 841, 842, 843, 845, 848, 849, 850, 859, 861, 863, 878, 879, 883, 887, 888]
[7, 16, 45, 57, 60, 79, 88, 92, 94, 114, 128, 129, 138, 139, 141, 147, 153, 166, 173, 177, 196, 200, 201, 204, 222, 227, 236, 245, 246, 248, 249, 258, 271, 282, 285, 295, 301, 314, 315, 328, 334, 338, 340, 346, 348, 368, 370, 383, 389, 406, 424, 431, 433, 434, 443, 453, 455, 461, 462, 469, 472, 481, 488, 494, 505, 513, 523, 531, 537, 538, 541, 543, 548, 560, 567, 574, 576, 580, 593, 605, 613, 618, 627, 639, 642, 649, 659, 660, 669, 679, 683, 686, 689, 690, 691, 693, 703, 710, 741, 752, 759, 760, 762, 766, 772, 776, 780, 784, 785, 799, 814, 826, 831, 841, 843, 850, 852, 854, 855, 877, 880, 889]

[0, 2, 3, 5, 6, 9, 10, 11, 13, 16, 19, 20, 22, 23, 25, 26, 28, 30, 31, 33, 36, 37, 38, 40, 42, 44, 45, 50, 55, 66, 67, 73, 77, 78, 81, 83, 84, 86, 87, 94, 95, 98, 99, 101, 103, 104, 105, 108, 109, 112, 114, 122, 125, 127, 128, 129, 134, 136, 138, 144, 148, 150, 153, 156, 158, 160, 163, 164, 169, 173, 178, 180, 181, 184, 185, 188, 194, 206, 207, 214, 216, 218, 222, 226, 227, 229, 230, 231, 233, 234, 238, 242, 246, 248, 249, 251, 252, 253, 254, 259, 260, 262, 265, 266, 268, 269, 279, 281, 286, 287, 292, 294, 295, 297, 298, 303, 305, 306, 307, 309, 313, 318, 320, 321, 322, 323, 327, 328, 329, 331, 333, 335, 338, 339, 341, 343, 348, 349, 350, 357, 359, 360, 365, 368, 373, 382, 384, 385, 386, 388, 389, 391, 395, 397, 399, 400, 401, 402, 403, 404, 408, 410, 413, 414, 416, 418, 419, 425, 428, 430, 433, 438, 439, 442, 444, 446, 451, 454, 463, 466, 468, 474, 478, 489, 490, 491, 498, 499, 502, 505, 508, 510, 512, 514, 517, 519, 520, 525, 527, 532, 543, 544, 547, 554, 555, 556, 562, 563, 566, 568, 570, 573, 576, 580, 581, 583, 585, 586, 587, 596, 598, 599, 603, 611, 613, 616, 629, 634, 635, 636, 638, 648, 654, 657, 658, 659, 665, 669, 674, 675, 676, 679, 681, 682, 686, 687, 689, 691, 698, 702, 706, 707, 708, 711, 712, 713, 714, 717, 719, 721, 724, 725, 726, 731, 735, 736, 739, 741, 747, 748, 749, 751, 752, 755, 760, 762, 765, 766, 767, 768, 769, 770, 773, 781, 786, 790, 791, 792, 795, 798, 799, 800, 801, 804, 809, 811, 813, 819, 820, 823, 825, 830, 833, 834, 837, 841, 842, 843, 845, 848, 849, 850, 853, 859, 861, 863, 866, 878, 879, 883, 887, 888]
[7, 16, 45, 57, 60, 79, 88, 92, 94, 114, 128, 129, 138, 139, 141, 147, 153, 166, 173, 177, 196, 200, 201, 204, 222, 227, 236, 245, 246, 248, 249, 258, 271, 282, 285, 295, 301, 314, 315, 328, 334, 338, 340, 346, 348, 368, 370, 383, 389, 406, 424, 431, 433, 434, 443, 453, 455, 461, 462, 469, 472, 481, 488, 494, 505, 513, 523, 531, 537, 538, 541, 543, 548, 560, 567, 574, 576, 580, 593, 605, 613, 618, 627, 639, 642, 649, 659, 660, 669, 679, 683, 686, 689, 690, 691, 693, 703, 710, 741, 752, 759, 760, 762, 766, 772, 776, 780, 784, 785, 799, 814, 826, 831, 841, 843, 850, 852, 854, 855, 877, 880, 889]

[0, 2, 3, 5, 6, 9, 10, 11, 12, 13, 14, 15, 16, 19, 20, 22, 23, 25, 26, 28, 30, 31, 33, 34, 35, 36, 37, 38, 39, 40, 42, 43, 44, 45, 50, 55, 59, 62, 66, 67, 73, 74, 77, 78, 81, 83, 84, 86, 87, 89, 94, 95, 98, 99, 101, 103, 104, 105, 108, 109, 112, 114, 122, 125, 126, 127, 128, 129, 134, 136, 138, 144, 148, 150, 152, 153, 156, 158, 160, 163, 164, 169, 170, 173, 178, 180, 181, 184, 185, 188, 194, 200, 206, 207, 211, 214, 216, 217, 218, 222, 226, 227, 229, 230, 231, 232, 233, 234, 238, 242, 246, 248, 249, 250, 251, 252, 253, 254, 259, 260, 262, 265, 266, 267, 268, 269, 270, 272, 273, 279, 281, 286, 287, 292, 294, 295, 297, 298, 303, 305, 306, 307, 309, 313, 318, 320, 321, 322, 323, 327, 328, 329, 331, 333, 335, 338, 339, 341, 343, 344, 347, 348, 349, 350, 354, 357, 358, 359, 360, 365, 368, 370, 373, 375, 380, 382, 384, 385, 386, 388, 389, 391, 395, 397, 398, 399, 400, 401, 402, 403, 404, 405, 406, 408, 410, 411, 413, 414, 416, 418, 419, 425, 428, 430, 433, 438, 439, 440, 441, 442, 444, 445, 446, 449, 451, 454, 456, 458, 463, 466, 468, 473, 474, 476, 478, 485, 489, 490, 491, 498, 499, 502, 505, 508, 510, 512, 514, 517, 519, 520, 525, 527, 529, 532, 534, 535, 540, 542, 543, 544, 547, 554, 555, 556, 562, 563, 566, 568, 570, 573, 576, 580, 581, 583, 585, 586, 587, 593, 596, 598, 599, 603, 605, 611, 613, 616, 619, 625, 629, 632, 634, 635, 636, 638, 643, 644, 648, 651, 653, 654, 657, 658, 659, 661, 664, 665, 666, 669, 670, 674, 675, 676, 679, 681, 682, 686, 687, 689, 691, 698, 702, 703, 706, 707, 708, 711, 712, 713, 714, 717, 719, 721, 724, 725, 726, 727, 730, 731, 735, 736, 739, 741, 747, 748, 749, 750, 751, 752, 755, 760, 762, 765, 766, 767, 768, 769, 770, 773, 778, 779, 781, 786, 790, 791, 792, 795, 796, 798, 799, 800, 801, 804, 809, 811, 813, 818, 819, 820, 823, 825, 827, 830, 831, 832, 833, 834, 837, 841, 842, 843, 845, 848, 849, 850, 853, 854, 855, 859, 861, 863, 865, 866, 871, 874, 878, 879, 883, 887, 888]
[7, 16, 45, 57, 60, 79, 88, 92, 94, 114, 128, 129, 138, 139, 141, 147, 153, 166, 173, 177, 196, 200, 201, 204, 222, 227, 236, 245, 246, 248, 249, 258, 271, 282, 285, 295, 301, 314, 315, 328, 334, 338, 340, 346, 348, 368, 370, 383, 389, 406, 424, 431, 433, 434, 443, 453, 455, 461, 462, 469, 472, 481, 488, 494, 505, 513, 523, 531, 537, 538, 541, 543, 548, 560, 567, 574, 576, 580, 593, 605, 613, 618, 627, 639, 642, 649, 659, 660, 669, 679, 683, 686, 689, 690, 691, 693, 703, 710, 741, 752, 759, 760, 762, 766, 772, 776, 780, 784, 785, 799, 814, 826, 831, 841, 843, 850, 852, 854, 855, 877, 880, 889]

[0, 2, 3, 5, 6, 9, 10, 11, 12, 13, 14, 15, 16, 19, 20, 22, 23, 25, 26, 28, 30, 31, 33, 34, 35, 36, 37, 38, 39, 40, 42, 43, 44, 45, 50, 55, 56, 59, 62, 66, 67, 73, 74, 77, 78, 81, 82, 83, 84, 86, 87, 89, 91, 93, 94, 95, 98, 99, 101, 103, 104, 105, 107, 108, 109, 111, 112, 114, 117, 119, 122, 125, 126, 127, 128, 129, 133, 134, 136, 138, 140, 144, 147, 148, 150, 152, 153, 156, 158, 159, 160, 163, 164, 167, 169, 170, 173, 178, 180, 181, 184, 185, 186, 188, 190, 192, 193, 194, 197, 200, 206, 207, 211, 214, 216, 217, 218, 222, 226, 227, 229, 230, 231, 232, 233, 234, 238, 239, 240, 242, 246, 247, 248, 249, 250, 251, 252, 253, 254, 259, 260, 262, 263, 265, 266, 267, 268, 269, 270, 272, 273, 279, 281, 286, 287, 292, 294, 295, 297, 298, 301, 303, 305, 306, 307, 309, 310, 313, 318, 320, 321, 322, 323, 327, 328, 329, 331, 332, 333, 335, 338, 339, 340, 341, 343, 344, 347, 348, 349, 350, 354, 357, 358, 359, 360, 362, 363, 364, 365, 368, 370, 371, 372, 373, 375, 376, 380, 382, 384, 385, 386, 388, 389, 391, 393, 395, 397, 398, 399, 400, 401, 402, 403, 404, 405, 406, 408, 410, 411, 413, 414, 415, 416, 418, 419, 423, 425, 428, 430, 433, 438, 439, 440, 441, 442, 443, 444, 445, 446, 449, 451, 454, 456, 458, 463, 464, 466, 468, 470, 473, 474, 476, 478, 485, 489, 490, 491, 498, 499, 500, 502, 505, 508, 510, 512, 513, 514, 517, 519, 520, 525, 527, 529, 532, 534, 535, 540, 542, 543, 544, 547, 554, 555, 556, 558, 562, 563, 564, 566, 567, 568, 570, 573, 576, 577, 578, 579, 580, 581, 583, 584, 585, 586, 587, 588, 592, 593, 596, 598, 599, 600, 603, 605, 610, 611, 613, 616, 617, 619, 621, 625, 628, 629, 632, 634, 635, 636, 638, 641, 642, 643, 644, 648, 651, 653, 654, 657, 658, 659, 661, 664, 665, 666, 668, 669, 670, 674, 675, 676, 679, 681, 682, 686, 687, 689, 691, 692, 698, 701, 702, 703, 706, 707, 708, 709, 710, 711, 712, 713, 714, 717, 718, 719, 720, 721, 724, 725, 726, 727, 730, 731, 734, 735, 736, 737, 739, 740, 741, 744, 747, 748, 749, 750, 751, 752, 755, 760, 762, 765, 766, 767, 768, 769, 770, 773, 778, 779, 781, 784, 786, 790, 791, 792, 795, 796, 798, 799, 800, 801, 804, 809, 811, 813, 817, 818, 819, 820, 823, 825, 826, 827, 830, 831, 832, 833, 834, 837, 838, 841, 842, 843, 845, 848, 849, 850, 853, 854, 855, 859, 861, 863, 865, 866, 867, 871, 874, 875, 876, 878, 879, 883, 885, 887, 888]
[7, 16, 45, 57, 60, 79, 88, 92, 94, 114, 128, 129, 138, 139, 141, 147, 153, 166, 173, 177, 196, 200, 201, 204, 222, 227, 236, 245, 246, 248, 249, 258, 271, 282, 285, 295, 301, 314, 315, 328, 334, 338, 340, 346, 348, 368, 370, 383, 389, 406, 424, 431, 433, 434, 443, 453, 455, 461, 462, 469, 472, 481, 488, 494, 505, 513, 523, 531, 537, 538, 541, 543, 548, 560, 567, 574, 576, 580, 593, 605, 613, 618, 627, 639, 642, 649, 659, 660, 669, 679, 683, 686, 689, 690, 691, 693, 703, 710, 741, 752, 759, 760, 762, 766, 772, 776, 780, 784, 785, 799, 814, 826, 831, 841, 843, 850, 852, 854, 855, 877, 880, 889]

[0, 2, 3, 5, 6, 8, 9, 10, 11, 12, 13, 14, 15, 16, 19, 20, 21, 22, 23, 25, 26, 28, 30, 31, 33, 34, 35, 36, 37, 38, 39, 40, 41, 42, 43, 44, 45, 47, 48, 50, 54, 55, 56, 59, 62, 66, 67, 69, 71, 72, 73, 74, 75, 77, 78, 81, 82, 83, 84, 86, 87, 89, 91, 92, 93, 94, 95, 98, 99, 101, 102, 103, 104, 105, 107, 108, 109, 111, 112, 114, 115, 117, 119, 122, 125, 126, 127, 128, 129, 132, 133, 134, 136, 137, 138, 140, 144, 146, 147, 148, 150, 151, 152, 153, 155, 156, 158, 159, 160, 163, 164, 165, 167, 169, 170, 173, 176, 178, 179, 180, 181, 184, 185, 186, 188, 189, 190, 192, 193, 194, 195, 197, 199, 200, 204, 205, 206, 207, 211, 213, 214, 216, 217, 218, 222, 226, 227, 228, 229, 230, 231, 232, 233, 234, 237, 238, 239, 240, 242, 245, 246, 247, 248, 249, 250, 251, 252, 253, 254, 259, 260, 262, 263, 264, 265, 266, 267, 268, 269, 270, 272, 273, 274, 279, 281, 286, 287, 289, 291, 292, 294, 295, 297, 298, 301, 302, 303, 304, 305, 306, 307, 309, 310, 311, 313, 318, 320, 321, 322, 323, 327, 328, 329, 331, 332, 333, 334, 335, 338, 339, 340, 341, 343, 344, 346, 347, 348, 349, 350, 351, 352, 354, 357, 358, 359, 360, 362, 363, 364, 365, 368, 370, 371, 372, 373, 375, 376, 380, 382, 384, 385, 386, 388, 389, 390, 391, 392, 393, 395, 397, 398, 399, 400, 401, 402, 403, 404, 405, 406, 408, 410, 411, 413, 414, 415, 416, 418, 419, 423, 425, 428, 430, 433, 438, 439, 440, 441, 442, 443, 444, 445, 446, 449, 450, 451, 453, 454, 456, 457, 458, 463, 464, 466, 468, 470, 473, 474, 476, 477, 478, 485, 489, 490, 491, 498, 499, 500, 502, 505, 507, 508, 510, 512, 513, 514, 515, 517, 518, 519, 520, 523, 524, 525, 526, 527, 529, 532, 534, 535, 540, 541, 542, 543, 544, 547, 554, 555, 556, 558, 562, 563, 564, 565, 566, 567, 568, 570, 573, 576, 577, 578, 579, 580, 581, 582, 583, 584, 585, 586, 587, 588, 592, 593, 595, 596, 598, 599, 600, 603, 605, 607, 610, 611, 613, 615, 616, 617, 619, 621, 625, 628, 629, 631, 632, 634, 635, 636, 638, 641, 642, 643, 644, 648, 651, 652, 653, 654, 657, 658, 659, 661, 663, 664, 665, 666, 668, 669, 670, 674, 675, 676, 679, 681, 682, 686, 687, 688, 689, 690, 691, 692, 696, 698, 701, 702, 703, 706, 707, 708, 709, 710, 711, 712, 713, 714, 717, 718, 719, 720, 721, 724, 725, 726, 727, 730, 731, 732, 734, 735, 736, 737, 738, 739, 740, 741, 742, 744, 747, 748, 749, 750, 751, 752, 755, 756, 758, 760, 762, 763, 764, 765, 766, 767, 768, 769, 770, 773, 778, 779, 781, 783, 784, 786, 790, 791, 792, 795, 796, 798, 799, 800, 801, 804, 809, 810, 811, 812, 813, 817, 818, 819, 820, 823, 825, 826, 827, 830, 831, 832, 833, 834, 837, 838, 840, 841, 842, 843, 845, 848, 849, 850, 852, 853, 854, 855, 859, 861, 863, 865, 866, 867, 871, 873, 874, 875, 876, 877, 878, 879, 883, 885, 887, 888]
[7, 16, 45, 57, 60, 79, 88, 92, 94, 114, 128, 129, 138, 139, 141, 147, 153, 166, 173, 177, 196, 200, 201, 204, 222, 227, 236, 245, 246, 248, 249, 258, 271, 282, 285, 295, 301, 314, 315, 328, 334, 338, 340, 346, 348, 368, 370, 383, 389, 406, 424, 431, 433, 434, 443, 453, 455, 461, 462, 469, 472, 481, 488, 494, 505, 513, 523, 531, 537, 538, 541, 543, 548, 560, 567, 574, 576, 580, 593, 605, 613, 618, 627, 639, 642, 649, 659, 660, 669, 679, 683, 686, 689, 690, 691, 693, 703, 710, 741, 752, 759, 760, 762, 766, 772, 776, 780, 784, 785, 799, 814, 826, 831, 841, 843, 850, 852, 854, 855, 877, 880, 889]

[0, 2, 3, 4, 5, 6, 8, 9, 10, 11, 12, 13, 14, 15, 16, 19, 20, 21, 22, 23, 24, 25, 26, 28, 30, 31, 33, 34, 35, 36, 37, 38, 39, 40, 41, 42, 43, 44, 45, 47, 48, 50, 54, 55, 56, 58, 59, 62, 65, 66, 67, 69, 71, 72, 73, 74, 75, 77, 78, 81, 82, 83, 84, 85, 86, 87, 89, 91, 92, 93, 94, 95, 98, 99, 100, 101, 102, 103, 104, 105, 107, 108, 109, 111, 112, 114, 115, 117, 119, 122, 123, 125, 126, 127, 128, 129, 130, 132, 133, 134, 136, 137, 138, 140, 141, 144, 146, 147, 148, 150, 151, 152, 153, 155, 156, 158, 159, 160, 163, 164, 165, 167, 169, 170, 172, 173, 174, 176, 177, 178, 179, 180, 181, 183, 184, 185, 186, 188, 189, 190, 192, 193, 194, 195, 197, 199, 200, 201, 204, 205, 206, 207, 211, 213, 214, 216, 217, 218, 221, 222, 226, 227, 228, 229, 230, 231, 232, 233, 234, 237, 238, 239, 240, 242, 245, 246, 247, 248, 249, 250, 251, 252, 253, 254, 257, 258, 259, 260, 262, 263, 264, 265, 266, 267, 268, 269, 270, 272, 273, 274, 278, 279, 281, 286, 287, 289, 290, 291, 292, 294, 295, 297, 298, 299, 301, 302, 303, 304, 305, 306, 307, 309, 310, 311, 313, 314, 315, 316, 318, 320, 321, 322, 323, 327, 328, 329, 331, 332, 333, 334, 335, 338, 339, 340, 341, 343, 344, 346, 347, 348, 349, 350, 351, 352, 354, 356, 357, 358, 359, 360, 361, 362, 363, 364, 365, 368, 370, 371, 372, 373, 375, 376, 380, 381, 382, 384, 385, 386, 387, 388, 389, 390, 391, 392, 393, 395, 397, 398, 399, 400, 401, 402, 403, 404, 405, 406, 408, 410, 411, 413, 414, 415, 416, 417, 418, 419, 420, 423, 425, 428, 430, 433, 435, 438, 439, 440, 441, 442, 443, 444, 445, 446, 449, 450, 451, 453, 454, 456, 457, 458, 461, 462, 463, 464, 466, 468, 470, 473, 474, 475, 476, 477, 478, 485, 486, 489, 490, 491, 495, 498, 499, 500, 502, 504, 505, 507, 508, 510, 512, 513, 514, 515, 517, 518, 519, 520, 523, 524, 525, 526, 527, 529, 530, 532, 534, 535, 540, 541, 542, 543, 544, 547, 548, 554, 555, 556, 558, 562, 563, 564, 565, 566, 567, 568, 570, 571, 573, 574, 575, 576, 577, 578, 579, 580, 581, 582, 583, 584, 585, 586, 587, 588, 590, 592, 593, 594, 595, 596, 598, 599, 600, 602, 603, 605, 607, 608, 610, 611, 613, 615, 616, 617, 619, 620, 621, 625, 627, 628, 629, 631, 632, 634, 635, 636, 638, 639, 641, 642, 643, 644, 648, 651, 652, 653, 654, 657, 658, 659, 661, 663, 664, 665, 666, 668, 669, 670, 671, 674, 675, 676, 679, 681, 682, 683, 685, 686, 687, 688, 689, 690, 691, 692, 696, 698, 699, 701, 702, 703, 704, 706, 707, 708, 709, 710, 711, 712, 713, 714, 715, 716, 717, 718, 719, 720, 721, 723, 724, 725, 726, 727, 728, 729, 730, 731, 732, 734, 735, 736, 737, 738, 739, 740, 741, 742, 744, 747, 748, 749, 750, 751, 752, 755, 756, 758, 759, 760, 762, 763, 764, 765, 766, 767, 768, 769, 770, 771, 773, 775, 778, 779, 781, 782, 783, 784, 786, 789, 790, 791, 792, 794, 795, 796, 798, 799, 800, 801, 802, 803, 804, 809, 810, 811, 812, 813, 817, 818, 819, 820, 821, 823, 825, 826, 827, 829, 830, 831, 832, 833, 834, 837, 838, 840, 841, 842, 843, 845, 848, 849, 850, 852, 853, 854, 855, 859, 860, 861, 863, 864, 865, 866, 867, 871, 872, 873, 874, 875, 876, 877, 878, 879, 880, 883, 884, 885, 886, 887, 888, 889]
[7, 16, 45, 57, 60, 79, 88, 92, 94, 114, 128, 129, 138, 139, 141, 147, 153, 166, 173, 177, 196, 200, 201, 204, 222, 227, 236, 245, 246, 248, 249, 258, 271, 282, 285, 295, 301, 314, 315, 328, 334, 338, 340, 346, 348, 368, 370, 383, 389, 406, 424, 431, 433, 434, 443, 453, 455, 461, 462, 469, 472, 481, 488, 494, 505, 513, 523, 531, 537, 538, 541, 543, 548, 560, 567, 574, 576, 580, 593, 605, 613, 618, 627, 639, 642, 649, 659, 660, 669, 679, 683, 686, 689, 690, 691, 693, 703, 710, 741, 752, 759, 760, 762, 766, 772, 776, 780, 784, 785, 799, 814, 826, 831, 841, 843, 850, 852, 854, 855, 877, 880, 889]

[0, 2, 3, 4, 5, 6, 7, 8, 9, 10, 11, 12, 13, 14, 15, 16, 17, 19, 20, 21, 22, 23, 24, 25, 26, 28, 29, 30, 31, 33, 34, 35, 36, 37, 38, 39, 40, 41, 42, 43, 44, 45, 47, 48, 50, 53, 54, 55, 56, 58, 59, 62, 65, 66, 67, 68, 69, 71, 72, 73, 74, 75, 76, 77, 78, 81, 82, 83, 84, 85, 86, 87, 88, 89, 91, 92, 93, 94, 95, 98, 99, 100, 101, 102, 103, 104, 105, 107, 108, 109, 111, 112, 113, 114, 115, 117, 119, 122, 123, 125, 126, 127, 128, 129, 130, 132, 133, 134, 136, 137, 138, 140, 141, 144, 146, 147, 148, 150, 151, 152, 153, 154, 155, 156, 157, 158, 159, 160, 163, 164, 165, 167, 168, 169, 170, 172, 173, 174, 176, 177, 178, 179, 180, 181, 183, 184, 185, 186, 187, 188, 189, 190, 192, 193, 194, 195, 196, 197, 199, 200, 201, 203, 204, 205, 206, 207, 210, 211, 212, 213, 214, 216, 217, 218, 221, 222, 223, 226, 227, 228, 229, 230, 231, 232, 233, 234, 237, 238, 239, 240, 241, 242, 243, 245, 246, 247, 248, 249, 250, 251, 252, 253, 254, 257, 258, 259, 260, 262, 263, 264, 265, 266, 267, 268, 269, 270, 271, 272, 273, 274, 276, 278, 279, 281, 283, 285, 286, 287, 289, 290, 291, 292, 294, 295, 297, 298, 299, 301, 302, 303, 304, 305, 306, 307, 308, 309, 310, 311, 313, 314, 315, 316, 317, 318, 320, 321, 322, 323, 324, 325, 327, 328, 329, 330, 331, 332, 333, 334, 335, 336, 337, 338, 339, 340, 341, 342, 343, 344, 346, 347, 348, 349, 350, 351, 352, 354, 356, 357, 358, 359, 360, 361, 362, 363, 364, 365, 368, 370, 371, 372, 373, 375, 376, 377, 380, 381, 382, 384, 385, 386, 387, 388, 389, 390, 391, 392, 393, 395, 397, 398, 399, 400, 401, 402, 403, 404, 405, 406, 408, 409, 410, 411, 413, 414, 415, 416, 417, 418, 419, 420, 423, 425, 426, 427, 428, 430, 433, 435, 436, 437, 438, 439, 440, 441, 442, 443, 444, 445, 446, 449, 450, 451, 453, 454, 456, 457, 458, 459, 461, 462, 463, 464, 465, 466, 468, 470, 471, 473, 474, 475, 476, 477, 478, 479, 481, 482, 485, 486, 488, 489, 490, 491, 493, 494, 495, 498, 499, 500, 502, 504, 505, 507, 508, 509, 510, 512, 513, 514, 515, 517, 518, 519, 520, 523, 524, 525, 526, 527, 528, 529, 530, 531, 532, 534, 535, 537, 540, 541, 542, 543, 544, 545, 547, 548, 553, 554, 555, 556, 558, 560, 562, 563, 564, 565, 566, 567, 568, 569, 570, 571, 573, 574, 575, 576, 577, 578, 579, 580, 581, 582, 583, 584, 585, 586, 587, 588, 590, 592, 593, 594, 595, 596, 597, 598, 599, 600, 602, 603, 604, 605, 606, 607, 608, 610, 611, 613, 615, 616, 617, 619, 620, 621, 622, 623, 625, 627, 628, 629, 631, 632, 633, 634, 635, 636, 638, 639, 641, 642, 643, 644, 645, 647, 648, 651, 652, 653, 654, 655, 657, 658, 659, 661, 663, 664, 665, 666, 667, 668, 669, 670, 671, 674, 675, 676, 679, 681, 682, 683, 685, 686, 687, 688, 689, 690, 691, 692, 693, 696, 698, 699, 701, 702, 703, 704, 705, 706, 707, 708, 709, 710, 711, 712, 713, 714, 715, 716, 717, 718, 719, 720, 721, 723, 724, 725, 726, 727, 728, 729, 730, 731, 732, 734, 735, 736, 737, 738, 739, 740, 741, 742, 744, 747, 748, 749, 750, 751, 752, 755, 756, 757, 758, 759, 760, 761, 762, 763, 764, 765, 766, 767, 768, 769, 770, 771, 772, 773, 775, 778, 779, 781, 782, 783, 784, 785, 786, 787, 788, 789, 790, 791, 792, 794, 795, 796, 798, 799, 800, 801, 802, 803, 804, 809, 810, 811, 812, 813, 814, 816, 817, 818, 819, 820, 821, 823, 825, 826, 827, 828, 829, 830, 831, 832, 833, 834, 835, 837, 838, 840, 841, 842, 843, 845, 846, 847, 848, 849, 850, 852, 853, 854, 855, 859, 860, 861, 863, 864, 865, 866, 867, 868, 871, 872, 873, 874, 875, 876, 877, 878, 879, 880, 883, 884, 885, 886, 887, 888, 889]
[7, 16, 45, 57, 60, 79, 88, 92, 94, 114, 128, 129, 138, 139, 141, 147, 153, 166, 173, 177, 196, 200, 201, 204, 222, 227, 236, 245, 246, 248, 249, 258, 271, 282, 285, 295, 301, 314, 315, 328, 334, 338, 340, 346, 348, 368, 370, 383, 389, 406, 424, 431, 433, 434, 443, 453, 455, 461, 462, 469, 472, 481, 488, 494, 505, 513, 523, 531, 537, 538, 541, 543, 548, 560, 567, 574, 576, 580, 593, 605, 613, 618, 627, 639, 642, 649, 659, 660, 669, 679, 683, 686, 689, 690, 691, 693, 703, 710, 741, 752, 759, 760, 762, 766, 772, 776, 780, 784, 785, 799, 814, 826, 831, 841, 843, 850, 852, 854, 855, 877, 880, 889]

[0, 2, 3, 4, 5, 6, 7, 8, 9, 10, 11, 12, 13, 14, 15, 16, 17, 19, 20, 21, 22, 23, 24, 25, 26, 28, 29, 30, 31, 33, 34, 35, 36, 37, 38, 39, 40, 41, 42, 43, 44, 45, 47, 48, 50, 53, 54, 55, 56, 57, 58, 59, 61, 62, 63, 65, 66, 67, 68, 69, 70, 71, 72, 73, 74, 75, 76, 77, 78, 79, 81, 82, 83, 84, 85, 86, 87, 88, 89, 91, 92, 93, 94, 95, 97, 98, 99, 100, 101, 102, 103, 104, 105, 107, 108, 109, 110, 111, 112, 113, 114, 115, 116, 117, 119, 120, 121, 122, 123, 125, 126, 127, 128, 129, 130, 132, 133, 134, 135, 136, 137, 138, 140, 141, 144, 146, 147, 148, 149, 150, 151, 152, 153, 154, 155, 156, 157, 158, 159, 160, 162, 163, 164, 165, 167, 168, 169, 170, 172, 173, 174, 176, 177, 178, 179, 180, 181, 183, 184, 185, 186, 187, 188, 189, 190, 191, 192, 193, 194, 195, 196, 197, 199, 200, 201, 202, 203, 204, 205, 206, 207, 210, 211, 212, 213, 214, 216, 217, 218, 220, 221, 222, 223, 224, 226, 227, 228, 229, 230, 231, 232, 233, 234, 237, 238, 239, 240, 241, 242, 243, 245, 246, 247, 248, 249, 250, 251, 252, 253, 254, 255, 256, 257, 258, 259, 260, 262, 263, 264, 265, 266, 267, 268, 269, 270, 271, 272, 273, 274, 275, 276, 277, 278, 279, 280, 281, 283, 284, 285, 286, 287, 288, 289, 290, 291, 292, 294, 295, 296, 297, 298, 299, 300, 301, 302, 303, 304, 305, 306, 307, 308, 309, 310, 311, 312, 313, 314, 315, 316, 317, 318, 320, 321, 322, 323, 324, 325, 327, 328, 329, 330, 331, 332, 333, 334, 335, 336, 337, 338, 339, 340, 341, 342, 343, 344, 346, 347, 348, 349, 350, 351, 352, 354, 355, 356, 357, 358, 359, 360, 361, 362, 363, 364, 365, 367, 368, 370, 371, 372, 373, 374, 375, 376, 377, 378, 379, 380, 381, 382, 384, 385, 386, 387, 388, 389, 390, 391, 392, 393, 395, 397, 398, 399, 400, 401, 402, 403, 404, 405, 406, 408, 409, 410, 411, 412, 413, 414, 415, 416, 417, 418, 419, 420, 421, 423, 424, 425, 426, 427, 428, 430, 431, 433, 435, 436, 437, 438, 439, 440, 441, 442, 443, 444, 445, 446, 448, 449, 450, 451, 453, 454, 455, 456, 457, 458, 459, 461, 462, 463, 464, 465, 466, 467, 468, 469, 470, 471, 473, 474, 475, 476, 477, 478, 479, 480, 481, 482, 483, 484, 485, 486, 488, 489, 490, 491, 493, 494, 495, 496, 498, 499, 500, 501, 502, 503, 504, 505, 507, 508, 509, 510, 511, 512, 513, 514, 515, 517, 518, 519, 520, 521, 522, 523, 524, 525, 526, 527, 528, 529, 530, 531, 532, 534, 535, 537, 540, 541, 542, 543, 544, 545, 546, 547, 548, 549, 552, 553, 554, 555, 556, 558, 560, 562, 563, 564, 565, 566, 567, 568, 569, 570, 571, 573, 574, 575, 576, 577, 578, 579, 580, 581, 582, 583, 584, 585, 586, 587, 588, 590, 592, 593, 594, 595, 596, 597, 598, 599, 600, 601, 602, 603, 604, 605, 606, 607, 608, 610, 611, 612, 613, 615, 616, 617, 618, 619, 620, 621, 622, 623, 625, 627, 628, 629, 631, 632, 633, 634, 635, 636, 638, 639, 640, 641, 642, 643, 644, 645, 646, 647, 648, 651, 652, 653, 654, 655, 657, 658, 659, 661, 663, 664, 665, 666, 667, 668, 669, 670, 671, 673, 674, 675, 676, 677, 678, 679, 681, 682, 683, 685, 686, 687, 688, 689, 690, 691, 692, 693, 694, 695, 696, 698, 699, 701, 702, 703, 704, 705, 706, 707, 708, 709, 710, 711, 712, 713, 714, 715, 716, 717, 718, 719, 720, 721, 722, 723, 724, 725, 726, 727, 728, 729, 730, 731, 732, 733, 734, 735, 736, 737, 738, 739, 740, 741, 742, 744, 745, 746, 747, 748, 749, 750, 751, 752, 755, 756, 757, 758, 759, 760, 761, 762, 763, 764, 765, 766, 767, 768, 769, 770, 771, 772, 773, 774, 775, 776, 778, 779, 781, 782, 783, 784, 785, 786, 787, 788, 789, 790, 791, 792, 794, 795, 796, 797, 798, 799, 800, 801, 802, 803, 804, 809, 810, 811, 812, 813, 814, 816, 817, 818, 819, 820, 821, 822, 823, 825, 826, 827, 828, 829, 830, 831, 832, 833, 834, 835, 837, 838, 840, 841, 842, 843, 844, 845, 846, 847, 848, 849, 850, 852, 853, 854, 855, 856, 857, 859, 860, 861, 862, 863, 864, 865, 866, 867, 868, 871, 872, 873, 874, 875, 876, 877, 878, 879, 880, 881, 883, 884, 885, 886, 887, 888, 889]
[7, 16, 45, 57, 60, 79, 88, 92, 94, 114, 128, 129, 138, 139, 141, 147, 153, 166, 173, 177, 196, 200, 201, 204, 222, 227, 236, 245, 246, 248, 249, 258, 271, 282, 285, 295, 301, 314, 315, 328, 334, 338, 340, 346, 348, 368, 370, 383, 389, 406, 424, 431, 433, 434, 443, 453, 455, 461, 462, 469, 472, 481, 488, 494, 505, 513, 523, 531, 537, 538, 541, 543, 548, 560, 567, 574, 576, 580, 593, 605, 613, 618, 627, 639, 642, 649, 659, 660, 669, 679, 683, 686, 689, 690, 691, 693, 703, 710, 741, 752, 759, 760, 762, 766, 772, 776, 780, 784, 785, 799, 814, 826, 831, 841, 843, 850, 852, 854, 855, 877, 880, 889]

