[1, 3, 15, 31, 66, 81, 173, 198, 201, 260, 311, 336, 349, 404, 434, 449, 479, 629, 646, 796, 817, 822]
[30, 154, 165, 178, 184, 238, 272, 298, 418, 465, 466, 467, 607, 609, 697, 733, 759, 802, 811, 863, 866, 878]

[1, 3, 15, 31, 66, 81, 173, 198, 201, 260, 311, 336, 349, 404, 434, 449, 479, 629, 646, 796, 817, 822]
[30, 35, 40, 41, 49, 53, 60, 62, 64, 65, 67, 70, 75, 107, 110, 113, 118, 134, 144, 146, 154, 165, 171, 178, 184, 199, 204, 210, 230, 236, 238, 242, 246, 251, 264, 272, 282, 292, 294, 298, 300, 307, 312, 325, 335, 346, 354, 356, 357, 370, 374, 376, 377, 413, 418, 430, 433, 443, 446, 463, 465, 466, 467, 483, 485, 486, 503, 511, 530, 536, 543, 549, 563, 577, 580, 592, 607, 609, 618, 625, 631, 634, 638, 639, 653, 654, 668, 676, 679, 693, 694, 697, 711, 731, 733, 735, 738, 740, 742, 743, 751, 759, 760, 770, 773, 779, 784, 800, 802, 811, 830, 831, 850, 853, 863, 866, 872, 876, 878, 883, 886, 889]

[1, 3, 15, 18, 31, 34, 53, 54, 55, 59, 64, 66, 70, 81, 95, 102, 103, 104, 110, 122, 126, 135, 139, 145, 167, 173, 178, 198, 201, 205, 214, 244, 260, 266, 304, 311, 314, 327, 336, 349, 352, 365, 370, 400, 404, 414, 416, 420, 422, 434, 440, 443, 449, 471, 478, 479, 495, 497, 509, 510, 511, 512, 519, 524, 528, 529, 531, 533, 534, 570, 572, 600, 612, 629, 631, 643, 644, 646, 647, 651, 668, 676, 688, 707, 726, 735, 736, 745, 752, 796, 817, 822, 839, 840, 859, 866, 870]
[30, 35, 40, 41, 49, 53, 60, 62, 64, 65, 67, 70, 75, 107, 110, 113, 118, 134, 144, 146, 154, 165, 171, 178, 184, 199, 204, 210, 230, 236, 238, 242, 246, 251, 264, 272, 282, 292, 294, 298, 300, 307, 312, 325, 335, 346, 354, 356, 357, 370, 374, 376, 377, 413, 418, 430, 433, 443, 446, 463, 465, 466, 467, 483, 485, 486, 503, 511, 530, 536, 543, 549, 563, 577, 580, 592, 607, 609, 618, 625, 631, 634, 638, 639, 653, 654, 668, 676, 679, 693, 694, 697, 711, 731, 733, 735, 738, 740, 742, 743, 751, 759, 760, 770, 773, 779, 784, 800, 802, 811, 830, 831, 850, 853, 863, 866, 872, 876, 878, 883, 886, 889]

[1, 3, 8, 11, 14, 15, 18, 20, 31, 34, 53, 54, 55, 57, 59, 64, 66, 67, 70, 75, 81, 83, 95, 102, 103, 104, 107, 110, 118, 121, 122, 126, 127, 135, 139, 140, 141, 145, 158, 161, 167, 173, 178, 184, 198, 201, 202, 204, 205, 211, 214, 219, 242, 244, 257, 260, 264, 265, 266, 274, 283, 286, 291, 302, 304, 311, 314, 327, 336, 345, 349, 352, 365, 366, 370, 371, 372, 392, 398, 400, 404, 414, 416, 420, 421, 422, 431, 434, 439, 440, 443, 445, 449, 458, 467, 471, 478, 479, 487, 494, 495, 497, 509, 510, 511, 512, 514, 516, 519, 520, 521, 524, 528, 529, 531, 533, 534, 544, 546, 550, 560, 561, 563, 570, 572, 573, 583, 586, 600, 604, 612, 619, 620, 622, 629, 631, 643, 644, 646, 647, 651, 668, 669, 672, 676, 688, 692, 695, 702, 705, 707, 726, 727, 729, 735, 736, 745, 752, 772, 784, 789, 796, 817, 822, 823, 828, 836, 839, 840, 859, 866, 870]
[30, 35, 40, 41, 49, 53, 60, 62, 64, 65, 67, 70, 75, 107, 110, 113, 118, 134, 144, 146, 154, 165, 171, 178, 184, 199, 204, 210, 230, 236, 238, 242, 246, 251, 264, 272, 282, 292, 294, 298, 300, 307, 312, 325, 335, 346, 354, 356, 357, 370, 374, 376, 377, 413, 418, 430, 433, 443, 446, 463, 465, 466, 467, 483, 485, 486, 503, 511, 530, 536, 543, 549, 563, 577, 580, 592, 607, 609, 618, 625, 631, 634, 638, 639, 653, 654, 668, 676, 679, 693, 694, 697, 711, 731, 733, 735, 738, 740, 742, 743, 751, 759, 760, 770, 773, 779, 784, 800, 802, 811, 830, 831, 850, 853, 863, 866, 872, 876, 878, 883, 886, 889]

[1, 3, 5, 8, 9, 11, 14, 15, 18, 20, 21, 31, 34, 53, 54, 55, 57, 59, 64, 66, 67, 70, 75, 81, 82, 83, 90, 91, 95, 97, 102, 103, 104, 107, 110, 118, 121, 122, 126, 127, 131, 135, 139, 140, 141, 145, 147, 148, 150, 154, 158, 160, 161, 167, 173, 174, 178, 184, 198, 201, 202, 204, 205, 210, 211, 214, 219, 221, 223, 242, 244, 248, 251, 257, 260, 264, 265, 266, 270, 274, 276, 283, 285, 286, 291, 302, 304, 306, 307, 308, 311, 314, 324, 326, 327, 336, 342, 345, 349, 352, 357, 362, 363, 365, 366, 370, 371, 372, 385, 386, 389, 391, 392, 398, 400, 404, 414, 416, 420, 421, 422, 431, 434, 439, 440, 442, 443, 445, 446, 449, 450, 458, 466, 467, 471, 478, 479, 482, 487, 493, 494, 495, 497, 500, 509, 510, 511, 512, 514, 515, 516, 519, 520, 521, 524, 528, 529, 531, 533, 534, 544, 546, 550, 560, 561, 563, 565, 567, 570, 572, 573, 583, 585, 586, 600, 604, 608, 612, 615, 619, 620, 622, 629, 631, 637, 643, 644, 646, 647, 651, 668, 669, 672, 676, 677, 678, 680, 683, 688, 692, 695, 702, 705, 706, 707, 711, 720, 722, 723, 726, 727, 728, 729, 732, 735, 736, 741, 745, 751, 752, 758, 762, 763, 772, 773, 778, 779, 781, 784, 789, 793, 796, 817, 822, 823, 825, 828, 834, 836, 839, 840, 841, 859, 866, 869, 870, 879]
[30, 35, 40, 41, 49, 53, 60, 62, 64, 65, 67, 70, 75, 107, 110, 113, 118, 134, 144, 146, 154, 165, 171, 178, 184, 199, 204, 210, 230, 236, 238, 242, 246, 251, 264, 272, 282, 292, 294, 298, 300, 307, 312, 325, 335, 346, 354, 356, 357, 370, 374, 376, 377, 413, 418, 430, 433, 443, 446, 463, 465, 466, 467, 483, 485, 486, 503, 511, 530, 536, 543, 549, 563, 577, 580, 592, 607, 609, 618, 625, 631, 634, 638, 639, 653, 654, 668, 676, 679, 693, 694, 697, 711, 731, 733, 735, 738, 740, 742, 743, 751, 759, 760, 770, 773, 779, 784, 800, 802, 811, 830, 831, 850, 853, 863, 866, 872, 876, 878, 883, 886, 889]

[1, 3, 5, 8, 9, 11, 14, 15, 18, 20, 21, 31, 34, 46, 48, 49, 52, 53, 54, 55, 57, 59, 63, 64, 66, 67, 70, 75, 81, 82, 83, 90, 91, 94, 95, 96, 97, 98, 102, 103, 104, 107, 110, 114, 118, 120, 121, 122, 126, 127, 131, 135, 139, 140, 141, 143, 144, 145, 146, 147, 148, 150, 154, 155, 156, 158, 160, 161, 164, 165, 167, 168, 173, 174, 177, 178, 184, 185, 186, 198, 201, 202, 204, 205, 210, 211, 214, 215, 219, 221, 223, 228, 239, 242, 244, 248, 251, 253, 256, 257, 260, 264, 265, 266, 270, 271, 274, 276, 282, 283, 285, 286, 290, 291, 302, 303, 304, 306, 307, 308, 311, 314, 316, 324, 326, 327, 333, 336, 342, 345, 348, 349, 350, 351, 352, 355, 357, 362, 363, 365, 366, 370, 371, 372, 377, 385, 386, 389, 391, 392, 398, 400, 404, 405, 407, 411, 414, 416, 420, 421, 422, 431, 434, 437, 439, 440, 442, 443, 444, 445, 446, 449, 450, 458, 466, 467, 471, 476, 478, 479, 482, 486, 487, 493, 494, 495, 497, 500, 502, 509, 510, 511, 512, 514, 515, 516, 518, 519, 520, 521, 524, 528, 529, 531, 533, 534, 539, 544, 546, 550, 560, 561, 563, 565, 567, 569, 570, 572, 573, 581, 583, 585, 586, 596, 598, 600, 601, 602, 604, 608, 609, 612, 615, 618, 619, 620, 622, 626, 629, 631, 637, 643, 644, 645, 646, 647, 651, 662, 663, 665, 667, 668, 669, 672, 676, 677, 678, 680, 683, 688, 692, 695, 702, 705, 706, 707, 711, 718, 720, 721, 722, 723, 724, 726, 727, 728, 729, 732, 733, 735, 736, 741, 745, 748, 750, 751, 752, 758, 762, 763, 770, 772, 773, 778, 779, 781, 784, 789, 793, 796, 798, 806, 812, 817, 820, 822, 823, 825, 828, 830, 834, 836, 839, 840, 841, 842, 857, 859, 866, 869, 870, 879]
[30, 35, 40, 41, 49, 53, 60, 62, 64, 65, 67, 70, 75, 107, 110, 113, 118, 134, 144, 146, 154, 165, 171, 178, 184, 199, 204, 210, 230, 236, 238, 242, 246, 251, 264, 272, 282, 292, 294, 298, 300, 307, 312, 325, 335, 346, 354, 356, 357, 370, 374, 376, 377, 413, 418, 430, 433, 443, 446, 463, 465, 466, 467, 483, 485, 486, 503, 511, 530, 536, 543, 549, 563, 577, 580, 592, 607, 609, 618, 625, 631, 634, 638, 639, 653, 654, 668, 676, 679, 693, 694, 697, 711, 731, 733, 735, 738, 740, 742, 743, 751, 759, 760, 770, 773, 779, 784, 800, 802, 811, 830, 831, 850, 853, 863, 866, 872, 876, 878, 883, 886, 889]

[1, 3, 4, 5, 8, 9, 11, 12, 14, 15, 18, 20, 21, 23, 28, 31, 34, 45, 46, 48, 49, 52, 53, 54, 55, 57, 59, 63, 64, 65, 66, 67, 70, 74, 75, 80, 81, 82, 83, 84, 88, 90, 91, 94, 95, 96, 97, 98, 102, 103, 104, 105, 107, 110, 114, 118, 120, 121, 122, 125, 126, 127, 131, 135, 139, 140, 141, 143, 144, 145, 146, 147, 148, 150, 154, 155, 156, 158, 160, 161, 164, 165, 167, 168, 172, 173, 174, 177, 178, 179, 183, 184, 185, 186, 192, 193, 198, 201, 202, 204, 205, 210, 211, 214, 215, 219, 221, 223, 228, 229, 235, 239, 242, 244, 248, 251, 253, 254, 256, 257, 260, 264, 265, 266, 270, 271, 274, 276, 277, 281, 282, 283, 285, 286, 290, 291, 302, 303, 304, 306, 307, 308, 311, 314, 316, 318, 321, 323, 324, 326, 327, 332, 333, 335, 336, 337, 342, 345, 348, 349, 350, 351, 352, 353, 355, 357, 362, 363, 365, 366, 370, 371, 372, 377, 380, 385, 386, 389, 391, 392, 395, 398, 400, 404, 405, 406, 407, 409, 411, 412, 414, 416, 419, 420, 421, 422, 431, 434, 437, 439, 440, 441, 442, 443, 444, 445, 446, 449, 450, 454, 458, 465, 466, 467, 471, 476, 477, 478, 479, 482, 486, 487, 493, 494, 495, 497, 500, 502, 509, 510, 511, 512, 514, 515, 516, 518, 519, 520, 521, 524, 528, 529, 531, 533, 534, 536, 538, 539, 540, 544, 546, 548, 549, 550, 560, 561, 562, 563, 564, 565, 567, 569, 570, 572, 573, 577, 578, 581, 583, 585, 586, 595, 596, 598, 600, 601, 602, 603, 604, 605, 608, 609, 610, 612, 615, 618, 619, 620, 622, 623, 626, 629, 631, 637, 642, 643, 644, 645, 646, 647, 651, 656, 661, 662, 663, 665, 667, 668, 669, 670, 672, 674, 676, 677, 678, 679, 680, 683, 685, 688, 692, 695, 702, 705, 706, 707, 711, 716, 718, 719, 720, 721, 722, 723, 724, 726, 727, 728, 729, 732, 733, 735, 736, 741, 745, 748, 750, 751, 752, 758, 762, 763, 765, 767, 769, 770, 772, 773, 778, 779, 781, 783, 784, 789, 792, 793, 796, 798, 806, 812, 817, 820, 822, 823, 824, 825, 827, 828, 830, 834, 836, 839, 840, 841, 842, 847, 849, 852, 857, 859, 862, 866, 867, 869, 870, 878, 879]
[30, 35, 40, 41, 49, 53, 60, 62, 64, 65, 67, 70, 75, 107, 110, 113, 118, 134, 144, 146, 154, 165, 171, 178, 184, 199, 204, 210, 230, 236, 238, 242, 246, 251, 264, 272, 282, 292, 294, 298, 300, 307, 312, 325, 335, 346, 354, 356, 357, 370, 374, 376, 377, 413, 418, 430, 433, 443, 446, 463, 465, 466, 467, 483, 485, 486, 503, 511, 530, 536, 543, 549, 563, 577, 580, 592, 607, 609, 618, 625, 631, 634, 638, 639, 653, 654, 668, 676, 679, 693, 694, 697, 711, 731, 733, 735, 738, 740, 742, 743, 751, 759, 760, 770, 773, 779, 784, 800, 802, 811, 830, 831, 850, 853, 863, 866, 872, 876, 878, 883, 886, 889]

[1, 3, 4, 5, 8, 9, 11, 12, 14, 15, 18, 20, 21, 23, 25, 28, 31, 34, 45, 46, 48, 49, 52, 53, 54, 55, 57, 59, 61, 63, 64, 65, 66, 67, 68, 70, 73, 74, 75, 80, 81, 82, 83, 84, 85, 87, 88, 90, 91, 93, 94, 95, 96, 97, 98, 100, 102, 103, 104, 105, 107, 110, 111, 112, 114, 118, 120, 121, 122, 124, 125, 126, 127, 131, 133, 135, 139, 140, 141, 142, 143, 144, 145, 146, 147, 148, 150, 153, 154, 155, 156, 158, 160, 161, 164, 165, 167, 168, 171, 172, 173, 174, 175, 176, 177, 178, 179, 183, 184, 185, 186, 187, 192, 193, 198, 201, 202, 204, 205, 207, 210, 211, 213, 214, 215, 216, 219, 220, 221, 223, 227, 228, 229, 235, 236, 237, 239, 242, 244, 248, 251, 253, 254, 256, 257, 259, 260, 264, 265, 266, 270, 271, 274, 276, 277, 279, 281, 282, 283, 285, 286, 290, 291, 293, 300, 301, 302, 303, 304, 306, 307, 308, 311, 314, 316, 318, 321, 323, 324, 326, 327, 332, 333, 335, 336, 337, 341, 342, 345, 348, 349, 350, 351, 352, 353, 355, 357, 359, 362, 363, 365, 366, 368, 369, 370, 371, 372, 377, 380, 385, 386, 389, 391, 392, 395, 398, 400, 404, 405, 406, 407, 409, 411, 412, 414, 416, 417, 419, 420, 421, 422, 427, 430, 431, 432, 433, 434, 435, 437, 439, 440, 441, 442, 443, 444, 445, 446, 449, 450, 454, 458, 460, 465, 466, 467, 471, 476, 477, 478, 479, 482, 486, 487, 493, 494, 495, 497, 500, 502, 505, 509, 510, 511, 512, 514, 515, 516, 518, 519, 520, 521, 523, 524, 528, 529, 531, 533, 534, 536, 538, 539, 540, 541, 544, 546, 548, 549, 550, 560, 561, 562, 563, 564, 565, 566, 567, 569, 570, 572, 573, 574, 575, 577, 578, 580, 581, 583, 584, 585, 586, 590, 592, 595, 596, 597, 598, 600, 601, 602, 603, 604, 605, 608, 609, 610, 612, 615, 618, 619, 620, 622, 623, 626, 628, 629, 631, 636, 637, 642, 643, 644, 645, 646, 647, 651, 656, 661, 662, 663, 665, 666, 667, 668, 669, 670, 672, 674, 676, 677, 678, 679, 680, 683, 685, 686, 688, 692, 695, 702, 705, 706, 707, 711, 716, 717, 718, 719, 720, 721, 722, 723, 724, 726, 727, 728, 729, 732, 733, 735, 736, 740, 741, 743, 745, 746, 748, 749, 750, 751, 752, 756, 758, 762, 763, 765, 767, 769, 770, 772, 773, 776, 777, 778, 779, 781, 783, 784, 788, 789, 792, 793, 796, 797, 798, 800, 806, 812, 817, 819, 820, 822, 823, 824, 825, 827, 828, 830, 834, 836, 839, 840, 841, 842, 846, 847, 849, 850, 851, 852, 857, 859, 862, 865, 866, 867, 869, 870, 874, 878, 879, 881, 886]
[30, 35, 40, 41, 49, 53, 60, 62, 64, 65, 67, 70, 75, 107, 110, 113, 118, 134, 144, 146, 154, 165, 171, 178, 184, 199, 204, 210, 230, 236, 238, 242, 246, 251, 264, 272, 282, 292, 294, 298, 300, 307, 312, 325, 335, 346, 354, 356, 357, 370, 374, 376, 377, 413, 418, 430, 433, 443, 446, 463, 465, 466, 467, 483, 485, 486, 503, 511, 530, 536, 543, 549, 563, 577, 580, 592, 607, 609, 618, 625, 631, 634, 638, 639, 653, 654, 668, 676, 679, 693, 694, 697, 711, 731, 733, 735, 738, 740, 742, 743, 751, 759, 760, 770, 773, 779, 784, 800, 802, 811, 830, 831, 850, 853, 863, 866, 872, 876, 878, 883, 886, 889]

[1, 3, 4, 5, 8, 9, 11, 12, 14, 15, 18, 20, 21, 23, 24, 25, 28, 30, 31, 33, 34, 37, 40, 45, 46, 48, 49, 52, 53, 54, 55, 57, 59, 60, 61, 62, 63, 64, 65, 66, 67, 68, 70, 73, 74, 75, 76, 80, 81, 82, 83, 84, 85, 87, 88, 90, 91, 93, 94, 95, 96, 97, 98, 100, 102, 103, 104, 105, 107, 108, 110, 111, 112, 114, 116, 118, 119, 120, 121, 122, 124, 125, 126, 127, 131, 133, 135, 139, 140, 141, 142, 143, 144, 145, 146, 147, 148, 149, 150, 151, 153, 154, 155, 156, 157, 158, 160, 161, 162, 164, 165, 167, 168, 171, 172, 173, 174, 175, 176, 177, 178, 179, 183, 184, 185, 186, 187, 189, 192, 193, 198, 201, 202, 204, 205, 207, 210, 211, 213, 214, 215, 216, 219, 220, 221, 223, 224, 227, 228, 229, 230, 231, 232, 233, 235, 236, 237, 239, 242, 244, 248, 251, 253, 254, 256, 257, 259, 260, 264, 265, 266, 268, 270, 271, 274, 276, 277, 279, 281, 282, 283, 285, 286, 289, 290, 291, 292, 293, 296, 300, 301, 302, 303, 304, 306, 307, 308, 311, 313, 314, 316, 317, 318, 321, 323, 324, 325, 326, 327, 332, 333, 335, 336, 337, 339, 341, 342, 345, 348, 349, 350, 351, 352, 353, 355, 357, 358, 359, 362, 363, 365, 366, 367, 368, 369, 370, 371, 372, 376, 377, 380, 382, 385, 386, 387, 388, 389, 391, 392, 395, 398, 400, 404, 405, 406, 407, 409, 411, 412, 414, 416, 417, 419, 420, 421, 422, 427, 430, 431, 432, 433, 434, 435, 436, 437, 439, 440, 441, 442, 443, 444, 445, 446, 449, 450, 452, 454, 455, 458, 460, 461, 462, 465, 466, 467, 471, 473, 476, 477, 478, 479, 482, 485, 486, 487, 490, 492, 493, 494, 495, 497, 499, 500, 501, 502, 505, 509, 510, 511, 512, 514, 515, 516, 518, 519, 520, 521, 523, 524, 525, 528, 529, 530, 531, 533, 534, 536, 538, 539, 540, 541, 544, 546, 548, 549, 550, 560, 561, 562, 563, 564, 565, 566, 567, 568, 569, 570, 572, 573, 574, 575, 577, 578, 580, 581, 583, 584, 585, 586, 590, 592, 594, 595, 596, 597, 598, 600, 601, 602, 603, 604, 605, 608, 609, 610, 612, 613, 615, 617, 618, 619, 620, 622, 623, 626, 628, 629, 631, 636, 637, 642, 643, 644, 645, 646, 647, 649, 651, 656, 657, 661, 662, 663, 665, 666, 667, 668, 669, 670, 671, 672, 673, 674, 676, 677, 678, 679, 680, 681, 683, 684, 685, 686, 688, 690, 691, 692, 695, 697, 698, 699, 700, 702, 705, 706, 707, 711, 716, 717, 718, 719, 720, 721, 722, 723, 724, 726, 727, 728, 729, 732, 733, 735, 736, 740, 741, 743, 745, 746, 748, 749, 750, 751, 752, 756, 757, 758, 762, 763, 765, 767, 769, 770, 772, 773, 776, 777, 778, 779, 781, 783, 784, 785, 788, 789, 792, 793, 795, 796, 797, 798, 800, 806, 808, 812, 813, 814, 817, 819, 820, 821, 822, 823, 824, 825, 826, 827, 828, 830, 831, 834, 835, 836, 838, 839, 840, 841, 842, 846, 847, 848, 849, 850, 851, 852, 857, 859, 862, 864, 865, 866, 867, 868, 869, 870, 874, 878, 879, 880, 881, 885, 886, 887]
[30, 35, 40, 41, 49, 53, 60, 62, 64, 65, 67, 70, 75, 107, 110, 113, 118, 134, 144, 146, 154, 165, 171, 178, 184, 199, 204, 210, 230, 236, 238, 242, 246, 251, 264, 272, 282, 292, 294, 298, 300, 307, 312, 325, 335, 346, 354, 356, 357, 370, 374, 376, 377, 413, 418, 430, 433, 443, 446, 463, 465, 466, 467, 483, 485, 486, 503, 511, 530, 536, 543, 549, 563, 577, 580, 592, 607, 609, 618, 625, 631, 634, 638, 639, 653, 654, 668, 676, 679, 693, 694, 697, 711, 731, 733, 735, 738, 740, 742, 743, 751, 759, 760, 770, 773, 779, 784, 800, 802, 811, 830, 831, 850, 853, 863, 866, 872, 876, 878, 883, 886, 889]

[1, 3, 4, 5, 8, 9, 11, 12, 14, 15, 18, 20, 21, 23, 24, 25, 28, 29, 30, 31, 33, 34, 35, 36, 37, 39, 40, 41, 44, 45, 46, 48, 49, 52, 53, 54, 55, 57, 58, 59, 60, 61, 62, 63, 64, 65, 66, 67, 68, 70, 73, 74, 75, 76, 80, 81, 82, 83, 84, 85, 87, 88, 90, 91, 93, 94, 95, 96, 97, 98, 99, 100, 102, 103, 104, 105, 106, 107, 108, 110, 111, 112, 114, 115, 116, 118, 119, 120, 121, 122, 124, 125, 126, 127, 131, 132, 133, 135, 137, 138, 139, 140, 141, 142, 143, 144, 145, 146, 147, 148, 149, 150, 151, 153, 154, 155, 156, 157, 158, 160, 161, 162, 163, 164, 165, 166, 167, 168, 171, 172, 173, 174, 175, 176, 177, 178, 179, 183, 184, 185, 186, 187, 188, 189, 192, 193, 195, 198, 201, 202, 203, 204, 205, 206, 207, 210, 211, 212, 213, 214, 215, 216, 217, 219, 220, 221, 223, 224, 227, 228, 229, 230, 231, 232, 233, 235, 236, 237, 238, 239, 242, 244, 248, 251, 253, 254, 256, 257, 259, 260, 264, 265, 266, 268, 270, 271, 274, 276, 277, 279, 281, 282, 283, 285, 286, 288, 289, 290, 291, 292, 293, 294, 296, 300, 301, 302, 303, 304, 305, 306, 307, 308, 311, 313, 314, 316, 317, 318, 320, 321, 323, 324, 325, 326, 327, 328, 331, 332, 333, 335, 336, 337, 338, 339, 341, 342, 345, 346, 347, 348, 349, 350, 351, 352, 353, 355, 357, 358, 359, 362, 363, 365, 366, 367, 368, 369, 370, 371, 372, 376, 377, 379, 380, 382, 385, 386, 387, 388, 389, 391, 392, 395, 396, 398, 400, 401, 403, 404, 405, 406, 407, 409, 411, 412, 413, 414, 416, 417, 418, 419, 420, 421, 422, 423, 427, 430, 431, 432, 433, 434, 435, 436, 437, 438, 439, 440, 441, 442, 443, 444, 445, 446, 449, 450, 452, 454, 455, 458, 459, 460, 461, 462, 464, 465, 466, 467, 471, 473, 474, 476, 477, 478, 479, 482, 483, 485, 486, 487, 490, 491, 492, 493, 494, 495, 497, 499, 500, 501, 502, 505, 507, 509, 510, 511, 512, 514, 515, 516, 517, 518, 519, 520, 521, 523, 524, 525, 528, 529, 530, 531, 532, 533, 534, 536, 537, 538, 539, 540, 541, 544, 546, 548, 549, 550, 556, 560, 561, 562, 563, 564, 565, 566, 567, 568, 569, 570, 572, 573, 574, 575, 577, 578, 579, 580, 581, 583, 584, 585, 586, 587, 590, 591, 592, 594, 595, 596, 597, 598, 599, 600, 601, 602, 603, 604, 605, 608, 609, 610, 612, 613, 615, 616, 617, 618, 619, 620, 622, 623, 624, 625, 626, 628, 629, 631, 633, 634, 635, 636, 637, 641, 642, 643, 644, 645, 646, 647, 649, 651, 656, 657, 658, 661, 662, 663, 665, 666, 667, 668, 669, 670, 671, 672, 673, 674, 675, 676, 677, 678, 679, 680, 681, 683, 684, 685, 686, 688, 690, 691, 692, 694, 695, 697, 698, 699, 700, 702, 704, 705, 706, 707, 711, 716, 717, 718, 719, 720, 721, 722, 723, 724, 726, 727, 728, 729, 732, 733, 734, 735, 736, 739, 740, 741, 743, 745, 746, 748, 749, 750, 751, 752, 755, 756, 757, 758, 762, 763, 765, 767, 769, 770, 772, 773, 776, 777, 778, 779, 781, 783, 784, 785, 787, 788, 789, 790, 792, 793, 795, 796, 797, 798, 800, 806, 808, 812, 813, 814, 816, 817, 819, 820, 821, 822, 823, 824, 825, 826, 827, 828, 829, 830, 831, 834, 835, 836, 838, 839, 840, 841, 842, 845, 846, 847, 848, 849, 850, 851, 852, 853, 855, 857, 859, 862, 863, 864, 865, 866, 867, 868, 869, 870, 872, 874, 876, 877, 878, 879, 880, 881, 885, 886, 887, 889]
[30, 35, 40, 41, 49, 53, 60, 62, 64, 65, 67, 70, 75, 107, 110, 113, 118, 134, 144, 146, 154, 165, 171, 178, 184, 199, 204, 210, 230, 236, 238, 242, 246, 251, 264, 272, 282, 292, 294, 298, 300, 307, 312, 325, 335, 346, 354, 356, 357, 370, 374, 376, 377, 413, 418, 430, 433, 443, 446, 463, 465, 466, 467, 483, 485, 486, 503, 511, 530, 536, 543, 549, 563, 577, 580, 592, 607, 609, 618, 625, 631, 634, 638, 639, 653, 654, 668, 676, 679, 693, 694, 697, 711, 731, 733, 735, 738, 740, 742, 743, 751, 759, 760, 770, 773, 779, 784, 800, 802, 811, 830, 831, 850, 853, 863, 866, 872, 876, 878, 883, 886, 889]

[1, 2, 3, 4, 5, 8, 9, 11, 12, 14, 15, 16, 17, 18, 19, 20, 21, 23, 24, 25, 28, 29, 30, 31, 33, 34, 35, 36, 37, 38, 39, 40, 41, 42, 43, 44, 45, 46, 48, 49, 52, 53, 54, 55, 57, 58, 59, 60, 61, 62, 63, 64, 65, 66, 67, 68, 70, 73, 74, 75, 76, 80, 81, 82, 83, 84, 85, 86, 87, 88, 90, 91, 93, 94, 95, 96, 97, 98, 99, 100, 102, 103, 104, 105, 106, 107, 108, 110, 111, 112, 113, 114, 115, 116, 118, 119, 120, 121, 122, 123, 124, 125, 126, 127, 128, 130, 131, 132, 133, 135, 137, 138, 139, 140, 141, 142, 143, 144, 145, 146, 147, 148, 149, 150, 151, 153, 154, 155, 156, 157, 158, 159, 160, 161, 162, 163, 164, 165, 166, 167, 168, 171, 172, 173, 174, 175, 176, 177, 178, 179, 182, 183, 184, 185, 186, 187, 188, 189, 190, 192, 193, 195, 198, 201, 202, 203, 204, 205, 206, 207, 209, 210, 211, 212, 213, 214, 215, 216, 217, 219, 220, 221, 223, 224, 225, 227, 228, 229, 230, 231, 232, 233, 234, 235, 236, 237, 238, 239, 242, 243, 244, 248, 251, 253, 254, 256, 257, 258, 259, 260, 264, 265, 266, 267, 268, 269, 270, 271, 273, 274, 276, 277, 278, 279, 281, 282, 283, 284, 285, 286, 287, 288, 289, 290, 291, 292, 293, 294, 296, 297, 299, 300, 301, 302, 303, 304, 305, 306, 307, 308, 311, 313, 314, 316, 317, 318, 320, 321, 322, 323, 324, 325, 326, 327, 328, 331, 332, 333, 335, 336, 337, 338, 339, 340, 341, 342, 344, 345, 346, 347, 348, 349, 350, 351, 352, 353, 354, 355, 357, 358, 359, 361, 362, 363, 364, 365, 366, 367, 368, 369, 370, 371, 372, 375, 376, 377, 378, 379, 380, 381, 382, 384, 385, 386, 387, 388, 389, 391, 392, 395, 396, 398, 400, 401, 403, 404, 405, 406, 407, 409, 411, 412, 413, 414, 415, 416, 417, 418, 419, 420, 421, 422, 423, 424, 427, 430, 431, 432, 433, 434, 435, 436, 437, 438, 439, 440, 441, 442, 443, 444, 445, 446, 449, 450, 451, 452, 454, 455, 458, 459, 460, 461, 462, 464, 465, 466, 467, 469, 470, 471, 473, 474, 476, 477, 478, 479, 482, 483, 485, 486, 487, 489, 490, 491, 492, 493, 494, 495, 497, 498, 499, 500, 501, 502, 504, 505, 507, 508, 509, 510, 511, 512, 514, 515, 516, 517, 518, 519, 520, 521, 523, 524, 525, 527, 528, 529, 530, 531, 532, 533, 534, 535, 536, 537, 538, 539, 540, 541, 542, 544, 546, 547, 548, 549, 550, 551, 555, 556, 557, 560, 561, 562, 563, 564, 565, 566, 567, 568, 569, 570, 572, 573, 574, 575, 577, 578, 579, 580, 581, 583, 584, 585, 586, 587, 588, 590, 591, 592, 594, 595, 596, 597, 598, 599, 600, 601, 602, 603, 604, 605, 606, 608, 609, 610, 612, 613, 615, 616, 617, 618, 619, 620, 621, 622, 623, 624, 625, 626, 628, 629, 631, 632, 633, 634, 635, 636, 637, 641, 642, 643, 644, 645, 646, 647, 649, 651, 655, 656, 657, 658, 661, 662, 663, 665, 666, 667, 668, 669, 670, 671, 672, 673, 674, 675, 676, 677, 678, 679, 680, 681, 683, 684, 685, 686, 688, 690, 691, 692, 694, 695, 697, 698, 699, 700, 701, 702, 703, 704, 705, 706, 707, 711, 713, 715, 716, 717, 718, 719, 720, 721, 722, 723, 724, 725, 726, 727, 728, 729, 732, 733, 734, 735, 736, 739, 740, 741, 743, 745, 746, 748, 749, 750, 751, 752, 754, 755, 756, 757, 758, 761, 762, 763, 765, 767, 768, 769, 770, 771, 772, 773, 776, 777, 778, 779, 780, 781, 782, 783, 784, 785, 786, 787, 788, 789, 790, 792, 793, 795, 796, 797, 798, 799, 800, 802, 806, 808, 809, 812, 813, 814, 816, 817, 819, 820, 821, 822, 823, 824, 825, 826, 827, 828, 829, 830, 831, 834, 835, 836, 837, 838, 839, 840, 841, 842, 845, 846, 847, 848, 849, 850, 851, 852, 853, 854, 855, 857, 859, 862, 863, 864, 865, 866, 867, 868, 869, 870, 872, 874, 876, 877, 878, 879, 880, 881, 883, 884, 885, 886, 887, 889]
[30, 35, 40, 41, 49, 53, 60, 62, 64, 65, 67, 70, 75, 107, 110, 113, 118, 134, 144, 146, 154, 165, 171, 178, 184, 199, 204, 210, 230, 236, 238, 242, 246, 251, 264, 272, 282, 292, 294, 298, 300, 307, 312, 325, 335, 346, 354, 356, 357, 370, 374, 376, 377, 413, 418, 430, 433, 443, 446, 463, 465, 466, 467, 483, 485, 486, 503, 511, 530, 536, 543, 549, 563, 577, 580, 592, 607, 609, 618, 625, 631, 634, 638, 639, 653, 654, 668, 676, 679, 693, 694, 697, 711, 731, 733, 735, 738, 740, 742, 743, 751, 759, 760, 770, 773, 779, 784, 800, 802, 811, 830, 831, 850, 853, 863, 866, 872, 876, 878, 883, 886, 889]

[0, 1, 2, 3, 4, 5, 8, 9, 11, 12, 14, 15, 16, 17, 18, 19, 20, 21, 23, 24, 25, 26, 28, 29, 30, 31, 32, 33, 34, 35, 36, 37, 38, 39, 40, 41, 42, 43, 44, 45, 46, 48, 49, 50, 52, 53, 54, 55, 56, 57, 58, 59, 60, 61, 62, 63, 64, 65, 66, 67, 68, 70, 71, 72, 73, 74, 75, 76, 78, 79, 80, 81, 82, 83, 84, 85, 86, 87, 88, 90, 91, 93, 94, 95, 96, 97, 98, 99, 100, 102, 103, 104, 105, 106, 107, 108, 110, 111, 112, 113, 114, 115, 116, 117, 118, 119, 120, 121, 122, 123, 124, 125, 126, 127, 128, 130, 131, 132, 133, 135, 137, 138, 139, 140, 141, 142, 143, 144, 145, 146, 147, 148, 149, 150, 151, 152, 153, 154, 155, 156, 157, 158, 159, 160, 161, 162, 163, 164, 165, 166, 167, 168, 169, 171, 172, 173, 174, 175, 176, 177, 178, 179, 182, 183, 184, 185, 186, 187, 188, 189, 190, 191, 192, 193, 194, 195, 197, 198, 201, 202, 203, 204, 205, 206, 207, 208, 209, 210, 211, 212, 213, 214, 215, 216, 217, 219, 220, 221, 222, 223, 224, 225, 226, 227, 228, 229, 230, 231, 232, 233, 234, 235, 236, 237, 238, 239, 240, 241, 242, 243, 244, 248, 250, 251, 253, 254, 256, 257, 258, 259, 260, 263, 264, 265, 266, 267, 268, 269, 270, 271, 273, 274, 276, 277, 278, 279, 281, 282, 283, 284, 285, 286, 287, 288, 289, 290, 291, 292, 293, 294, 296, 297, 298, 299, 300, 301, 302, 303, 304, 305, 306, 307, 308, 309, 311, 313, 314, 316, 317, 318, 320, 321, 322, 323, 324, 325, 326, 327, 328, 329, 330, 331, 332, 333, 334, 335, 336, 337, 338, 339, 340, 341, 342, 343, 344, 345, 346, 347, 348, 349, 350, 351, 352, 353, 354, 355, 357, 358, 359, 360, 361, 362, 363, 364, 365, 366, 367, 368, 369, 370, 371, 372, 374, 375, 376, 377, 378, 379, 380, 381, 382, 383, 384, 385, 386, 387, 388, 389, 390, 391, 392, 394, 395, 396, 397, 398, 400, 401, 402, 403, 404, 405, 406, 407, 408, 409, 411, 412, 413, 414, 415, 416, 417, 418, 419, 420, 421, 422, 423, 424, 426, 427, 429, 430, 431, 432, 433, 434, 435, 436, 437, 438, 439, 440, 441, 442, 443, 444, 445, 446, 449, 450, 451, 452, 454, 455, 456, 457, 458, 459, 460, 461, 462, 464, 465, 466, 467, 469, 470, 471, 473, 474, 476, 477, 478, 479, 481, 482, 483, 484, 485, 486, 487, 488, 489, 490, 491, 492, 493, 494, 495, 497, 498, 499, 500, 501, 502, 504, 505, 506, 507, 508, 509, 510, 511, 512, 514, 515, 516, 517, 518, 519, 520, 521, 522, 523, 524, 525, 527, 528, 529, 530, 531, 532, 533, 534, 535, 536, 537, 538, 539, 540, 541, 542, 544, 546, 547, 548, 549, 550, 551, 552, 554, 555, 556, 557, 558, 559, 560, 561, 562, 563, 564, 565, 566, 567, 568, 569, 570, 572, 573, 574, 575, 576, 577, 578, 579, 580, 581, 583, 584, 585, 586, 587, 588, 590, 591, 592, 593, 594, 595, 596, 597, 598, 599, 600, 601, 602, 603, 604, 605, 606, 607, 608, 609, 610, 612, 613, 615, 616, 617, 618, 619, 620, 621, 622, 623, 624, 625, 626, 627, 628, 629, 631, 632, 633, 634, 635, 636, 637, 639, 641, 642, 643, 644, 645, 646, 647, 649, 651, 653, 654, 655, 656, 657, 658, 660, 661, 662, 663, 665, 666, 667, 668, 669, 670, 671, 672, 673, 674, 675, 676, 677, 678, 679, 680, 681, 683, 684, 685, 686, 687, 688, 690, 691, 692, 694, 695, 697, 698, 699, 700, 701, 702, 703, 704, 705, 706, 707, 708, 711, 712, 713, 715, 716, 717, 718, 719, 720, 721, 722, 723, 724, 725, 726, 727, 728, 729, 732, 733, 734, 735, 736, 737, 739, 740, 741, 743, 744, 745, 746, 748, 749, 750, 751, 752, 753, 754, 755, 756, 757, 758, 760, 761, 762, 763, 764, 765, 766, 767, 768, 769, 770, 771, 772, 773, 775, 776, 777, 778, 779, 780, 781, 782, 783, 784, 785, 786, 787, 788, 789, 790, 792, 793, 795, 796, 797, 798, 799, 800, 802, 804, 806, 808, 809, 810, 811, 812, 813, 814, 816, 817, 818, 819, 820, 821, 822, 823, 824, 825, 826, 827, 828, 829, 830, 831, 832, 833, 834, 835, 836, 837, 838, 839, 840, 841, 842, 845, 846, 847, 848, 849, 850, 851, 852, 853, 854, 855, 857, 859, 862, 863, 864, 865, 866, 867, 868, 869, 870, 872, 873, 874, 875, 876, 877, 878, 879, 880, 881, 883, 884, 885, 886, 887, 889]
[30, 35, 40, 41, 49, 53, 60, 62, 64, 65, 67, 70, 75, 107, 110, 113, 118, 134, 144, 146, 154, 165, 171, 178, 184, 199, 204, 210, 230, 236, 238, 242, 246, 251, 264, 272, 282, 292, 294, 298, 300, 307, 312, 325, 335, 346, 354, 356, 357, 370, 374, 376, 377, 413, 418, 430, 433, 443, 446, 463, 465, 466, 467, 483, 485, 486, 503, 511, 530, 536, 543, 549, 563, 577, 580, 592, 607, 609, 618, 625, 631, 634, 638, 639, 653, 654, 668, 676, 679, 693, 694, 697, 711, 731, 733, 735, 738, 740, 742, 743, 751, 759, 760, 770, 773, 779, 784, 800, 802, 811, 830, 831, 850, 853, 863, 866, 872, 876, 878, 883, 886, 889]

