[123, 184, 244, 264, 342, 346, 420, 429, 455, 469, 471, 518, 655, 669, 676, 691, 700, 722, 733, 841, 869, 878]
[25, 32, 80, 120, 157, 174, 235, 243, 255, 276, 305, 501, 505, 561, 570, 616, 710, 724, 774, 799, 848, 879]

[123, 184, 244, 264, 342, 346, 420, 429, 455, 469, 471, 518, 655, 669, 676, 691, 700, 722, 733, 841, 869, 878]
[0, 7, 14, 22, 25, 32, 34, 40, 41, 47, 49, 64, 80, 85, 89, 94, 104, 112, 113, 120, 121, 126, 134, 157, 169, 174, 178, 181, 182, 192, 195, 207, 219, 235, 239, 243, 249, 250, 255, 259, 262, 267, 276, 281, 305, 314, 325, 329, 341, 345, 357, 358, 359, 366, 375, 389, 392, 394, 398, 399, 422, 431, 452, 453, 463, 475, 480, 481, 486, 501, 505, 506, 512, 513, 523, 530, 531, 532, 536, 544, 556, 561, 566, 570, 576, 584, 597, 616, 618, 621, 628, 634, 643, 657, 673, 678, 681, 684, 685, 690, 707, 710, 712, 724, 729, 736, 766, 774, 793, 799, 806, 809, 822, 828, 830, 835, 837, 845, 848, 866, 879, 886]

[19, 22, 24, 28, 40, 56, 62, 88, 94, 100, 114, 116, 123, 148, 151, 164, 171, 184, 192, 203, 230, 242, 244, 245, 264, 270, 273, 309, 312, 314, 326, 342, 346, 353, 356, 383, 389, 401, 405, 420, 429, 438, 447, 455, 457, 459, 463, 469, 471, 495, 501, 502, 509, 518, 528, 536, 539, 542, 543, 544, 560, 582, 643, 651, 655, 669, 674, 676, 688, 691, 698, 700, 703, 704, 709, 722, 729, 733, 745, 755, 768, 770, 779, 797, 800, 801, 813, 816, 827, 834, 840, 841, 859, 868, 869, 871, 878]
[0, 7, 14, 22, 25, 32, 34, 40, 41, 47, 49, 64, 80, 85, 89, 94, 104, 112, 113, 120, 121, 126, 134, 157, 169, 174, 178, 181, 182, 192, 195, 207, 219, 235, 239, 243, 249, 250, 255, 259, 262, 267, 276, 281, 305, 314, 325, 329, 341, 345, 357, 358, 359, 366, 375, 389, 392, 394, 398, 399, 422, 431, 452, 453, 463, 475, 480, 481, 486, 501, 505, 506, 512, 513, 523, 530, 531, 532, 536, 544, 556, 561, 566, 570, 576, 584, 597, 616, 618, 621, 628, 634, 643, 657, 673, 678, 681, 684, 685, 690, 707, 710, 712, 724, 729, 736, 766, 774, 793, 799, 806, 809, 822, 828, 830, 835, 837, 845, 848, 866, 879, 886]

[3, 5, 19, 22, 24, 28, 40, 45, 54, 56, 61, 62, 82, 88, 89, 90, 92, 94, 100, 114, 116, 123, 148, 151, 164, 171, 173, 177, 178, 179, 184, 185, 192, 194, 203, 219, 223, 230, 242, 244, 245, 251, 257, 264, 270, 271, 273, 305, 309, 312, 314, 326, 328, 331, 342, 343, 345, 346, 348, 353, 356, 363, 370, 374, 379, 383, 384, 386, 389, 391, 401, 405, 414, 415, 420, 429, 436, 438, 447, 455, 457, 459, 463, 469, 471, 472, 473, 476, 480, 488, 492, 493, 495, 501, 502, 509, 513, 514, 517, 518, 520, 526, 528, 536, 539, 542, 543, 544, 545, 547, 551, 560, 564, 579, 582, 585, 590, 593, 595, 608, 615, 618, 622, 634, 643, 651, 652, 655, 656, 668, 669, 673, 674, 676, 680, 688, 689, 691, 698, 700, 703, 704, 709, 718, 722, 729, 731, 733, 745, 755, 768, 770, 779, 785, 797, 800, 801, 813, 816, 827, 829, 834, 837, 840, 841, 859, 865, 868, 869, 871, 877, 878]
[0, 7, 14, 22, 25, 32, 34, 40, 41, 47, 49, 64, 80, 85, 89, 94, 104, 112, 113, 120, 121, 126, 134, 157, 169, 174, 178, 181, 182, 192, 195, 207, 219, 235, 239, 243, 249, 250, 255, 259, 262, 267, 276, 281, 305, 314, 325, 329, 341, 345, 357, 358, 359, 366, 375, 389, 392, 394, 398, 399, 422, 431, 452, 453, 463, 475, 480, 481, 486, 501, 505, 506, 512, 513, 523, 530, 531, 532, 536, 544, 556, 561, 566, 570, 576, 584, 597, 616, 618, 621, 628, 634, 643, 657, 673, 678, 681, 684, 685, 690, 707, 710, 712, 724, 729, 736, 766, 774, 793, 799, 806, 809, 822, 828, 830, 835, 837, 845, 848, 866, 879, 886]

[3, 5, 19, 22, 24, 28, 32, 40, 45, 54, 56, 60, 61, 62, 64, 67, 71, 78, 79, 81, 82, 85, 86, 88, 89, 90, 92, 94, 100, 102, 114, 116, 123, 134, 148, 150, 151, 158, 161, 164, 171, 173, 175, 177, 178, 179, 184, 185, 187, 188, 192, 194, 203, 208, 219, 221, 223, 228, 230, 240, 242, 244, 245, 251, 257, 264, 270, 271, 273, 275, 284, 286, 295, 300, 304, 305, 309, 312, 314, 318, 320, 326, 328, 331, 332, 334, 338, 340, 342, 343, 345, 346, 348, 350, 351, 353, 354, 356, 363, 370, 374, 379, 383, 384, 386, 389, 391, 393, 401, 405, 414, 415, 420, 421, 429, 436, 438, 447, 450, 455, 457, 459, 463, 469, 471, 472, 473, 476, 478, 480, 488, 492, 493, 495, 501, 502, 509, 513, 514, 517, 518, 520, 521, 525, 526, 528, 530, 532, 536, 539, 542, 543, 544, 545, 547, 551, 554, 560, 564, 566, 579, 582, 585, 587, 590, 593, 595, 599, 602, 608, 614, 615, 618, 622, 634, 641, 643, 651, 652, 655, 656, 660, 662, 668, 669, 673, 674, 676, 680, 688, 689, 691, 695, 698, 700, 703, 704, 709, 712, 718, 719, 722, 727, 729, 731, 733, 745, 755, 759, 761, 763, 766, 768, 770, 772, 777, 779, 782, 783, 785, 788, 795, 797, 800, 801, 804, 813, 816, 827, 829, 834, 837, 838, 840, 841, 844, 859, 860, 865, 868, 869, 871, 872, 877, 878, 879, 887]
[0, 7, 14, 22, 25, 32, 34, 40, 41, 47, 49, 64, 80, 85, 89, 94, 104, 112, 113, 120, 121, 126, 134, 157, 169, 174, 178, 181, 182, 192, 195, 207, 219, 235, 239, 243, 249, 250, 255, 259, 262, 267, 276, 281, 305, 314, 325, 329, 341, 345, 357, 358, 359, 366, 375, 389, 392, 394, 398, 399, 422, 431, 452, 453, 463, 475, 480, 481, 486, 501, 505, 506, 512, 513, 523, 530, 531, 532, 536, 544, 556, 561, 566, 570, 576, 584, 597, 616, 618, 621, 628, 634, 643, 657, 673, 678, 681, 684, 685, 690, 707, 710, 712, 724, 729, 736, 766, 774, 793, 799, 806, 809, 822, 828, 830, 835, 837, 845, 848, 866, 879, 886]

[3, 5, 8, 9, 11, 15, 19, 22, 24, 27, 28, 32, 37, 39, 40, 45, 48, 54, 56, 58, 60, 61, 62, 64, 66, 67, 71, 72, 78, 79, 81, 82, 84, 85, 86, 88, 89, 90, 92, 94, 100, 101, 102, 108, 114, 116, 117, 120, 123, 133, 134, 148, 149, 150, 151, 156, 158, 161, 164, 171, 173, 175, 177, 178, 179, 182, 184, 185, 187, 188, 192, 194, 196, 203, 207, 208, 219, 221, 222, 223, 224, 227, 228, 230, 234, 240, 242, 244, 245, 249, 251, 257, 260, 264, 270, 271, 273, 275, 282, 284, 286, 290, 295, 296, 300, 303, 304, 305, 309, 312, 314, 317, 318, 320, 326, 328, 331, 332, 334, 338, 340, 342, 343, 344, 345, 346, 348, 350, 351, 353, 354, 356, 363, 364, 370, 374, 379, 383, 384, 386, 389, 391, 393, 401, 405, 414, 415, 420, 421, 429, 436, 438, 447, 450, 455, 456, 457, 459, 462, 463, 469, 470, 471, 472, 473, 476, 478, 480, 486, 488, 490, 492, 493, 495, 498, 501, 502, 506, 508, 509, 513, 514, 517, 518, 520, 521, 525, 526, 528, 530, 531, 532, 536, 539, 542, 543, 544, 545, 547, 551, 554, 560, 564, 566, 579, 582, 583, 585, 587, 589, 590, 593, 595, 599, 602, 606, 608, 614, 615, 616, 618, 622, 625, 634, 641, 643, 650, 651, 652, 655, 656, 660, 662, 668, 669, 672, 673, 674, 676, 680, 688, 689, 691, 693, 695, 698, 700, 703, 704, 709, 712, 718, 719, 722, 723, 727, 729, 730, 731, 733, 741, 745, 755, 759, 761, 763, 764, 766, 768, 769, 770, 772, 774, 776, 777, 779, 781, 782, 783, 785, 788, 794, 795, 797, 800, 801, 802, 804, 808, 812, 813, 816, 819, 823, 827, 829, 832, 834, 837, 838, 840, 841, 842, 844, 853, 859, 860, 861, 865, 868, 869, 871, 872, 874, 877, 878, 879, 880, 881, 884, 885, 887]
[0, 7, 14, 22, 25, 32, 34, 40, 41, 47, 49, 64, 80, 85, 89, 94, 104, 112, 113, 120, 121, 126, 134, 157, 169, 174, 178, 181, 182, 192, 195, 207, 219, 235, 239, 243, 249, 250, 255, 259, 262, 267, 276, 281, 305, 314, 325, 329, 341, 345, 357, 358, 359, 366, 375, 389, 392, 394, 398, 399, 422, 431, 452, 453, 463, 475, 480, 481, 486, 501, 505, 506, 512, 513, 523, 530, 531, 532, 536, 544, 556, 561, 566, 570, 576, 584, 597, 616, 618, 621, 628, 634, 643, 657, 673, 678, 681, 684, 685, 690, 707, 710, 712, 724, 729, 736, 766, 774, 793, 799, 806, 809, 822, 828, 830, 835, 837, 845, 848, 866, 879, 886]

[1, 3, 5, 8, 9, 11, 15, 19, 22, 24, 27, 28, 32, 33, 37, 39, 40, 45, 48, 50, 54, 56, 58, 60, 61, 62, 64, 66, 67, 71, 72, 78, 79, 80, 81, 82, 84, 85, 86, 88, 89, 90, 92, 93, 94, 96, 100, 101, 102, 104, 108, 113, 114, 116, 117, 119, 120, 123, 133, 134, 139, 142, 148, 149, 150, 151, 155, 156, 158, 161, 164, 166, 169, 170, 171, 173, 175, 177, 178, 179, 182, 184, 185, 187, 188, 189, 192, 193, 194, 196, 203, 207, 208, 212, 219, 221, 222, 223, 224, 227, 228, 230, 234, 240, 242, 244, 245, 249, 250, 251, 254, 255, 257, 260, 264, 270, 271, 273, 274, 275, 276, 282, 284, 286, 290, 294, 295, 296, 300, 303, 304, 305, 309, 312, 314, 317, 318, 320, 324, 326, 328, 331, 332, 334, 335, 338, 340, 342, 343, 344, 345, 346, 348, 350, 351, 353, 354, 356, 358, 363, 364, 367, 370, 371, 373, 374, 379, 383, 384, 386, 389, 391, 393, 396, 397, 400, 401, 405, 411, 412, 414, 415, 420, 421, 424, 428, 429, 436, 438, 439, 445, 447, 450, 455, 456, 457, 459, 460, 462, 463, 469, 470, 471, 472, 473, 476, 477, 478, 480, 481, 486, 488, 490, 492, 493, 495, 498, 501, 502, 504, 506, 508, 509, 512, 513, 514, 517, 518, 519, 520, 521, 525, 526, 528, 530, 531, 532, 536, 539, 542, 543, 544, 545, 547, 551, 553, 554, 560, 564, 566, 568, 570, 573, 579, 581, 582, 583, 585, 587, 589, 590, 593, 595, 596, 599, 602, 606, 608, 611, 614, 615, 616, 618, 622, 623, 625, 626, 629, 634, 641, 642, 643, 644, 646, 650, 651, 652, 655, 656, 660, 662, 668, 669, 671, 672, 673, 674, 676, 678, 680, 688, 689, 690, 691, 693, 695, 696, 697, 698, 700, 703, 704, 706, 707, 709, 712, 718, 719, 722, 723, 725, 727, 729, 730, 731, 733, 734, 741, 745, 755, 759, 761, 763, 764, 765, 766, 768, 769, 770, 772, 774, 776, 777, 779, 781, 782, 783, 785, 788, 789, 792, 794, 795, 797, 800, 801, 802, 804, 807, 808, 809, 812, 813, 816, 819, 823, 827, 829, 832, 834, 837, 838, 840, 841, 842, 844, 853, 854, 857, 859, 860, 861, 865, 868, 869, 871, 872, 874, 877, 878, 879, 880, 881, 882, 884, 885, 887]
[0, 7, 14, 22, 25, 32, 34, 40, 41, 47, 49, 64, 80, 85, 89, 94, 104, 112, 113, 120, 121, 126, 134, 157, 169, 174, 178, 181, 182, 192, 195, 207, 219, 235, 239, 243, 249, 250, 255, 259, 262, 267, 276, 281, 305, 314, 325, 329, 341, 345, 357, 358, 359, 366, 375, 389, 392, 394, 398, 399, 422, 431, 452, 453, 463, 475, 480, 481, 486, 501, 505, 506, 512, 513, 523, 530, 531, 532, 536, 544, 556, 561, 566, 570, 576, 584, 597, 616, 618, 621, 628, 634, 643, 657, 673, 678, 681, 684, 685, 690, 707, 710, 712, 724, 729, 736, 766, 774, 793, 799, 806, 809, 822, 828, 830, 835, 837, 845, 848, 866, 879, 886]

[1, 3, 4, 5, 8, 9, 11, 15, 17, 18, 19, 20, 22, 24, 27, 28, 31, 32, 33, 34, 37, 39, 40, 45, 48, 49, 50, 54, 56, 58, 60, 61, 62, 64, 66, 67, 71, 72, 73, 78, 79, 80, 81, 82, 84, 85, 86, 87, 88, 89, 90, 92, 93, 94, 95, 96, 99, 100, 101, 102, 104, 107, 108, 109, 113, 114, 115, 116, 117, 119, 120, 123, 128, 129, 133, 134, 135, 137, 138, 139, 141, 142, 148, 149, 150, 151, 155, 156, 157, 158, 161, 162, 164, 166, 169, 170, 171, 172, 173, 175, 176, 177, 178, 179, 182, 183, 184, 185, 187, 188, 189, 192, 193, 194, 196, 201, 203, 207, 208, 211, 212, 219, 221, 222, 223, 224, 227, 228, 230, 234, 239, 240, 242, 244, 245, 249, 250, 251, 253, 254, 255, 257, 259, 260, 264, 270, 271, 273, 274, 275, 276, 277, 282, 284, 286, 290, 294, 295, 296, 300, 303, 304, 305, 309, 312, 314, 317, 318, 319, 320, 324, 326, 328, 331, 332, 334, 335, 338, 340, 342, 343, 344, 345, 346, 348, 350, 351, 353, 354, 356, 358, 363, 364, 367, 370, 371, 373, 374, 379, 383, 384, 386, 389, 391, 393, 396, 397, 398, 400, 401, 405, 408, 411, 412, 414, 415, 420, 421, 424, 428, 429, 431, 434, 436, 438, 439, 440, 445, 446, 447, 448, 450, 452, 455, 456, 457, 459, 460, 462, 463, 469, 470, 471, 472, 473, 476, 477, 478, 480, 481, 485, 486, 488, 490, 491, 492, 493, 495, 496, 498, 501, 502, 504, 506, 507, 508, 509, 512, 513, 514, 517, 518, 519, 520, 521, 523, 525, 526, 528, 530, 531, 532, 535, 536, 539, 542, 543, 544, 545, 547, 551, 553, 554, 556, 560, 563, 564, 566, 568, 570, 572, 573, 579, 581, 582, 583, 585, 587, 588, 589, 590, 593, 595, 596, 599, 602, 606, 608, 611, 614, 615, 616, 618, 619, 622, 623, 625, 626, 629, 634, 637, 641, 642, 643, 644, 646, 647, 650, 651, 652, 655, 656, 660, 662, 665, 668, 669, 671, 672, 673, 674, 676, 678, 680, 681, 683, 688, 689, 690, 691, 693, 695, 696, 697, 698, 700, 703, 704, 706, 707, 709, 712, 714, 716, 717, 718, 719, 720, 722, 723, 725, 726, 727, 729, 730, 731, 733, 734, 736, 737, 739, 741, 744, 745, 753, 755, 759, 761, 763, 764, 765, 766, 768, 769, 770, 772, 774, 775, 776, 777, 779, 781, 782, 783, 785, 788, 789, 792, 794, 795, 796, 797, 800, 801, 802, 804, 807, 808, 809, 812, 813, 814, 816, 817, 819, 823, 827, 828, 829, 832, 834, 837, 838, 840, 841, 842, 844, 845, 853, 854, 857, 859, 860, 861, 863, 865, 868, 869, 870, 871, 872, 874, 877, 878, 879, 880, 881, 882, 883, 884, 885, 887]
[0, 7, 14, 22, 25, 32, 34, 40, 41, 47, 49, 64, 80, 85, 89, 94, 104, 112, 113, 120, 121, 126, 134, 157, 169, 174, 178, 181, 182, 192, 195, 207, 219, 235, 239, 243, 249, 250, 255, 259, 262, 267, 276, 281, 305, 314, 325, 329, 341, 345, 357, 358, 359, 366, 375, 389, 392, 394, 398, 399, 422, 431, 452, 453, 463, 475, 480, 481, 486, 501, 505, 506, 512, 513, 523, 530, 531, 532, 536, 544, 556, 561, 566, 570, 576, 584, 597, 616, 618, 621, 628, 634, 643, 657, 673, 678, 681, 684, 685, 690, 707, 710, 712, 724, 729, 736, 766, 774, 793, 799, 806, 809, 822, 828, 830, 835, 837, 845, 848, 866, 879, 886]

[1, 3, 4, 5, 8, 9, 11, 15, 17, 18, 19, 20, 22, 24, 27, 28, 30, 31, 32, 33, 34, 37, 39, 40, 45, 48, 49, 50, 53, 54, 55, 56, 57, 58, 60, 61, 62, 64, 66, 67, 71, 72, 73, 78, 79, 80, 81, 82, 84, 85, 86, 87, 88, 89, 90, 92, 93, 94, 95, 96, 99, 100, 101, 102, 104, 105, 106, 107, 108, 109, 112, 113, 114, 115, 116, 117, 119, 120, 121, 123, 126, 128, 129, 130, 131, 133, 134, 135, 137, 138, 139, 140, 141, 142, 148, 149, 150, 151, 155, 156, 157, 158, 161, 162, 164, 166, 169, 170, 171, 172, 173, 175, 176, 177, 178, 179, 180, 181, 182, 183, 184, 185, 187, 188, 189, 191, 192, 193, 194, 195, 196, 201, 203, 207, 208, 211, 212, 215, 219, 221, 222, 223, 224, 227, 228, 230, 233, 234, 239, 240, 242, 244, 245, 246, 247, 249, 250, 251, 253, 254, 255, 257, 259, 260, 264, 265, 270, 271, 273, 274, 275, 276, 277, 282, 284, 286, 289, 290, 292, 294, 295, 296, 300, 303, 304, 305, 306, 309, 311, 312, 314, 316, 317, 318, 319, 320, 322, 324, 326, 328, 331, 332, 334, 335, 337, 338, 340, 341, 342, 343, 344, 345, 346, 348, 350, 351, 353, 354, 356, 358, 363, 364, 367, 370, 371, 373, 374, 375, 379, 382, 383, 384, 385, 386, 387, 388, 389, 391, 393, 395, 396, 397, 398, 400, 401, 404, 405, 408, 411, 412, 414, 415, 419, 420, 421, 424, 425, 428, 429, 430, 431, 434, 436, 438, 439, 440, 442, 445, 446, 447, 448, 450, 452, 455, 456, 457, 459, 460, 462, 463, 467, 469, 470, 471, 472, 473, 476, 477, 478, 480, 481, 483, 484, 485, 486, 488, 490, 491, 492, 493, 495, 496, 498, 500, 501, 502, 504, 506, 507, 508, 509, 512, 513, 514, 517, 518, 519, 520, 521, 523, 525, 526, 528, 529, 530, 531, 532, 535, 536, 539, 542, 543, 544, 545, 547, 548, 551, 553, 554, 555, 556, 559, 560, 561, 563, 564, 566, 568, 570, 572, 573, 579, 581, 582, 583, 585, 587, 588, 589, 590, 593, 594, 595, 596, 599, 602, 606, 607, 608, 611, 614, 615, 616, 618, 619, 622, 623, 625, 626, 629, 634, 635, 637, 638, 641, 642, 643, 644, 646, 647, 650, 651, 652, 655, 656, 658, 660, 662, 664, 665, 668, 669, 671, 672, 673, 674, 676, 678, 679, 680, 681, 683, 688, 689, 690, 691, 693, 694, 695, 696, 697, 698, 700, 703, 704, 705, 706, 707, 708, 709, 712, 714, 716, 717, 718, 719, 720, 722, 723, 725, 726, 727, 729, 730, 731, 733, 734, 736, 737, 738, 739, 741, 743, 744, 745, 752, 753, 755, 757, 759, 760, 761, 763, 764, 765, 766, 768, 769, 770, 772, 774, 775, 776, 777, 778, 779, 781, 782, 783, 785, 787, 788, 789, 791, 792, 794, 795, 796, 797, 798, 800, 801, 802, 804, 807, 808, 809, 812, 813, 814, 816, 817, 819, 821, 823, 824, 825, 827, 828, 829, 832, 834, 837, 838, 840, 841, 842, 844, 845, 846, 853, 854, 857, 859, 860, 861, 863, 864, 865, 867, 868, 869, 870, 871, 872, 873, 874, 877, 878, 879, 880, 881, 882, 883, 884, 885, 887]
[0, 7, 14, 22, 25, 32, 34, 40, 41, 47, 49, 64, 80, 85, 89, 94, 104, 112, 113, 120, 121, 126, 134, 157, 169, 174, 178, 181, 182, 192, 195, 207, 219, 235, 239, 243, 249, 250, 255, 259, 262, 267, 276, 281, 305, 314, 325, 329, 341, 345, 357, 358, 359, 366, 375, 389, 392, 394, 398, 399, 422, 431, 452, 453, 463, 475, 480, 481, 486, 501, 505, 506, 512, 513, 523, 530, 531, 532, 536, 544, 556, 561, 566, 570, 576, 584, 597, 616, 618, 621, 628, 634, 643, 657, 673, 678, 681, 684, 685, 690, 707, 710, 712, 724, 729, 736, 766, 774, 793, 799, 806, 809, 822, 828, 830, 835, 837, 845, 848, 866, 879, 886]

[1, 2, 3, 4, 5, 6, 8, 9, 11, 15, 17, 18, 19, 20, 21, 22, 24, 26, 27, 28, 30, 31, 32, 33, 34, 36, 37, 38, 39, 40, 45, 48, 49, 50, 53, 54, 55, 56, 57, 58, 59, 60, 61, 62, 64, 66, 67, 71, 72, 73, 78, 79, 80, 81, 82, 84, 85, 86, 87, 88, 89, 90, 92, 93, 94, 95, 96, 99, 100, 101, 102, 104, 105, 106, 107, 108, 109, 112, 113, 114, 115, 116, 117, 119, 120, 121, 123, 126, 127, 128, 129, 130, 131, 133, 134, 135, 137, 138, 139, 140, 141, 142, 143, 146, 148, 149, 150, 151, 155, 156, 157, 158, 161, 162, 164, 165, 166, 168, 169, 170, 171, 172, 173, 175, 176, 177, 178, 179, 180, 181, 182, 183, 184, 185, 187, 188, 189, 191, 192, 193, 194, 195, 196, 198, 201, 202, 203, 207, 208, 211, 212, 215, 217, 218, 219, 221, 222, 223, 224, 227, 228, 229, 230, 233, 234, 237, 238, 239, 240, 242, 244, 245, 246, 247, 248, 249, 250, 251, 253, 254, 255, 256, 257, 258, 259, 260, 264, 265, 270, 271, 272, 273, 274, 275, 276, 277, 278, 282, 283, 284, 286, 289, 290, 292, 293, 294, 295, 296, 298, 300, 301, 303, 304, 305, 306, 309, 311, 312, 313, 314, 316, 317, 318, 319, 320, 321, 322, 324, 326, 328, 330, 331, 332, 334, 335, 337, 338, 340, 341, 342, 343, 344, 345, 346, 348, 350, 351, 353, 354, 356, 357, 358, 360, 363, 364, 367, 370, 371, 373, 374, 375, 379, 382, 383, 384, 385, 386, 387, 388, 389, 391, 393, 395, 396, 397, 398, 400, 401, 402, 404, 405, 408, 411, 412, 413, 414, 415, 417, 419, 420, 421, 424, 425, 428, 429, 430, 431, 432, 434, 436, 438, 439, 440, 442, 445, 446, 447, 448, 450, 451, 452, 453, 454, 455, 456, 457, 458, 459, 460, 461, 462, 463, 464, 467, 468, 469, 470, 471, 472, 473, 476, 477, 478, 480, 481, 483, 484, 485, 486, 488, 489, 490, 491, 492, 493, 495, 496, 498, 500, 501, 502, 504, 506, 507, 508, 509, 510, 512, 513, 514, 515, 517, 518, 519, 520, 521, 522, 523, 525, 526, 528, 529, 530, 531, 532, 534, 535, 536, 537, 539, 542, 543, 544, 545, 546, 547, 548, 551, 553, 554, 555, 556, 559, 560, 561, 563, 564, 566, 567, 568, 570, 571, 572, 573, 579, 581, 582, 583, 585, 586, 587, 588, 589, 590, 593, 594, 595, 596, 597, 599, 602, 606, 607, 608, 611, 614, 615, 616, 618, 619, 622, 623, 625, 626, 629, 634, 635, 637, 638, 639, 641, 642, 643, 644, 646, 647, 649, 650, 651, 652, 655, 656, 658, 660, 662, 664, 665, 668, 669, 670, 671, 672, 673, 674, 676, 678, 679, 680, 681, 683, 688, 689, 690, 691, 693, 694, 695, 696, 697, 698, 699, 700, 702, 703, 704, 705, 706, 707, 708, 709, 711, 712, 714, 716, 717, 718, 719, 720, 721, 722, 723, 725, 726, 727, 729, 730, 731, 733, 734, 735, 736, 737, 738, 739, 740, 741, 743, 744, 745, 746, 749, 750, 752, 753, 754, 755, 757, 759, 760, 761, 762, 763, 764, 765, 766, 768, 769, 770, 772, 773, 774, 775, 776, 777, 778, 779, 781, 782, 783, 785, 787, 788, 789, 790, 791, 792, 794, 795, 796, 797, 798, 799, 800, 801, 802, 803, 804, 807, 808, 809, 811, 812, 813, 814, 815, 816, 817, 819, 820, 821, 823, 824, 825, 826, 827, 828, 829, 830, 832, 834, 835, 837, 838, 840, 841, 842, 844, 845, 846, 851, 853, 854, 857, 858, 859, 860, 861, 863, 864, 865, 867, 868, 869, 870, 871, 872, 873, 874, 877, 878, 879, 880, 881, 882, 883, 884, 885, 887]
[0, 7, 14, 22, 25, 32, 34, 40, 41, 47, 49, 64, 80, 85, 89, 94, 104, 112, 113, 120, 121, 126, 134, 157, 169, 174, 178, 181, 182, 192, 195, 207, 219, 235, 239, 243, 249, 250, 255, 259, 262, 267, 276, 281, 305, 314, 325, 329, 341, 345, 357, 358, 359, 366, 375, 389, 392, 394, 398, 399, 422, 431, 452, 453, 463, 475, 480, 481, 486, 501, 505, 506, 512, 513, 523, 530, 531, 532, 536, 544, 556, 561, 566, 570, 576, 584, 597, 616, 618, 621, 628, 634, 643, 657, 673, 678, 681, 684, 685, 690, 707, 710, 712, 724, 729, 736, 766, 774, 793, 799, 806, 809, 822, 828, 830, 835, 837, 845, 848, 866, 879, 886]

[1, 2, 3, 4, 5, 6, 8, 9, 11, 13, 15, 16, 17, 18, 19, 20, 21, 22, 23, 24, 26, 27, 28, 30, 31, 32, 33, 34, 36, 37, 38, 39, 40, 45, 46, 47, 48, 49, 50, 51, 53, 54, 55, 56, 57, 58, 59, 60, 61, 62, 63, 64, 65, 66, 67, 71, 72, 73, 75, 78, 79, 80, 81, 82, 84, 85, 86, 87, 88, 89, 90, 92, 93, 94, 95, 96, 99, 100, 101, 102, 104, 105, 106, 107, 108, 109, 111, 112, 113, 114, 115, 116, 117, 118, 119, 120, 121, 123, 126, 127, 128, 129, 130, 131, 133, 134, 135, 137, 138, 139, 140, 141, 142, 143, 144, 146, 148, 149, 150, 151, 154, 155, 156, 157, 158, 159, 161, 162, 164, 165, 166, 168, 169, 170, 171, 172, 173, 175, 176, 177, 178, 179, 180, 181, 182, 183, 184, 185, 186, 187, 188, 189, 190, 191, 192, 193, 194, 195, 196, 198, 201, 202, 203, 207, 208, 211, 212, 213, 215, 217, 218, 219, 221, 222, 223, 224, 227, 228, 229, 230, 231, 233, 234, 235, 236, 237, 238, 239, 240, 241, 242, 243, 244, 245, 246, 247, 248, 249, 250, 251, 253, 254, 255, 256, 257, 258, 259, 260, 261, 262, 264, 265, 267, 270, 271, 272, 273, 274, 275, 276, 277, 278, 281, 282, 283, 284, 285, 286, 287, 288, 289, 290, 292, 293, 294, 295, 296, 298, 300, 301, 302, 303, 304, 305, 306, 309, 311, 312, 313, 314, 316, 317, 318, 319, 320, 321, 322, 324, 326, 328, 330, 331, 332, 334, 335, 337, 338, 339, 340, 341, 342, 343, 344, 345, 346, 347, 348, 350, 351, 353, 354, 356, 357, 358, 360, 361, 363, 364, 367, 369, 370, 371, 373, 374, 375, 379, 380, 382, 383, 384, 385, 386, 387, 388, 389, 390, 391, 393, 395, 396, 397, 398, 399, 400, 401, 402, 404, 405, 408, 409, 410, 411, 412, 413, 414, 415, 416, 417, 419, 420, 421, 424, 425, 427, 428, 429, 430, 431, 432, 433, 434, 436, 438, 439, 440, 442, 445, 446, 447, 448, 450, 451, 452, 453, 454, 455, 456, 457, 458, 459, 460, 461, 462, 463, 464, 467, 468, 469, 470, 471, 472, 473, 476, 477, 478, 479, 480, 481, 482, 483, 484, 485, 486, 488, 489, 490, 491, 492, 493, 495, 496, 498, 499, 500, 501, 502, 504, 506, 507, 508, 509, 510, 511, 512, 513, 514, 515, 516, 517, 518, 519, 520, 521, 522, 523, 525, 526, 527, 528, 529, 530, 531, 532, 534, 535, 536, 537, 539, 541, 542, 543, 544, 545, 546, 547, 548, 549, 550, 551, 553, 554, 555, 556, 557, 559, 560, 561, 563, 564, 566, 567, 568, 570, 571, 572, 573, 575, 577, 579, 581, 582, 583, 584, 585, 586, 587, 588, 589, 590, 592, 593, 594, 595, 596, 597, 599, 602, 606, 607, 608, 609, 611, 614, 615, 616, 618, 619, 621, 622, 623, 625, 626, 627, 629, 630, 631, 633, 634, 635, 637, 638, 639, 641, 642, 643, 644, 646, 647, 649, 650, 651, 652, 655, 656, 658, 659, 660, 662, 663, 664, 665, 668, 669, 670, 671, 672, 673, 674, 675, 676, 677, 678, 679, 680, 681, 683, 688, 689, 690, 691, 693, 694, 695, 696, 697, 698, 699, 700, 702, 703, 704, 705, 706, 707, 708, 709, 711, 712, 714, 715, 716, 717, 718, 719, 720, 721, 722, 723, 725, 726, 727, 729, 730, 731, 732, 733, 734, 735, 736, 737, 738, 739, 740, 741, 743, 744, 745, 746, 749, 750, 751, 752, 753, 754, 755, 757, 759, 760, 761, 762, 763, 764, 765, 766, 768, 769, 770, 772, 773, 774, 775, 776, 777, 778, 779, 781, 782, 783, 785, 786, 787, 788, 789, 790, 791, 792, 794, 795, 796, 797, 798, 799, 800, 801, 802, 803, 804, 806, 807, 808, 809, 810, 811, 812, 813, 814, 815, 816, 817, 818, 819, 820, 821, 823, 824, 825, 826, 827, 828, 829, 830, 832, 834, 835, 836, 837, 838, 840, 841, 842, 844, 845, 846, 847, 851, 853, 854, 855, 857, 858, 859, 860, 861, 862, 863, 864, 865, 867, 868, 869, 870, 871, 872, 873, 874, 875, 877, 878, 879, 880, 881, 882, 883, 884, 885, 886, 887]
[0, 7, 14, 22, 25, 32, 34, 40, 41, 47, 49, 64, 80, 85, 89, 94, 104, 112, 113, 120, 121, 126, 134, 157, 169, 174, 178, 181, 182, 192, 195, 207, 219, 235, 239, 243, 249, 250, 255, 259, 262, 267, 276, 281, 305, 314, 325, 329, 341, 345, 357, 358, 359, 366, 375, 389, 392, 394, 398, 399, 422, 431, 452, 453, 463, 475, 480, 481, 486, 501, 505, 506, 512, 513, 523, 530, 531, 532, 536, 544, 556, 561, 566, 570, 576, 584, 597, 616, 618, 621, 628, 634, 643, 657, 673, 678, 681, 684, 685, 690, 707, 710, 712, 724, 729, 736, 766, 774, 793, 799, 806, 809, 822, 828, 830, 835, 837, 845, 848, 866, 879, 886]

[0, 1, 2, 3, 4, 5, 6, 8, 9, 11, 13, 15, 16, 17, 18, 19, 20, 21, 22, 23, 24, 25, 26, 27, 28, 30, 31, 32, 33, 34, 35, 36, 37, 38, 39, 40, 42, 45, 46, 47, 48, 49, 50, 51, 53, 54, 55, 56, 57, 58, 59, 60, 61, 62, 63, 64, 65, 66, 67, 70, 71, 72, 73, 74, 75, 78, 79, 80, 81, 82, 83, 84, 85, 86, 87, 88, 89, 90, 92, 93, 94, 95, 96, 99, 100, 101, 102, 104, 105, 106, 107, 108, 109, 110, 111, 112, 113, 114, 115, 116, 117, 118, 119, 120, 121, 123, 125, 126, 127, 128, 129, 130, 131, 133, 134, 135, 136, 137, 138, 139, 140, 141, 142, 143, 144, 146, 148, 149, 150, 151, 153, 154, 155, 156, 157, 158, 159, 161, 162, 163, 164, 165, 166, 168, 169, 170, 171, 172, 173, 175, 176, 177, 178, 179, 180, 181, 182, 183, 184, 185, 186, 187, 188, 189, 190, 191, 192, 193, 194, 195, 196, 198, 199, 201, 202, 203, 207, 208, 211, 212, 213, 215, 216, 217, 218, 219, 221, 222, 223, 224, 227, 228, 229, 230, 231, 232, 233, 234, 235, 236, 237, 238, 239, 240, 241, 242, 243, 244, 245, 246, 247, 248, 249, 250, 251, 252, 253, 254, 255, 256, 257, 258, 259, 260, 261, 262, 264, 265, 267, 268, 269, 270, 271, 272, 273, 274, 275, 276, 277, 278, 279, 281, 282, 283, 284, 285, 286, 287, 288, 289, 290, 291, 292, 293, 294, 295, 296, 298, 299, 300, 301, 302, 303, 304, 305, 306, 309, 311, 312, 313, 314, 315, 316, 317, 318, 319, 320, 321, 322, 323, 324, 325, 326, 327, 328, 329, 330, 331, 332, 334, 335, 337, 338, 339, 340, 341, 342, 343, 344, 345, 346, 347, 348, 349, 350, 351, 352, 353, 354, 356, 357, 358, 360, 361, 362, 363, 364, 367, 369, 370, 371, 373, 374, 375, 377, 378, 379, 380, 381, 382, 383, 384, 385, 386, 387, 388, 389, 390, 391, 392, 393, 394, 395, 396, 397, 398, 399, 400, 401, 402, 404, 405, 407, 408, 409, 410, 411, 412, 413, 414, 415, 416, 417, 418, 419, 420, 421, 424, 425, 426, 427, 428, 429, 430, 431, 432, 433, 434, 436, 438, 439, 440, 441, 442, 445, 446, 447, 448, 450, 451, 452, 453, 454, 455, 456, 457, 458, 459, 460, 461, 462, 463, 464, 465, 466, 467, 468, 469, 470, 471, 472, 473, 474, 476, 477, 478, 479, 480, 481, 482, 483, 484, 485, 486, 488, 489, 490, 491, 492, 493, 495, 496, 497, 498, 499, 500, 501, 502, 503, 504, 506, 507, 508, 509, 510, 511, 512, 513, 514, 515, 516, 517, 518, 519, 520, 521, 522, 523, 524, 525, 526, 527, 528, 529, 530, 531, 532, 534, 535, 536, 537, 539, 541, 542, 543, 544, 545, 546, 547, 548, 549, 550, 551, 552, 553, 554, 555, 556, 557, 558, 559, 560, 561, 563, 564, 566, 567, 568, 570, 571, 572, 573, 575, 577, 579, 581, 582, 583, 584, 585, 586, 587, 588, 589, 590, 591, 592, 593, 594, 595, 596, 597, 599, 600, 602, 604, 605, 606, 607, 608, 609, 611, 614, 615, 616, 618, 619, 621, 622, 623, 625, 626, 627, 628, 629, 630, 631, 633, 634, 635, 637, 638, 639, 640, 641, 642, 643, 644, 646, 647, 648, 649, 650, 651, 652, 653, 655, 656, 657, 658, 659, 660, 661, 662, 663, 664, 665, 667, 668, 669, 670, 671, 672, 673, 674, 675, 676, 677, 678, 679, 680, 681, 682, 683, 685, 688, 689, 690, 691, 693, 694, 695, 696, 697, 698, 699, 700, 702, 703, 704, 705, 706, 707, 708, 709, 711, 712, 714, 715, 716, 717, 718, 719, 720, 721, 722, 723, 725, 726, 727, 729, 730, 731, 732, 733, 734, 735, 736, 737, 738, 739, 740, 741, 743, 744, 745, 746, 747, 748, 749, 750, 751, 752, 753, 754, 755, 756, 757, 758, 759, 760, 761, 762, 763, 764, 765, 766, 768, 769, 770, 772, 773, 774, 775, 776, 777, 778, 779, 781, 782, 783, 784, 785, 786, 787, 788, 789, 790, 791, 792, 794, 795, 796, 797, 798, 799, 800, 801, 802, 803, 804, 805, 806, 807, 808, 809, 810, 811, 812, 813, 814, 815, 816, 817, 818, 819, 820, 821, 822, 823, 824, 825, 826, 827, 828, 829, 830, 831, 832, 834, 835, 836, 837, 838, 839, 840, 841, 842, 843, 844, 845, 846, 847, 848, 849, 851, 852, 853, 854, 855, 857, 858, 859, 860, 861, 862, 863, 864, 865, 866, 867, 868, 869, 870, 871, 872, 873, 874, 875, 876, 877, 878, 879, 880, 881, 882, 883, 884, 885, 886, 887, 889]
[0, 7, 14, 22, 25, 32, 34, 40, 41, 47, 49, 64, 80, 85, 89, 94, 104, 112, 113, 120, 121, 126, 134, 157, 169, 174, 178, 181, 182, 192, 195, 207, 219, 235, 239, 243, 249, 250, 255, 259, 262, 267, 276, 281, 305, 314, 325, 329, 341, 345, 357, 358, 359, 366, 375, 389, 392, 394, 398, 399, 422, 431, 452, 453, 463, 475, 480, 481, 486, 501, 505, 506, 512, 513, 523, 530, 531, 532, 536, 544, 556, 561, 566, 570, 576, 584, 597, 616, 618, 621, 628, 634, 643, 657, 673, 678, 681, 684, 685, 690, 707, 710, 712, 724, 729, 736, 766, 774, 793, 799, 806, 809, 822, 828, 830, 835, 837, 845, 848, 866, 879, 886]

