[90, 93, 125, 192, 202, 237, 266, 345, 371, 376, 412, 566, 585, 586, 662, 683, 714, 771, 842, 861, 882, 884]
[104, 170, 183, 185, 236, 242, 245, 312, 358, 380, 383, 388, 459, 467, 516, 553, 599, 652, 702, 781, 866, 878]

[90, 93, 125, 192, 202, 237, 266, 345, 371, 376, 412, 566, 585, 586, 662, 683, 714, 771, 842, 861, 882, 884]
[9, 11, 29, 34, 41, 66, 67, 88, 94, 97, 99, 104, 124, 144, 145, 150, 170, 176, 183, 185, 194, 203, 236, 242, 244, 245, 247, 249, 252, 263, 287, 306, 309, 312, 315, 321, 325, 328, 333, 334, 337, 352, 358, 377, 380, 383, 388, 408, 415, 430, 434, 437, 443, 446, 454, 456, 459, 464, 465, 467, 474, 489, 501, 504, 513, 516, 517, 521, 533, 541, 545, 553, 557, 558, 561, 568, 598, 599, 611, 612, 613, 622, 628, 629, 644, 649, 650, 652, 653, 654, 660, 664, 670, 680, 689, 693, 694, 695, 702, 717, 718, 725, 740, 752, 753, 755, 770, 776, 781, 785, 790, 793, 794, 802, 835, 847, 850, 856, 866, 878, 879, 886]

[3, 36, 47, 55, 56, 64, 66, 83, 88, 90, 93, 103, 125, 134, 171, 173, 179, 192, 202, 203, 212, 213, 220, 228, 237, 242, 243, 260, 266, 268, 315, 335, 339, 345, 357, 364, 365, 371, 376, 394, 396, 412, 415, 422, 447, 457, 462, 478, 479, 482, 485, 490, 516, 533, 543, 559, 566, 569, 570, 580, 585, 586, 589, 620, 625, 630, 636, 661, 662, 672, 683, 688, 697, 700, 714, 720, 728, 730, 739, 754, 771, 800, 801, 804, 820, 829, 842, 844, 849, 853, 854, 855, 861, 875, 882, 883, 884]
[9, 11, 29, 34, 41, 66, 67, 88, 94, 97, 99, 104, 124, 144, 145, 150, 170, 176, 183, 185, 194, 203, 236, 242, 244, 245, 247, 249, 252, 263, 287, 306, 309, 312, 315, 321, 325, 328, 333, 334, 337, 352, 358, 377, 380, 383, 388, 408, 415, 430, 434, 437, 443, 446, 454, 456, 459, 464, 465, 467, 474, 489, 501, 504, 513, 516, 517, 521, 533, 541, 545, 553, 557, 558, 561, 568, 598, 599, 611, 612, 613, 622, 628, 629, 644, 649, 650, 652, 653, 654, 660, 664, 670, 680, 689, 693, 694, 695, 702, 717, 718, 725, 740, 752, 753, 755, 770, 776, 781, 785, 790, 793, 794, 802, 835, 847, 850, 856, 866, 878, 879, 886]

[2, 3, 5, 6, 8, 19, 36, 47, 53, 55, 56, 64, 66, 76, 83, 88, 90, 93, 100, 101, 103, 109, 119, 123, 125, 132, 134, 146, 158, 171, 173, 174, 179, 184, 192, 202, 203, 204, 208, 209, 212, 213, 220, 228, 237, 242, 243, 246, 247, 254, 260, 266, 268, 288, 290, 298, 311, 315, 335, 339, 341, 345, 348, 356, 357, 359, 363, 364, 365, 371, 376, 387, 394, 396, 402, 411, 412, 415, 421, 422, 434, 447, 457, 459, 462, 467, 470, 471, 478, 479, 481, 482, 485, 490, 516, 528, 533, 540, 542, 543, 553, 559, 562, 566, 568, 569, 570, 577, 580, 583, 585, 586, 589, 600, 610, 620, 623, 625, 627, 630, 636, 639, 653, 657, 659, 661, 662, 670, 672, 683, 688, 696, 697, 700, 706, 714, 720, 728, 730, 735, 739, 748, 754, 757, 766, 771, 790, 791, 800, 801, 804, 811, 818, 820, 821, 822, 823, 829, 836, 842, 844, 849, 853, 854, 855, 861, 873, 875, 877, 882, 883, 884]
[9, 11, 29, 34, 41, 66, 67, 88, 94, 97, 99, 104, 124, 144, 145, 150, 170, 176, 183, 185, 194, 203, 236, 242, 244, 245, 247, 249, 252, 263, 287, 306, 309, 312, 315, 321, 325, 328, 333, 334, 337, 352, 358, 377, 380, 383, 388, 408, 415, 430, 434, 437, 443, 446, 454, 456, 459, 464, 465, 467, 474, 489, 501, 504, 513, 516, 517, 521, 533, 541, 545, 553, 557, 558, 561, 568, 598, 599, 611, 612, 613, 622, 628, 629, 644, 649, 650, 652, 653, 654, 660, 664, 670, 680, 689, 693, 694, 695, 702, 717, 718, 725, 740, 752, 753, 755, 770, 776, 781, 785, 790, 793, 794, 802, 835, 847, 850, 856, 866, 878, 879, 886]

[2, 3, 5, 6, 8, 9, 15, 19, 24, 35, 36, 37, 41, 47, 51, 53, 55, 56, 63, 64, 66, 76, 83, 88, 90, 93, 94, 96, 100, 101, 103, 109, 117, 119, 120, 123, 125, 126, 128, 132, 134, 139, 144, 146, 156, 158, 165, 171, 173, 174, 179, 184, 192, 202, 203, 204, 205, 208, 209, 212, 213, 220, 225, 228, 237, 238, 240, 242, 243, 245, 246, 247, 249, 254, 260, 266, 268, 269, 276, 288, 289, 290, 298, 301, 303, 311, 315, 317, 318, 322, 324, 328, 330, 333, 335, 339, 341, 343, 344, 345, 348, 356, 357, 359, 360, 363, 364, 365, 371, 376, 387, 394, 396, 402, 411, 412, 415, 421, 422, 429, 434, 437, 447, 450, 457, 458, 459, 462, 467, 470, 471, 478, 479, 481, 482, 485, 490, 516, 528, 530, 533, 540, 542, 543, 547, 548, 553, 555, 559, 562, 564, 565, 566, 568, 569, 570, 577, 580, 583, 585, 586, 589, 595, 598, 599, 600, 602, 605, 610, 620, 622, 623, 625, 627, 630, 633, 636, 639, 641, 644, 646, 648, 653, 657, 659, 661, 662, 670, 672, 683, 686, 687, 688, 694, 696, 697, 700, 706, 714, 720, 728, 730, 733, 735, 739, 740, 742, 747, 748, 752, 754, 757, 765, 766, 771, 789, 790, 791, 800, 801, 802, 804, 811, 815, 818, 820, 821, 822, 823, 825, 829, 836, 842, 844, 849, 853, 854, 855, 861, 865, 873, 875, 877, 882, 883, 884, 886]
[9, 11, 29, 34, 41, 66, 67, 88, 94, 97, 99, 104, 124, 144, 145, 150, 170, 176, 183, 185, 194, 203, 236, 242, 244, 245, 247, 249, 252, 263, 287, 306, 309, 312, 315, 321, 325, 328, 333, 334, 337, 352, 358, 377, 380, 383, 388, 408, 415, 430, 434, 437, 443, 446, 454, 456, 459, 464, 465, 467, 474, 489, 501, 504, 513, 516, 517, 521, 533, 541, 545, 553, 557, 558, 561, 568, 598, 599, 611, 612, 613, 622, 628, 629, 644, 649, 650, 652, 653, 654, 660, 664, 670, 680, 689, 693, 694, 695, 702, 717, 718, 725, 740, 752, 753, 755, 770, 776, 781, 785, 790, 793, 794, 802, 835, 847, 850, 856, 866, 878, 879, 886]

[2, 3, 5, 6, 8, 9, 11, 15, 19, 24, 26, 31, 32, 35, 36, 37, 38, 39, 41, 44, 46, 47, 51, 52, 53, 55, 56, 60, 63, 64, 66, 71, 74, 76, 83, 87, 88, 90, 93, 94, 96, 97, 100, 101, 103, 109, 117, 119, 120, 123, 125, 126, 127, 128, 132, 134, 139, 144, 146, 148, 156, 158, 159, 165, 171, 173, 174, 179, 184, 192, 194, 198, 202, 203, 204, 205, 208, 209, 212, 213, 218, 220, 225, 228, 235, 237, 238, 240, 241, 242, 243, 245, 246, 247, 249, 254, 260, 261, 266, 268, 269, 271, 276, 288, 289, 290, 293, 298, 301, 303, 311, 315, 317, 318, 322, 323, 324, 327, 328, 330, 333, 335, 339, 341, 343, 344, 345, 348, 356, 357, 359, 360, 363, 364, 365, 371, 376, 377, 380, 384, 387, 392, 394, 396, 402, 411, 412, 414, 415, 418, 420, 421, 422, 424, 428, 429, 430, 434, 437, 438, 446, 447, 450, 457, 458, 459, 462, 467, 470, 471, 478, 479, 480, 481, 482, 485, 490, 498, 504, 505, 515, 516, 524, 528, 530, 531, 533, 540, 542, 543, 547, 548, 549, 550, 553, 555, 559, 562, 564, 565, 566, 568, 569, 570, 577, 580, 581, 583, 585, 586, 588, 589, 595, 598, 599, 600, 601, 602, 605, 607, 610, 611, 614, 620, 621, 622, 623, 625, 627, 628, 630, 631, 633, 635, 636, 639, 641, 644, 646, 648, 649, 653, 657, 659, 661, 662, 670, 672, 680, 683, 686, 687, 688, 694, 695, 696, 697, 699, 700, 703, 706, 714, 715, 720, 724, 728, 730, 733, 735, 736, 739, 740, 742, 747, 748, 752, 754, 757, 758, 760, 765, 766, 771, 789, 790, 791, 793, 800, 801, 802, 804, 809, 811, 815, 816, 818, 820, 821, 822, 823, 825, 829, 836, 841, 842, 844, 847, 849, 853, 854, 855, 860, 861, 865, 870, 873, 875, 877, 882, 883, 884, 886]
[9, 11, 29, 34, 41, 66, 67, 88, 94, 97, 99, 104, 124, 144, 145, 150, 170, 176, 183, 185, 194, 203, 236, 242, 244, 245, 247, 249, 252, 263, 287, 306, 309, 312, 315, 321, 325, 328, 333, 334, 337, 352, 358, 377, 380, 383, 388, 408, 415, 430, 434, 437, 443, 446, 454, 456, 459, 464, 465, 467, 474, 489, 501, 504, 513, 516, 517, 521, 533, 541, 545, 553, 557, 558, 561, 568, 598, 599, 611, 612, 613, 622, 628, 629, 644, 649, 650, 652, 653, 654, 660, 664, 670, 680, 689, 693, 694, 695, 702, 717, 718, 725, 740, 752, 753, 755, 770, 776, 781, 785, 790, 793, 794, 802, 835, 847, 850, 856, 866, 878, 879, 886]

[1, 2, 3, 5, 6, 8, 9, 11, 12, 15, 19, 21, 24, 26, 28, 31, 32, 35, 36, 37, 38, 39, 41, 44, 46, 47, 50, 51, 52, 53, 55, 56, 60, 63, 64, 66, 70, 71, 74, 76, 83, 85, 87, 88, 90, 93, 94, 96, 97, 100, 101, 103, 108, 109, 113, 117, 119, 120, 123, 125, 126, 127, 128, 130, 132, 134, 137, 139, 141, 144, 146, 148, 156, 158, 159, 165, 170, 171, 173, 174, 176, 177, 179, 184, 192, 194, 196, 198, 199, 201, 202, 203, 204, 205, 207, 208, 209, 212, 213, 214, 218, 220, 224, 225, 227, 228, 235, 237, 238, 240, 241, 242, 243, 245, 246, 247, 249, 253, 254, 260, 261, 266, 268, 269, 271, 272, 276, 282, 286, 288, 289, 290, 293, 297, 298, 301, 303, 304, 305, 308, 311, 315, 317, 318, 322, 323, 324, 327, 328, 330, 333, 335, 339, 341, 343, 344, 345, 348, 351, 356, 357, 359, 360, 363, 364, 365, 371, 376, 377, 380, 384, 387, 389, 392, 394, 396, 402, 410, 411, 412, 414, 415, 416, 418, 420, 421, 422, 424, 428, 429, 430, 434, 437, 438, 446, 447, 448, 450, 453, 457, 458, 459, 462, 467, 470, 471, 472, 473, 476, 477, 478, 479, 480, 481, 482, 485, 490, 494, 498, 504, 505, 512, 514, 515, 516, 519, 524, 527, 528, 530, 531, 533, 535, 539, 540, 542, 543, 547, 548, 549, 550, 553, 555, 558, 559, 562, 564, 565, 566, 568, 569, 570, 575, 577, 580, 581, 583, 585, 586, 588, 589, 590, 594, 595, 598, 599, 600, 601, 602, 605, 607, 609, 610, 611, 614, 620, 621, 622, 623, 625, 627, 628, 630, 631, 633, 635, 636, 638, 639, 640, 641, 644, 646, 648, 649, 652, 653, 657, 659, 661, 662, 665, 668, 670, 672, 680, 681, 683, 686, 687, 688, 694, 695, 696, 697, 699, 700, 701, 703, 706, 714, 715, 720, 724, 728, 730, 732, 733, 735, 736, 737, 739, 740, 742, 746, 747, 748, 750, 752, 754, 755, 757, 758, 760, 764, 765, 766, 767, 771, 789, 790, 791, 793, 795, 799, 800, 801, 802, 804, 805, 809, 811, 814, 815, 816, 818, 820, 821, 822, 823, 825, 828, 829, 836, 838, 841, 842, 844, 847, 849, 853, 854, 855, 860, 861, 865, 868, 870, 872, 873, 875, 877, 882, 883, 884, 886, 888]
[9, 11, 29, 34, 41, 66, 67, 88, 94, 97, 99, 104, 124, 144, 145, 150, 170, 176, 183, 185, 194, 203, 236, 242, 244, 245, 247, 249, 252, 263, 287, 306, 309, 312, 315, 321, 325, 328, 333, 334, 337, 352, 358, 377, 380, 383, 388, 408, 415, 430, 434, 437, 443, 446, 454, 456, 459, 464, 465, 467, 474, 489, 501, 504, 513, 516, 517, 521, 533, 541, 545, 553, 557, 558, 561, 568, 598, 599, 611, 612, 613, 622, 628, 629, 644, 649, 650, 652, 653, 654, 660, 664, 670, 680, 689, 693, 694, 695, 702, 717, 718, 725, 740, 752, 753, 755, 770, 776, 781, 785, 790, 793, 794, 802, 835, 847, 850, 856, 866, 878, 879, 886]

[1, 2, 3, 5, 6, 8, 9, 11, 12, 15, 19, 21, 24, 26, 28, 31, 32, 35, 36, 37, 38, 39, 41, 44, 46, 47, 50, 51, 52, 53, 55, 56, 60, 63, 64, 66, 67, 70, 71, 74, 76, 77, 82, 83, 84, 85, 87, 88, 90, 93, 94, 96, 97, 98, 100, 101, 103, 108, 109, 110, 113, 114, 117, 119, 120, 123, 125, 126, 127, 128, 130, 132, 134, 136, 137, 139, 141, 144, 146, 147, 148, 156, 157, 158, 159, 160, 165, 166, 170, 171, 173, 174, 176, 177, 179, 180, 184, 192, 194, 196, 198, 199, 201, 202, 203, 204, 205, 207, 208, 209, 212, 213, 214, 218, 220, 224, 225, 227, 228, 230, 234, 235, 237, 238, 240, 241, 242, 243, 245, 246, 247, 249, 253, 254, 255, 256, 257, 260, 261, 266, 268, 269, 271, 272, 274, 275, 276, 282, 284, 286, 288, 289, 290, 293, 295, 297, 298, 300, 301, 303, 304, 305, 308, 311, 315, 316, 317, 318, 319, 322, 323, 324, 327, 328, 330, 333, 335, 339, 341, 343, 344, 345, 348, 351, 354, 356, 357, 358, 359, 360, 363, 364, 365, 368, 369, 371, 375, 376, 377, 378, 380, 384, 387, 389, 392, 394, 396, 402, 410, 411, 412, 414, 415, 416, 418, 420, 421, 422, 424, 425, 428, 429, 430, 434, 436, 437, 438, 446, 447, 448, 450, 453, 457, 458, 459, 462, 463, 467, 468, 470, 471, 472, 473, 476, 477, 478, 479, 480, 481, 482, 484, 485, 490, 492, 494, 497, 498, 504, 505, 511, 512, 514, 515, 516, 519, 521, 524, 525, 527, 528, 530, 531, 532, 533, 535, 538, 539, 540, 542, 543, 547, 548, 549, 550, 553, 555, 556, 558, 559, 561, 562, 564, 565, 566, 568, 569, 570, 574, 575, 577, 578, 580, 581, 582, 583, 585, 586, 588, 589, 590, 594, 595, 598, 599, 600, 601, 602, 605, 607, 609, 610, 611, 614, 618, 619, 620, 621, 622, 623, 625, 627, 628, 630, 631, 633, 635, 636, 637, 638, 639, 640, 641, 642, 644, 646, 648, 649, 652, 653, 657, 659, 660, 661, 662, 665, 668, 670, 672, 675, 678, 680, 681, 683, 684, 686, 687, 688, 694, 695, 696, 697, 699, 700, 701, 703, 706, 708, 709, 714, 715, 717, 718, 720, 724, 728, 730, 731, 732, 733, 735, 736, 737, 739, 740, 742, 745, 746, 747, 748, 749, 750, 752, 754, 755, 757, 758, 760, 764, 765, 766, 767, 771, 776, 787, 789, 790, 791, 793, 795, 797, 799, 800, 801, 802, 804, 805, 809, 811, 812, 813, 814, 815, 816, 818, 820, 821, 822, 823, 825, 828, 829, 834, 836, 838, 839, 841, 842, 843, 844, 847, 849, 853, 854, 855, 857, 858, 860, 861, 865, 868, 869, 870, 872, 873, 875, 877, 882, 883, 884, 885, 886, 888]
[9, 11, 29, 34, 41, 66, 67, 88, 94, 97, 99, 104, 124, 144, 145, 150, 170, 176, 183, 185, 194, 203, 236, 242, 244, 245, 247, 249, 252, 263, 287, 306, 309, 312, 315, 321, 325, 328, 333, 334, 337, 352, 358, 377, 380, 383, 388, 408, 415, 430, 434, 437, 443, 446, 454, 456, 459, 464, 465, 467, 474, 489, 501, 504, 513, 516, 517, 521, 533, 541, 545, 553, 557, 558, 561, 568, 598, 599, 611, 612, 613, 622, 628, 629, 644, 649, 650, 652, 653, 654, 660, 664, 670, 680, 689, 693, 694, 695, 702, 717, 718, 725, 740, 752, 753, 755, 770, 776, 781, 785, 790, 793, 794, 802, 835, 847, 850, 856, 866, 878, 879, 886]

[0, 1, 2, 3, 4, 5, 6, 8, 9, 10, 11, 12, 15, 19, 20, 21, 23, 24, 26, 28, 31, 32, 35, 36, 37, 38, 39, 41, 44, 45, 46, 47, 49, 50, 51, 52, 53, 55, 56, 60, 61, 63, 64, 66, 67, 70, 71, 73, 74, 76, 77, 82, 83, 84, 85, 87, 88, 90, 92, 93, 94, 96, 97, 98, 100, 101, 103, 104, 105, 108, 109, 110, 111, 113, 114, 116, 117, 118, 119, 120, 123, 125, 126, 127, 128, 130, 132, 134, 136, 137, 139, 141, 143, 144, 145, 146, 147, 148, 150, 153, 156, 157, 158, 159, 160, 161, 165, 166, 169, 170, 171, 173, 174, 176, 177, 179, 180, 184, 186, 192, 194, 196, 198, 199, 201, 202, 203, 204, 205, 207, 208, 209, 212, 213, 214, 215, 217, 218, 219, 220, 223, 224, 225, 227, 228, 230, 234, 235, 237, 238, 239, 240, 241, 242, 243, 244, 245, 246, 247, 249, 251, 253, 254, 255, 256, 257, 260, 261, 266, 268, 269, 271, 272, 274, 275, 276, 279, 282, 284, 286, 288, 289, 290, 293, 295, 297, 298, 300, 301, 303, 304, 305, 308, 310, 311, 315, 316, 317, 318, 319, 322, 323, 324, 327, 328, 330, 333, 335, 339, 341, 343, 344, 345, 348, 351, 354, 355, 356, 357, 358, 359, 360, 363, 364, 365, 368, 369, 371, 374, 375, 376, 377, 378, 380, 384, 386, 387, 389, 392, 394, 395, 396, 399, 402, 408, 409, 410, 411, 412, 413, 414, 415, 416, 418, 420, 421, 422, 424, 425, 427, 428, 429, 430, 432, 434, 435, 436, 437, 438, 441, 445, 446, 447, 448, 450, 453, 454, 457, 458, 459, 460, 462, 463, 465, 467, 468, 470, 471, 472, 473, 476, 477, 478, 479, 480, 481, 482, 484, 485, 486, 490, 492, 494, 497, 498, 500, 504, 505, 511, 512, 514, 515, 516, 519, 521, 524, 525, 527, 528, 530, 531, 532, 533, 535, 537, 538, 539, 540, 541, 542, 543, 547, 548, 549, 550, 553, 555, 556, 558, 559, 560, 561, 562, 564, 565, 566, 567, 568, 569, 570, 574, 575, 577, 578, 580, 581, 582, 583, 585, 586, 588, 589, 590, 591, 594, 595, 596, 598, 599, 600, 601, 602, 604, 605, 606, 607, 609, 610, 611, 613, 614, 618, 619, 620, 621, 622, 623, 624, 625, 627, 628, 630, 631, 633, 635, 636, 637, 638, 639, 640, 641, 642, 644, 646, 648, 649, 650, 652, 653, 657, 659, 660, 661, 662, 663, 665, 668, 670, 672, 674, 675, 676, 678, 680, 681, 683, 684, 686, 687, 688, 689, 694, 695, 696, 697, 699, 700, 701, 703, 706, 708, 709, 714, 715, 717, 718, 720, 721, 722, 724, 725, 728, 729, 730, 731, 732, 733, 735, 736, 737, 739, 740, 742, 743, 745, 746, 747, 748, 749, 750, 752, 754, 755, 756, 757, 758, 760, 764, 765, 766, 767, 771, 775, 776, 778, 780, 786, 787, 789, 790, 791, 793, 795, 797, 799, 800, 801, 802, 804, 805, 807, 808, 809, 810, 811, 812, 813, 814, 815, 816, 818, 820, 821, 822, 823, 825, 828, 829, 832, 834, 836, 838, 839, 841, 842, 843, 844, 845, 847, 849, 853, 854, 855, 857, 858, 859, 860, 861, 865, 868, 869, 870, 872, 873, 875, 877, 878, 882, 883, 884, 885, 886, 888]
[9, 11, 29, 34, 41, 66, 67, 88, 94, 97, 99, 104, 124, 144, 145, 150, 170, 176, 183, 185, 194, 203, 236, 242, 244, 245, 247, 249, 252, 263, 287, 306, 309, 312, 315, 321, 325, 328, 333, 334, 337, 352, 358, 377, 380, 383, 388, 408, 415, 430, 434, 437, 443, 446, 454, 456, 459, 464, 465, 467, 474, 489, 501, 504, 513, 516, 517, 521, 533, 541, 545, 553, 557, 558, 561, 568, 598, 599, 611, 612, 613, 622, 628, 629, 644, 649, 650, 652, 653, 654, 660, 664, 670, 680, 689, 693, 694, 695, 702, 717, 718, 725, 740, 752, 753, 755, 770, 776, 781, 785, 790, 793, 794, 802, 835, 847, 850, 856, 866, 878, 879, 886]

[0, 1, 2, 3, 4, 5, 6, 8, 9, 10, 11, 12, 14, 15, 17, 19, 20, 21, 23, 24, 25, 26, 28, 31, 32, 33, 35, 36, 37, 38, 39, 41, 44, 45, 46, 47, 49, 50, 51, 52, 53, 54, 55, 56, 60, 61, 63, 64, 66, 67, 70, 71, 73, 74, 76, 77, 82, 83, 84, 85, 87, 88, 90, 92, 93, 94, 96, 97, 98, 100, 101, 103, 104, 105, 106, 108, 109, 110, 111, 113, 114, 115, 116, 117, 118, 119, 120, 121, 123, 124, 125, 126, 127, 128, 130, 131, 132, 134, 135, 136, 137, 139, 141, 142, 143, 144, 145, 146, 147, 148, 150, 153, 156, 157, 158, 159, 160, 161, 162, 164, 165, 166, 169, 170, 171, 173, 174, 175, 176, 177, 179, 180, 184, 185, 186, 192, 194, 195, 196, 198, 199, 201, 202, 203, 204, 205, 207, 208, 209, 212, 213, 214, 215, 217, 218, 219, 220, 223, 224, 225, 227, 228, 229, 230, 232, 233, 234, 235, 237, 238, 239, 240, 241, 242, 243, 244, 245, 246, 247, 249, 251, 253, 254, 255, 256, 257, 258, 259, 260, 261, 264, 266, 268, 269, 270, 271, 272, 273, 274, 275, 276, 277, 279, 281, 282, 284, 285, 286, 288, 289, 290, 291, 293, 295, 297, 298, 300, 301, 303, 304, 305, 306, 308, 309, 310, 311, 315, 316, 317, 318, 319, 321, 322, 323, 324, 327, 328, 330, 333, 335, 336, 337, 339, 341, 343, 344, 345, 348, 351, 354, 355, 356, 357, 358, 359, 360, 362, 363, 364, 365, 368, 369, 371, 372, 374, 375, 376, 377, 378, 380, 382, 384, 386, 387, 389, 392, 394, 395, 396, 399, 402, 406, 408, 409, 410, 411, 412, 413, 414, 415, 416, 418, 420, 421, 422, 423, 424, 425, 427, 428, 429, 430, 432, 434, 435, 436, 437, 438, 441, 443, 445, 446, 447, 448, 450, 451, 452, 453, 454, 457, 458, 459, 460, 461, 462, 463, 465, 467, 468, 470, 471, 472, 473, 476, 477, 478, 479, 480, 481, 482, 484, 485, 486, 488, 490, 492, 494, 496, 497, 498, 499, 500, 501, 504, 505, 509, 511, 512, 514, 515, 516, 517, 519, 521, 522, 524, 525, 527, 528, 530, 531, 532, 533, 535, 537, 538, 539, 540, 541, 542, 543, 547, 548, 549, 550, 553, 555, 556, 557, 558, 559, 560, 561, 562, 563, 564, 565, 566, 567, 568, 569, 570, 574, 575, 577, 578, 580, 581, 582, 583, 585, 586, 588, 589, 590, 591, 593, 594, 595, 596, 598, 599, 600, 601, 602, 604, 605, 606, 607, 609, 610, 611, 613, 614, 618, 619, 620, 621, 622, 623, 624, 625, 627, 628, 629, 630, 631, 633, 635, 636, 637, 638, 639, 640, 641, 642, 644, 645, 646, 648, 649, 650, 652, 653, 657, 659, 660, 661, 662, 663, 664, 665, 668, 670, 671, 672, 674, 675, 676, 678, 680, 681, 683, 684, 686, 687, 688, 689, 691, 692, 693, 694, 695, 696, 697, 699, 700, 701, 703, 704, 706, 708, 709, 712, 714, 715, 717, 718, 720, 721, 722, 724, 725, 728, 729, 730, 731, 732, 733, 735, 736, 737, 739, 740, 742, 743, 744, 745, 746, 747, 748, 749, 750, 752, 754, 755, 756, 757, 758, 760, 764, 765, 766, 767, 770, 771, 773, 774, 775, 776, 778, 780, 782, 786, 787, 789, 790, 791, 793, 795, 797, 798, 799, 800, 801, 802, 804, 805, 807, 808, 809, 810, 811, 812, 813, 814, 815, 816, 817, 818, 819, 820, 821, 822, 823, 825, 828, 829, 832, 833, 834, 836, 838, 839, 841, 842, 843, 844, 845, 847, 849, 851, 853, 854, 855, 857, 858, 859, 860, 861, 865, 868, 869, 870, 872, 873, 875, 877, 878, 880, 881, 882, 883, 884, 885, 886, 888, 889]
[9, 11, 29, 34, 41, 66, 67, 88, 94, 97, 99, 104, 124, 144, 145, 150, 170, 176, 183, 185, 194, 203, 236, 242, 244, 245, 247, 249, 252, 263, 287, 306, 309, 312, 315, 321, 325, 328, 333, 334, 337, 352, 358, 377, 380, 383, 388, 408, 415, 430, 434, 437, 443, 446, 454, 456, 459, 464, 465, 467, 474, 489, 501, 504, 513, 516, 517, 521, 533, 541, 545, 553, 557, 558, 561, 568, 598, 599, 611, 612, 613, 622, 628, 629, 644, 649, 650, 652, 653, 654, 660, 664, 670, 680, 689, 693, 694, 695, 702, 717, 718, 725, 740, 752, 753, 755, 770, 776, 781, 785, 790, 793, 794, 802, 835, 847, 850, 856, 866, 878, 879, 886]

[0, 1, 2, 3, 4, 5, 6, 8, 9, 10, 11, 12, 13, 14, 15, 17, 19, 20, 21, 23, 24, 25, 26, 28, 30, 31, 32, 33, 35, 36, 37, 38, 39, 41, 42, 44, 45, 46, 47, 49, 50, 51, 52, 53, 54, 55, 56, 60, 61, 63, 64, 66, 67, 69, 70, 71, 73, 74, 76, 77, 81, 82, 83, 84, 85, 87, 88, 90, 91, 92, 93, 94, 95, 96, 97, 98, 100, 101, 103, 104, 105, 106, 108, 109, 110, 111, 112, 113, 114, 115, 116, 117, 118, 119, 120, 121, 122, 123, 124, 125, 126, 127, 128, 130, 131, 132, 133, 134, 135, 136, 137, 139, 141, 142, 143, 144, 145, 146, 147, 148, 149, 150, 152, 153, 155, 156, 157, 158, 159, 160, 161, 162, 164, 165, 166, 167, 168, 169, 170, 171, 173, 174, 175, 176, 177, 179, 180, 184, 185, 186, 192, 194, 195, 196, 197, 198, 199, 201, 202, 203, 204, 205, 207, 208, 209, 211, 212, 213, 214, 215, 217, 218, 219, 220, 222, 223, 224, 225, 227, 228, 229, 230, 231, 232, 233, 234, 235, 236, 237, 238, 239, 240, 241, 242, 243, 244, 245, 246, 247, 249, 250, 251, 253, 254, 255, 256, 257, 258, 259, 260, 261, 263, 264, 266, 268, 269, 270, 271, 272, 273, 274, 275, 276, 277, 279, 281, 282, 283, 284, 285, 286, 287, 288, 289, 290, 291, 293, 295, 297, 298, 300, 301, 303, 304, 305, 306, 308, 309, 310, 311, 315, 316, 317, 318, 319, 321, 322, 323, 324, 325, 327, 328, 330, 333, 335, 336, 337, 339, 341, 343, 344, 345, 346, 347, 348, 351, 354, 355, 356, 357, 358, 359, 360, 361, 362, 363, 364, 365, 366, 368, 369, 371, 372, 373, 374, 375, 376, 377, 378, 380, 382, 384, 385, 386, 387, 389, 392, 394, 395, 396, 399, 402, 404, 406, 407, 408, 409, 410, 411, 412, 413, 414, 415, 416, 417, 418, 420, 421, 422, 423, 424, 425, 426, 427, 428, 429, 430, 432, 433, 434, 435, 436, 437, 438, 441, 443, 445, 446, 447, 448, 449, 450, 451, 452, 453, 454, 457, 458, 459, 460, 461, 462, 463, 465, 467, 468, 470, 471, 472, 473, 476, 477, 478, 479, 480, 481, 482, 484, 485, 486, 488, 490, 492, 493, 494, 496, 497, 498, 499, 500, 501, 502, 504, 505, 509, 511, 512, 514, 515, 516, 517, 518, 519, 520, 521, 522, 524, 525, 527, 528, 529, 530, 531, 532, 533, 535, 537, 538, 539, 540, 541, 542, 543, 546, 547, 548, 549, 550, 551, 553, 554, 555, 556, 557, 558, 559, 560, 561, 562, 563, 564, 565, 566, 567, 568, 569, 570, 573, 574, 575, 577, 578, 580, 581, 582, 583, 584, 585, 586, 588, 589, 590, 591, 592, 593, 594, 595, 596, 598, 599, 600, 601, 602, 604, 605, 606, 607, 608, 609, 610, 611, 612, 613, 614, 616, 617, 618, 619, 620, 621, 622, 623, 624, 625, 627, 628, 629, 630, 631, 633, 634, 635, 636, 637, 638, 639, 640, 641, 642, 644, 645, 646, 648, 649, 650, 652, 653, 657, 659, 660, 661, 662, 663, 664, 665, 667, 668, 670, 671, 672, 674, 675, 676, 678, 680, 681, 683, 684, 686, 687, 688, 689, 691, 692, 693, 694, 695, 696, 697, 699, 700, 701, 703, 704, 706, 708, 709, 710, 711, 712, 713, 714, 715, 716, 717, 718, 720, 721, 722, 724, 725, 727, 728, 729, 730, 731, 732, 733, 734, 735, 736, 737, 739, 740, 742, 743, 744, 745, 746, 747, 748, 749, 750, 752, 754, 755, 756, 757, 758, 760, 762, 764, 765, 766, 767, 769, 770, 771, 772, 773, 774, 775, 776, 778, 780, 782, 784, 785, 786, 787, 789, 790, 791, 792, 793, 795, 797, 798, 799, 800, 801, 802, 803, 804, 805, 806, 807, 808, 809, 810, 811, 812, 813, 814, 815, 816, 817, 818, 819, 820, 821, 822, 823, 825, 826, 827, 828, 829, 832, 833, 834, 836, 838, 839, 841, 842, 843, 844, 845, 846, 847, 849, 851, 853, 854, 855, 856, 857, 858, 859, 860, 861, 863, 865, 867, 868, 869, 870, 872, 873, 875, 877, 878, 879, 880, 881, 882, 883, 884, 885, 886, 888, 889]
[9, 11, 29, 34, 41, 66, 67, 88, 94, 97, 99, 104, 124, 144, 145, 150, 170, 176, 183, 185, 194, 203, 236, 242, 244, 245, 247, 249, 252, 263, 287, 306, 309, 312, 315, 321, 325, 328, 333, 334, 337, 352, 358, 377, 380, 383, 388, 408, 415, 430, 434, 437, 443, 446, 454, 456, 459, 464, 465, 467, 474, 489, 501, 504, 513, 516, 517, 521, 533, 541, 545, 553, 557, 558, 561, 568, 598, 599, 611, 612, 613, 622, 628, 629, 644, 649, 650, 652, 653, 654, 660, 664, 670, 680, 689, 693, 694, 695, 702, 717, 718, 725, 740, 752, 753, 755, 770, 776, 781, 785, 790, 793, 794, 802, 835, 847, 850, 856, 866, 878, 879, 886]

[0, 1, 2, 3, 4, 5, 6, 7, 8, 9, 10, 11, 12, 13, 14, 15, 16, 17, 18, 19, 20, 21, 23, 24, 25, 26, 27, 28, 30, 31, 32, 33, 35, 36, 37, 38, 39, 41, 42, 43, 44, 45, 46, 47, 49, 50, 51, 52, 53, 54, 55, 56, 60, 61, 63, 64, 66, 67, 69, 70, 71, 72, 73, 74, 75, 76, 77, 80, 81, 82, 83, 84, 85, 87, 88, 90, 91, 92, 93, 94, 95, 96, 97, 98, 100, 101, 103, 104, 105, 106, 108, 109, 110, 111, 112, 113, 114, 115, 116, 117, 118, 119, 120, 121, 122, 123, 124, 125, 126, 127, 128, 130, 131, 132, 133, 134, 135, 136, 137, 138, 139, 141, 142, 143, 144, 145, 146, 147, 148, 149, 150, 151, 152, 153, 154, 155, 156, 157, 158, 159, 160, 161, 162, 164, 165, 166, 167, 168, 169, 170, 171, 172, 173, 174, 175, 176, 177, 178, 179, 180, 181, 182, 183, 184, 185, 186, 187, 190, 192, 194, 195, 196, 197, 198, 199, 201, 202, 203, 204, 205, 207, 208, 209, 210, 211, 212, 213, 214, 215, 217, 218, 219, 220, 221, 222, 223, 224, 225, 226, 227, 228, 229, 230, 231, 232, 233, 234, 235, 236, 237, 238, 239, 240, 241, 242, 243, 244, 245, 246, 247, 249, 250, 251, 253, 254, 255, 256, 257, 258, 259, 260, 261, 263, 264, 266, 268, 269, 270, 271, 272, 273, 274, 275, 276, 277, 278, 279, 280, 281, 282, 283, 284, 285, 286, 287, 288, 289, 290, 291, 293, 295, 296, 297, 298, 300, 301, 302, 303, 304, 305, 306, 307, 308, 309, 310, 311, 312, 315, 316, 317, 318, 319, 321, 322, 323, 324, 325, 327, 328, 330, 332, 333, 335, 336, 337, 338, 339, 341, 342, 343, 344, 345, 346, 347, 348, 349, 350, 351, 353, 354, 355, 356, 357, 358, 359, 360, 361, 362, 363, 364, 365, 366, 368, 369, 370, 371, 372, 373, 374, 375, 376, 377, 378, 380, 381, 382, 384, 385, 386, 387, 388, 389, 390, 392, 393, 394, 395, 396, 397, 399, 402, 404, 406, 407, 408, 409, 410, 411, 412, 413, 414, 415, 416, 417, 418, 419, 420, 421, 422, 423, 424, 425, 426, 427, 428, 429, 430, 431, 432, 433, 434, 435, 436, 437, 438, 441, 443, 445, 446, 447, 448, 449, 450, 451, 452, 453, 454, 457, 458, 459, 460, 461, 462, 463, 464, 465, 467, 468, 470, 471, 472, 473, 476, 477, 478, 479, 480, 481, 482, 483, 484, 485, 486, 488, 489, 490, 491, 492, 493, 494, 495, 496, 497, 498, 499, 500, 501, 502, 504, 505, 506, 509, 511, 512, 513, 514, 515, 516, 517, 518, 519, 520, 521, 522, 524, 525, 526, 527, 528, 529, 530, 531, 532, 533, 534, 535, 537, 538, 539, 540, 541, 542, 543, 546, 547, 548, 549, 550, 551, 552, 553, 554, 555, 556, 557, 558, 559, 560, 561, 562, 563, 564, 565, 566, 567, 568, 569, 570, 571, 572, 573, 574, 575, 577, 578, 580, 581, 582, 583, 584, 585, 586, 588, 589, 590, 591, 592, 593, 594, 595, 596, 598, 599, 600, 601, 602, 604, 605, 606, 607, 608, 609, 610, 611, 612, 613, 614, 615, 616, 617, 618, 619, 620, 621, 622, 623, 624, 625, 627, 628, 629, 630, 631, 633, 634, 635, 636, 637, 638, 639, 640, 641, 642, 644, 645, 646, 647, 648, 649, 650, 652, 653, 655, 657, 658, 659, 660, 661, 662, 663, 664, 665, 667, 668, 670, 671, 672, 674, 675, 676, 677, 678, 679, 680, 681, 683, 684, 686, 687, 688, 689, 691, 692, 693, 694, 695, 696, 697, 699, 700, 701, 703, 704, 706, 708, 709, 710, 711, 712, 713, 714, 715, 716, 717, 718, 720, 721, 722, 724, 725, 727, 728, 729, 730, 731, 732, 733, 734, 735, 736, 737, 738, 739, 740, 741, 742, 743, 744, 745, 746, 747, 748, 749, 750, 752, 754, 755, 756, 757, 758, 759, 760, 762, 764, 765, 766, 767, 768, 769, 770, 771, 772, 773, 774, 775, 776, 778, 780, 782, 784, 785, 786, 787, 788, 789, 790, 791, 792, 793, 795, 797, 798, 799, 800, 801, 802, 803, 804, 805, 806, 807, 808, 809, 810, 811, 812, 813, 814, 815, 816, 817, 818, 819, 820, 821, 822, 823, 824, 825, 826, 827, 828, 829, 832, 833, 834, 835, 836, 837, 838, 839, 840, 841, 842, 843, 844, 845, 846, 847, 848, 849, 850, 851, 852, 853, 854, 855, 856, 857, 858, 859, 860, 861, 863, 865, 866, 867, 868, 869, 870, 871, 872, 873, 874, 875, 876, 877, 878, 879, 880, 881, 882, 883, 884, 885, 886, 888, 889]
[9, 11, 29, 34, 41, 66, 67, 88, 94, 97, 99, 104, 124, 144, 145, 150, 170, 176, 183, 185, 194, 203, 236, 242, 244, 245, 247, 249, 252, 263, 287, 306, 309, 312, 315, 321, 325, 328, 333, 334, 337, 352, 358, 377, 380, 383, 388, 408, 415, 430, 434, 437, 443, 446, 454, 456, 459, 464, 465, 467, 474, 489, 501, 504, 513, 516, 517, 521, 533, 541, 545, 553, 557, 558, 561, 568, 598, 599, 611, 612, 613, 622, 628, 629, 644, 649, 650, 652, 653, 654, 660, 664, 670, 680, 689, 693, 694, 695, 702, 717, 718, 725, 740, 752, 753, 755, 770, 776, 781, 785, 790, 793, 794, 802, 835, 847, 850, 856, 866, 878, 879, 886]

