[41, 56, 61, 324, 339, 353, 387, 441, 474, 475, 491, 534, 576, 602, 676, 679, 732, 762, 791, 792, 804, 838]
[31, 135, 154, 165, 220, 257, 384, 389, 404, 435, 445, 457, 481, 504, 516, 526, 549, 567, 599, 603, 710, 866]

[41, 56, 61, 324, 339, 353, 387, 441, 474, 475, 491, 534, 576, 602, 676, 679, 732, 762, 791, 792, 804, 838]
[5, 8, 10, 17, 31, 32, 33, 42, 46, 68, 72, 80, 91, 104, 109, 116, 117, 120, 121, 129, 133, 135, 143, 154, 159, 163, 165, 169, 172, 192, 193, 202, 209, 220, 222, 235, 238, 257, 259, 292, 312, 376, 378, 384, 385, 388, 389, 391, 394, 397, 404, 405, 428, 430, 435, 436, 445, 457, 458, 478, 481, 490, 498, 504, 510, 516, 524, 526, 548, 549, 553, 558, 559, 567, 569, 573, 574, 594, 597, 599, 603, 629, 635, 637, 641, 645, 647, 664, 666, 667, 671, 680, 681, 704, 710, 717, 719, 728, 729, 753, 760, 767, 768, 769, 772, 774, 790, 795, 798, 803, 815, 820, 845, 847, 850, 860, 866, 876, 877, 878, 883, 884]

[1, 3, 11, 13, 41, 44, 56, 61, 69, 75, 79, 91, 97, 105, 117, 118, 136, 153, 160, 161, 187, 188, 198, 204, 205, 209, 223, 238, 268, 275, 281, 290, 292, 310, 313, 320, 324, 326, 338, 339, 351, 352, 353, 387, 395, 397, 421, 427, 441, 474, 475, 491, 497, 498, 521, 522, 527, 534, 536, 537, 543, 576, 580, 602, 629, 633, 676, 679, 695, 706, 714, 731, 732, 748, 752, 761, 762, 767, 778, 786, 791, 792, 799, 804, 817, 821, 823, 825, 838, 847, 850, 852, 854, 857, 861, 862, 883]
[5, 8, 10, 17, 31, 32, 33, 42, 46, 68, 72, 80, 91, 104, 109, 116, 117, 120, 121, 129, 133, 135, 143, 154, 159, 163, 165, 169, 172, 192, 193, 202, 209, 220, 222, 235, 238, 257, 259, 292, 312, 376, 378, 384, 385, 388, 389, 391, 394, 397, 404, 405, 428, 430, 435, 436, 445, 457, 458, 478, 481, 490, 498, 504, 510, 516, 524, 526, 548, 549, 553, 558, 559, 567, 569, 573, 574, 594, 597, 599, 603, 629, 635, 637, 641, 645, 647, 664, 666, 667, 671, 680, 681, 704, 710, 717, 719, 728, 729, 753, 760, 767, 768, 769, 772, 774, 790, 795, 798, 803, 815, 820, 845, 847, 850, 860, 866, 876, 877, 878, 883, 884]

[1, 3, 11, 13, 18, 41, 42, 44, 56, 59, 61, 62, 69, 73, 75, 79, 89, 91, 97, 102, 103, 105, 106, 117, 118, 122, 129, 130, 132, 136, 150, 153, 160, 161, 182, 187, 188, 194, 198, 201, 204, 205, 209, 223, 226, 235, 236, 238, 241, 248, 249, 266, 268, 272, 274, 275, 279, 281, 290, 292, 307, 310, 311, 313, 320, 324, 326, 332, 338, 339, 343, 351, 352, 353, 365, 366, 374, 376, 387, 389, 392, 395, 397, 417, 421, 427, 428, 438, 441, 445, 454, 459, 474, 475, 479, 481, 491, 497, 498, 499, 510, 521, 522, 527, 530, 534, 536, 537, 543, 546, 576, 580, 600, 602, 619, 629, 633, 642, 659, 661, 669, 676, 679, 680, 681, 684, 692, 695, 697, 699, 705, 706, 714, 731, 732, 733, 748, 752, 758, 760, 761, 762, 767, 778, 786, 791, 792, 799, 803, 804, 817, 821, 823, 825, 826, 827, 828, 831, 838, 842, 847, 850, 852, 854, 857, 858, 861, 862, 873, 876, 877, 883]
[5, 8, 10, 17, 31, 32, 33, 42, 46, 68, 72, 80, 91, 104, 109, 116, 117, 120, 121, 129, 133, 135, 143, 154, 159, 163, 165, 169, 172, 192, 193, 202, 209, 220, 222, 235, 238, 257, 259, 292, 312, 376, 378, 384, 385, 388, 389, 391, 394, 397, 404, 405, 428, 430, 435, 436, 445, 457, 458, 478, 481, 490, 498, 504, 510, 516, 524, 526, 548, 549, 553, 558, 559, 567, 569, 573, 574, 594, 597, 599, 603, 629, 635, 637, 641, 645, 647, 664, 666, 667, 671, 680, 681, 704, 710, 717, 719, 728, 729, 753, 760, 767, 768, 769, 772, 774, 790, 795, 798, 803, 815, 820, 845, 847, 850, 860, 866, 876, 877, 878, 883, 884]

[1, 3, 4, 11, 13, 17, 18, 20, 21, 33, 39, 40, 41, 42, 44, 50, 53, 56, 59, 60, 61, 62, 67, 69, 71, 73, 75, 79, 89, 91, 97, 99, 102, 103, 105, 106, 112, 117, 118, 122, 125, 129, 130, 132, 133, 136, 143, 150, 153, 154, 160, 161, 164, 171, 182, 187, 188, 189, 191, 194, 198, 201, 204, 205, 207, 209, 213, 219, 221, 223, 226, 227, 235, 236, 238, 241, 243, 246, 248, 249, 266, 267, 268, 269, 272, 274, 275, 279, 281, 287, 290, 292, 294, 307, 310, 311, 312, 313, 320, 324, 325, 326, 330, 332, 338, 339, 340, 343, 351, 352, 353, 365, 366, 374, 376, 387, 389, 392, 393, 395, 396, 397, 399, 400, 415, 416, 417, 421, 427, 428, 431, 438, 441, 445, 454, 459, 465, 473, 474, 475, 479, 481, 482, 491, 497, 498, 499, 501, 510, 521, 522, 527, 530, 534, 536, 537, 541, 543, 546, 548, 576, 577, 580, 583, 589, 600, 602, 610, 614, 619, 624, 627, 629, 633, 642, 643, 659, 661, 669, 670, 672, 676, 679, 680, 681, 684, 692, 695, 697, 699, 705, 706, 714, 724, 731, 732, 733, 739, 748, 752, 754, 756, 757, 758, 760, 761, 762, 765, 767, 768, 778, 786, 791, 792, 799, 803, 804, 805, 808, 809, 817, 821, 823, 825, 826, 827, 828, 831, 834, 836, 838, 839, 842, 847, 850, 851, 852, 854, 857, 858, 861, 862, 873, 876, 877, 883, 884]
[5, 8, 10, 17, 31, 32, 33, 42, 46, 68, 72, 80, 91, 104, 109, 116, 117, 120, 121, 129, 133, 135, 143, 154, 159, 163, 165, 169, 172, 192, 193, 202, 209, 220, 222, 235, 238, 257, 259, 292, 312, 376, 378, 384, 385, 388, 389, 391, 394, 397, 404, 405, 428, 430, 435, 436, 445, 457, 458, 478, 481, 490, 498, 504, 510, 516, 524, 526, 548, 549, 553, 558, 559, 567, 569, 573, 574, 594, 597, 599, 603, 629, 635, 637, 641, 645, 647, 664, 666, 667, 671, 680, 681, 704, 710, 717, 719, 728, 729, 753, 760, 767, 768, 769, 772, 774, 790, 795, 798, 803, 815, 820, 845, 847, 850, 860, 866, 876, 877, 878, 883, 884]

[1, 3, 4, 6, 8, 11, 13, 17, 18, 20, 21, 33, 39, 40, 41, 42, 43, 44, 49, 50, 53, 54, 56, 59, 60, 61, 62, 67, 69, 71, 73, 75, 79, 89, 91, 97, 99, 102, 103, 104, 105, 106, 111, 112, 117, 118, 119, 122, 125, 126, 128, 129, 130, 132, 133, 134, 136, 137, 139, 143, 146, 150, 152, 153, 154, 159, 160, 161, 163, 164, 171, 173, 175, 180, 182, 185, 187, 188, 189, 191, 194, 197, 198, 200, 201, 204, 205, 207, 209, 213, 219, 221, 223, 226, 227, 228, 232, 235, 236, 237, 238, 240, 241, 243, 246, 248, 249, 250, 256, 266, 267, 268, 269, 271, 272, 274, 275, 279, 281, 287, 290, 291, 292, 294, 307, 310, 311, 312, 313, 320, 324, 325, 326, 330, 332, 338, 339, 340, 342, 343, 351, 352, 353, 365, 366, 371, 374, 375, 376, 378, 381, 387, 389, 392, 393, 395, 396, 397, 399, 400, 409, 415, 416, 417, 421, 422, 427, 428, 431, 438, 441, 442, 443, 444, 445, 454, 459, 463, 465, 472, 473, 474, 475, 479, 481, 482, 490, 491, 496, 497, 498, 499, 501, 510, 512, 521, 522, 527, 530, 533, 534, 536, 537, 541, 542, 543, 546, 548, 551, 557, 558, 560, 562, 564, 576, 577, 580, 583, 589, 590, 592, 600, 602, 610, 614, 619, 624, 627, 629, 632, 633, 637, 642, 643, 653, 654, 659, 661, 669, 670, 672, 676, 679, 680, 681, 684, 687, 688, 692, 695, 697, 699, 705, 706, 714, 715, 724, 728, 731, 732, 733, 736, 739, 748, 749, 751, 752, 754, 756, 757, 758, 760, 761, 762, 764, 765, 767, 768, 778, 785, 786, 787, 791, 792, 799, 803, 804, 805, 808, 809, 817, 821, 823, 825, 826, 827, 828, 830, 831, 834, 836, 838, 839, 840, 842, 847, 850, 851, 852, 854, 857, 858, 861, 862, 863, 871, 873, 875, 876, 877, 883, 884]
[5, 8, 10, 17, 31, 32, 33, 42, 46, 68, 72, 80, 91, 104, 109, 116, 117, 120, 121, 129, 133, 135, 143, 154, 159, 163, 165, 169, 172, 192, 193, 202, 209, 220, 222, 235, 238, 257, 259, 292, 312, 376, 378, 384, 385, 388, 389, 391, 394, 397, 404, 405, 428, 430, 435, 436, 445, 457, 458, 478, 481, 490, 498, 504, 510, 516, 524, 526, 548, 549, 553, 558, 559, 567, 569, 573, 574, 594, 597, 599, 603, 629, 635, 637, 641, 645, 647, 664, 666, 667, 671, 680, 681, 704, 710, 717, 719, 728, 729, 753, 760, 767, 768, 769, 772, 774, 790, 795, 798, 803, 815, 820, 845, 847, 850, 860, 866, 876, 877, 878, 883, 884]

[1, 3, 4, 6, 8, 11, 13, 16, 17, 18, 19, 20, 21, 27, 33, 39, 40, 41, 42, 43, 44, 49, 50, 53, 54, 56, 59, 60, 61, 62, 63, 67, 69, 71, 72, 73, 75, 79, 84, 89, 91, 92, 93, 97, 99, 102, 103, 104, 105, 106, 111, 112, 117, 118, 119, 122, 125, 126, 128, 129, 130, 132, 133, 134, 136, 137, 139, 143, 146, 148, 150, 151, 152, 153, 154, 156, 159, 160, 161, 163, 164, 165, 171, 173, 175, 180, 182, 185, 186, 187, 188, 189, 191, 194, 197, 198, 200, 201, 204, 205, 207, 209, 213, 219, 221, 223, 226, 227, 228, 232, 235, 236, 237, 238, 240, 241, 242, 243, 246, 248, 249, 250, 256, 259, 263, 266, 267, 268, 269, 271, 272, 274, 275, 279, 281, 287, 289, 290, 291, 292, 294, 307, 308, 309, 310, 311, 312, 313, 315, 320, 323, 324, 325, 326, 327, 330, 332, 338, 339, 340, 342, 343, 344, 348, 351, 352, 353, 355, 356, 363, 365, 366, 369, 371, 374, 375, 376, 378, 381, 382, 387, 388, 389, 392, 393, 395, 396, 397, 399, 400, 406, 409, 410, 411, 415, 416, 417, 420, 421, 422, 423, 424, 427, 428, 431, 433, 435, 438, 441, 442, 443, 444, 445, 447, 452, 454, 458, 459, 463, 465, 469, 472, 473, 474, 475, 479, 481, 482, 488, 489, 490, 491, 496, 497, 498, 499, 501, 509, 510, 512, 513, 521, 522, 527, 528, 530, 533, 534, 536, 537, 538, 541, 542, 543, 546, 548, 551, 553, 557, 558, 560, 562, 564, 567, 576, 577, 580, 583, 584, 589, 590, 592, 593, 600, 602, 610, 614, 619, 620, 624, 627, 629, 632, 633, 637, 639, 642, 643, 653, 654, 657, 659, 661, 669, 670, 672, 674, 676, 679, 680, 681, 684, 687, 688, 692, 695, 697, 699, 704, 705, 706, 714, 715, 724, 725, 728, 731, 732, 733, 734, 736, 739, 740, 748, 749, 751, 752, 754, 756, 757, 758, 760, 761, 762, 763, 764, 765, 767, 768, 770, 772, 778, 785, 786, 787, 791, 792, 798, 799, 800, 802, 803, 804, 805, 808, 809, 813, 817, 820, 821, 823, 825, 826, 827, 828, 830, 831, 834, 836, 838, 839, 840, 842, 847, 848, 850, 851, 852, 854, 857, 858, 860, 861, 862, 863, 865, 871, 872, 873, 875, 876, 877, 879, 880, 883, 884, 885]
[5, 8, 10, 17, 31, 32, 33, 42, 46, 68, 72, 80, 91, 104, 109, 116, 117, 120, 121, 129, 133, 135, 143, 154, 159, 163, 165, 169, 172, 192, 193, 202, 209, 220, 222, 235, 238, 257, 259, 292, 312, 376, 378, 384, 385, 388, 389, 391, 394, 397, 404, 405, 428, 430, 435, 436, 445, 457, 458, 478, 481, 490, 498, 504, 510, 516, 524, 526, 548, 549, 553, 558, 559, 567, 569, 573, 574, 594, 597, 599, 603, 629, 635, 637, 641, 645, 647, 664, 666, 667, 671, 680, 681, 704, 710, 717, 719, 728, 729, 753, 760, 767, 768, 769, 772, 774, 790, 795, 798, 803, 815, 820, 845, 847, 850, 860, 866, 876, 877, 878, 883, 884]

[1, 3, 4, 6, 8, 11, 13, 15, 16, 17, 18, 19, 20, 21, 27, 28, 33, 35, 39, 40, 41, 42, 43, 44, 47, 49, 50, 51, 53, 54, 56, 59, 60, 61, 62, 63, 67, 68, 69, 71, 72, 73, 74, 75, 78, 79, 84, 89, 91, 92, 93, 97, 99, 102, 103, 104, 105, 106, 107, 111, 112, 114, 117, 118, 119, 122, 125, 126, 128, 129, 130, 132, 133, 134, 136, 137, 139, 143, 145, 146, 148, 149, 150, 151, 152, 153, 154, 155, 156, 159, 160, 161, 163, 164, 165, 171, 173, 175, 179, 180, 182, 184, 185, 186, 187, 188, 189, 191, 194, 197, 198, 200, 201, 204, 205, 207, 209, 212, 213, 214, 215, 219, 220, 221, 223, 226, 227, 228, 232, 235, 236, 237, 238, 240, 241, 242, 243, 246, 247, 248, 249, 250, 253, 256, 258, 259, 260, 262, 263, 266, 267, 268, 269, 271, 272, 274, 275, 278, 279, 281, 282, 287, 289, 290, 291, 292, 294, 295, 296, 307, 308, 309, 310, 311, 312, 313, 315, 320, 323, 324, 325, 326, 327, 330, 332, 337, 338, 339, 340, 341, 342, 343, 344, 346, 348, 351, 352, 353, 355, 356, 363, 365, 366, 369, 371, 374, 375, 376, 378, 379, 381, 382, 387, 388, 389, 392, 393, 395, 396, 397, 399, 400, 403, 406, 407, 409, 410, 411, 415, 416, 417, 420, 421, 422, 423, 424, 427, 428, 431, 433, 435, 436, 438, 441, 442, 443, 444, 445, 447, 452, 454, 458, 459, 463, 464, 465, 469, 472, 473, 474, 475, 479, 481, 482, 484, 488, 489, 490, 491, 492, 496, 497, 498, 499, 501, 503, 508, 509, 510, 512, 513, 519, 521, 522, 525, 527, 528, 530, 532, 533, 534, 535, 536, 537, 538, 541, 542, 543, 546, 548, 551, 553, 557, 558, 560, 562, 564, 567, 572, 576, 577, 580, 583, 584, 588, 589, 590, 591, 592, 593, 596, 599, 600, 602, 606, 608, 610, 614, 619, 620, 624, 627, 629, 632, 633, 637, 639, 640, 642, 643, 646, 648, 649, 650, 653, 654, 657, 659, 661, 665, 669, 670, 672, 674, 676, 678, 679, 680, 681, 684, 687, 688, 691, 692, 695, 697, 699, 701, 703, 704, 705, 706, 710, 714, 715, 723, 724, 725, 728, 731, 732, 733, 734, 736, 739, 740, 743, 747, 748, 749, 751, 752, 754, 756, 757, 758, 760, 761, 762, 763, 764, 765, 767, 768, 769, 770, 772, 778, 785, 786, 787, 791, 792, 793, 794, 798, 799, 800, 802, 803, 804, 805, 808, 809, 813, 815, 817, 820, 821, 823, 824, 825, 826, 827, 828, 830, 831, 834, 836, 837, 838, 839, 840, 842, 847, 848, 850, 851, 852, 853, 854, 855, 857, 858, 860, 861, 862, 863, 864, 865, 871, 872, 873, 875, 876, 877, 879, 880, 883, 884, 885, 889]
[5, 8, 10, 17, 31, 32, 33, 42, 46, 68, 72, 80, 91, 104, 109, 116, 117, 120, 121, 129, 133, 135, 143, 154, 159, 163, 165, 169, 172, 192, 193, 202, 209, 220, 222, 235, 238, 257, 259, 292, 312, 376, 378, 384, 385, 388, 389, 391, 394, 397, 404, 405, 428, 430, 435, 436, 445, 457, 458, 478, 481, 490, 498, 504, 510, 516, 524, 526, 548, 549, 553, 558, 559, 567, 569, 573, 574, 594, 597, 599, 603, 629, 635, 637, 641, 645, 647, 664, 666, 667, 671, 680, 681, 704, 710, 717, 719, 728, 729, 753, 760, 767, 768, 769, 772, 774, 790, 795, 798, 803, 815, 820, 845, 847, 850, 860, 866, 876, 877, 878, 883, 884]

[1, 3, 4, 6, 8, 11, 13, 15, 16, 17, 18, 19, 20, 21, 25, 27, 28, 33, 35, 39, 40, 41, 42, 43, 44, 46, 47, 49, 50, 51, 53, 54, 56, 59, 60, 61, 62, 63, 65, 67, 68, 69, 70, 71, 72, 73, 74, 75, 78, 79, 81, 84, 85, 88, 89, 91, 92, 93, 95, 97, 99, 102, 103, 104, 105, 106, 107, 110, 111, 112, 114, 117, 118, 119, 122, 124, 125, 126, 127, 128, 129, 130, 131, 132, 133, 134, 135, 136, 137, 139, 143, 144, 145, 146, 148, 149, 150, 151, 152, 153, 154, 155, 156, 159, 160, 161, 163, 164, 165, 166, 167, 169, 171, 173, 175, 179, 180, 181, 182, 184, 185, 186, 187, 188, 189, 191, 194, 197, 198, 200, 201, 204, 205, 207, 209, 210, 212, 213, 214, 215, 219, 220, 221, 223, 224, 225, 226, 227, 228, 232, 233, 234, 235, 236, 237, 238, 240, 241, 242, 243, 246, 247, 248, 249, 250, 251, 253, 256, 258, 259, 260, 262, 263, 265, 266, 267, 268, 269, 270, 271, 272, 274, 275, 278, 279, 281, 282, 287, 289, 290, 291, 292, 294, 295, 296, 298, 307, 308, 309, 310, 311, 312, 313, 315, 316, 318, 320, 322, 323, 324, 325, 326, 327, 329, 330, 332, 334, 337, 338, 339, 340, 341, 342, 343, 344, 346, 348, 349, 351, 352, 353, 354, 355, 356, 363, 365, 366, 369, 371, 374, 375, 376, 378, 379, 380, 381, 382, 384, 387, 388, 389, 392, 393, 395, 396, 397, 399, 400, 403, 406, 407, 409, 410, 411, 412, 413, 415, 416, 417, 420, 421, 422, 423, 424, 427, 428, 431, 432, 433, 435, 436, 438, 441, 442, 443, 444, 445, 447, 450, 452, 454, 458, 459, 463, 464, 465, 467, 469, 472, 473, 474, 475, 479, 481, 482, 484, 486, 488, 489, 490, 491, 492, 496, 497, 498, 499, 501, 503, 508, 509, 510, 512, 513, 514, 516, 519, 521, 522, 525, 527, 528, 530, 532, 533, 534, 535, 536, 537, 538, 540, 541, 542, 543, 545, 546, 548, 550, 551, 553, 557, 558, 560, 562, 564, 567, 569, 572, 573, 576, 577, 580, 581, 583, 584, 588, 589, 590, 591, 592, 593, 596, 599, 600, 602, 606, 608, 610, 614, 619, 620, 621, 622, 624, 625, 627, 628, 629, 631, 632, 633, 637, 639, 640, 642, 643, 646, 648, 649, 650, 651, 653, 654, 657, 659, 661, 662, 664, 665, 669, 670, 672, 674, 676, 678, 679, 680, 681, 684, 687, 688, 691, 692, 695, 697, 698, 699, 701, 702, 703, 704, 705, 706, 708, 710, 714, 715, 723, 724, 725, 728, 731, 732, 733, 734, 736, 737, 739, 740, 741, 742, 743, 747, 748, 749, 751, 752, 754, 756, 757, 758, 759, 760, 761, 762, 763, 764, 765, 767, 768, 769, 770, 772, 773, 778, 780, 785, 786, 787, 791, 792, 793, 794, 796, 798, 799, 800, 802, 803, 804, 805, 808, 809, 813, 815, 817, 820, 821, 822, 823, 824, 825, 826, 827, 828, 829, 830, 831, 834, 836, 837, 838, 839, 840, 842, 844, 846, 847, 848, 850, 851, 852, 853, 854, 855, 856, 857, 858, 860, 861, 862, 863, 864, 865, 866, 871, 872, 873, 875, 876, 877, 879, 880, 881, 882, 883, 884, 885, 886, 889]
[5, 8, 10, 17, 31, 32, 33, 42, 46, 68, 72, 80, 91, 104, 109, 116, 117, 120, 121, 129, 133, 135, 143, 154, 159, 163, 165, 169, 172, 192, 193, 202, 209, 220, 222, 235, 238, 257, 259, 292, 312, 376, 378, 384, 385, 388, 389, 391, 394, 397, 404, 405, 428, 430, 435, 436, 445, 457, 458, 478, 481, 490, 498, 504, 510, 516, 524, 526, 548, 549, 553, 558, 559, 567, 569, 573, 574, 594, 597, 599, 603, 629, 635, 637, 641, 645, 647, 664, 666, 667, 671, 680, 681, 704, 710, 717, 719, 728, 729, 753, 760, 767, 768, 769, 772, 774, 790, 795, 798, 803, 815, 820, 845, 847, 850, 860, 866, 876, 877, 878, 883, 884]

[1, 3, 4, 5, 6, 8, 10, 11, 13, 15, 16, 17, 18, 19, 20, 21, 24, 25, 27, 28, 33, 35, 38, 39, 40, 41, 42, 43, 44, 46, 47, 49, 50, 51, 53, 54, 55, 56, 59, 60, 61, 62, 63, 65, 67, 68, 69, 70, 71, 72, 73, 74, 75, 78, 79, 80, 81, 82, 84, 85, 88, 89, 91, 92, 93, 95, 97, 99, 102, 103, 104, 105, 106, 107, 110, 111, 112, 114, 116, 117, 118, 119, 120, 122, 123, 124, 125, 126, 127, 128, 129, 130, 131, 132, 133, 134, 135, 136, 137, 139, 143, 144, 145, 146, 148, 149, 150, 151, 152, 153, 154, 155, 156, 159, 160, 161, 163, 164, 165, 166, 167, 169, 171, 172, 173, 175, 179, 180, 181, 182, 183, 184, 185, 186, 187, 188, 189, 191, 192, 194, 197, 198, 200, 201, 204, 205, 207, 209, 210, 211, 212, 213, 214, 215, 216, 219, 220, 221, 223, 224, 225, 226, 227, 228, 229, 230, 231, 232, 233, 234, 235, 236, 237, 238, 240, 241, 242, 243, 246, 247, 248, 249, 250, 251, 253, 254, 256, 258, 259, 260, 262, 263, 265, 266, 267, 268, 269, 270, 271, 272, 274, 275, 278, 279, 281, 282, 284, 286, 287, 288, 289, 290, 291, 292, 294, 295, 296, 298, 301, 304, 306, 307, 308, 309, 310, 311, 312, 313, 314, 315, 316, 317, 318, 320, 322, 323, 324, 325, 326, 327, 329, 330, 332, 334, 335, 337, 338, 339, 340, 341, 342, 343, 344, 346, 348, 349, 351, 352, 353, 354, 355, 356, 363, 365, 366, 368, 369, 370, 371, 374, 375, 376, 378, 379, 380, 381, 382, 384, 386, 387, 388, 389, 392, 393, 395, 396, 397, 399, 400, 403, 406, 407, 409, 410, 411, 412, 413, 415, 416, 417, 419, 420, 421, 422, 423, 424, 427, 428, 431, 432, 433, 435, 436, 437, 438, 441, 442, 443, 444, 445, 447, 450, 452, 453, 454, 458, 459, 460, 461, 463, 464, 465, 467, 468, 469, 472, 473, 474, 475, 479, 480, 481, 482, 484, 485, 486, 487, 488, 489, 490, 491, 492, 496, 497, 498, 499, 501, 503, 508, 509, 510, 512, 513, 514, 516, 517, 519, 521, 522, 523, 525, 527, 528, 530, 532, 533, 534, 535, 536, 537, 538, 540, 541, 542, 543, 545, 546, 547, 548, 549, 550, 551, 553, 557, 558, 560, 562, 564, 565, 567, 569, 572, 573, 576, 577, 579, 580, 581, 583, 584, 588, 589, 590, 591, 592, 593, 596, 597, 598, 599, 600, 602, 606, 608, 610, 614, 616, 619, 620, 621, 622, 624, 625, 626, 627, 628, 629, 631, 632, 633, 634, 637, 639, 640, 642, 643, 646, 648, 649, 650, 651, 653, 654, 655, 657, 659, 661, 662, 664, 665, 668, 669, 670, 672, 674, 676, 678, 679, 680, 681, 682, 684, 686, 687, 688, 691, 692, 694, 695, 697, 698, 699, 701, 702, 703, 704, 705, 706, 708, 709, 710, 714, 715, 721, 723, 724, 725, 726, 728, 731, 732, 733, 734, 736, 737, 739, 740, 741, 742, 743, 747, 748, 749, 751, 752, 754, 756, 757, 758, 759, 760, 761, 762, 763, 764, 765, 767, 768, 769, 770, 772, 773, 778, 780, 783, 784, 785, 786, 787, 788, 790, 791, 792, 793, 794, 796, 798, 799, 800, 801, 802, 803, 804, 805, 808, 809, 813, 814, 815, 817, 818, 820, 821, 822, 823, 824, 825, 826, 827, 828, 829, 830, 831, 832, 834, 836, 837, 838, 839, 840, 842, 843, 844, 845, 846, 847, 848, 849, 850, 851, 852, 853, 854, 855, 856, 857, 858, 859, 860, 861, 862, 863, 864, 865, 866, 868, 870, 871, 872, 873, 874, 875, 876, 877, 879, 880, 881, 882, 883, 884, 885, 886, 888, 889]
[5, 8, 10, 17, 31, 32, 33, 42, 46, 68, 72, 80, 91, 104, 109, 116, 117, 120, 121, 129, 133, 135, 143, 154, 159, 163, 165, 169, 172, 192, 193, 202, 209, 220, 222, 235, 238, 257, 259, 292, 312, 376, 378, 384, 385, 388, 389, 391, 394, 397, 404, 405, 428, 430, 435, 436, 445, 457, 458, 478, 481, 490, 498, 504, 510, 516, 524, 526, 548, 549, 553, 558, 559, 567, 569, 573, 574, 594, 597, 599, 603, 629, 635, 637, 641, 645, 647, 664, 666, 667, 671, 680, 681, 704, 710, 717, 719, 728, 729, 753, 760, 767, 768, 769, 772, 774, 790, 795, 798, 803, 815, 820, 845, 847, 850, 860, 866, 876, 877, 878, 883, 884]

[1, 3, 4, 5, 6, 7, 8, 9, 10, 11, 13, 15, 16, 17, 18, 19, 20, 21, 24, 25, 27, 28, 33, 34, 35, 36, 38, 39, 40, 41, 42, 43, 44, 45, 46, 47, 49, 50, 51, 53, 54, 55, 56, 57, 59, 60, 61, 62, 63, 65, 66, 67, 68, 69, 70, 71, 72, 73, 74, 75, 78, 79, 80, 81, 82, 83, 84, 85, 88, 89, 91, 92, 93, 94, 95, 97, 99, 102, 103, 104, 105, 106, 107, 109, 110, 111, 112, 114, 116, 117, 118, 119, 120, 122, 123, 124, 125, 126, 127, 128, 129, 130, 131, 132, 133, 134, 135, 136, 137, 139, 140, 141, 143, 144, 145, 146, 148, 149, 150, 151, 152, 153, 154, 155, 156, 158, 159, 160, 161, 163, 164, 165, 166, 167, 169, 170, 171, 172, 173, 175, 179, 180, 181, 182, 183, 184, 185, 186, 187, 188, 189, 190, 191, 192, 193, 194, 195, 196, 197, 198, 200, 201, 204, 205, 207, 209, 210, 211, 212, 213, 214, 215, 216, 218, 219, 220, 221, 223, 224, 225, 226, 227, 228, 229, 230, 231, 232, 233, 234, 235, 236, 237, 238, 240, 241, 242, 243, 244, 246, 247, 248, 249, 250, 251, 252, 253, 254, 255, 256, 258, 259, 260, 262, 263, 265, 266, 267, 268, 269, 270, 271, 272, 274, 275, 276, 278, 279, 280, 281, 282, 284, 286, 287, 288, 289, 290, 291, 292, 294, 295, 296, 297, 298, 301, 303, 304, 306, 307, 308, 309, 310, 311, 312, 313, 314, 315, 316, 317, 318, 319, 320, 321, 322, 323, 324, 325, 326, 327, 328, 329, 330, 331, 332, 334, 335, 336, 337, 338, 339, 340, 341, 342, 343, 344, 346, 348, 349, 351, 352, 353, 354, 355, 356, 358, 362, 363, 364, 365, 366, 368, 369, 370, 371, 373, 374, 375, 376, 377, 378, 379, 380, 381, 382, 384, 386, 387, 388, 389, 392, 393, 394, 395, 396, 397, 399, 400, 402, 403, 406, 407, 409, 410, 411, 412, 413, 414, 415, 416, 417, 419, 420, 421, 422, 423, 424, 426, 427, 428, 429, 430, 431, 432, 433, 435, 436, 437, 438, 441, 442, 443, 444, 445, 447, 448, 450, 452, 453, 454, 457, 458, 459, 460, 461, 463, 464, 465, 467, 468, 469, 472, 473, 474, 475, 476, 477, 479, 480, 481, 482, 484, 485, 486, 487, 488, 489, 490, 491, 492, 495, 496, 497, 498, 499, 501, 503, 508, 509, 510, 511, 512, 513, 514, 515, 516, 517, 519, 521, 522, 523, 525, 527, 528, 530, 532, 533, 534, 535, 536, 537, 538, 540, 541, 542, 543, 545, 546, 547, 548, 549, 550, 551, 552, 553, 557, 558, 560, 562, 564, 565, 567, 569, 571, 572, 573, 576, 577, 578, 579, 580, 581, 583, 584, 585, 588, 589, 590, 591, 592, 593, 596, 597, 598, 599, 600, 601, 602, 603, 604, 606, 608, 610, 612, 614, 616, 617, 619, 620, 621, 622, 624, 625, 626, 627, 628, 629, 630, 631, 632, 633, 634, 636, 637, 639, 640, 641, 642, 643, 646, 648, 649, 650, 651, 653, 654, 655, 656, 657, 658, 659, 661, 662, 663, 664, 665, 667, 668, 669, 670, 671, 672, 673, 674, 675, 676, 678, 679, 680, 681, 682, 684, 686, 687, 688, 690, 691, 692, 694, 695, 696, 697, 698, 699, 701, 702, 703, 704, 705, 706, 708, 709, 710, 714, 715, 716, 718, 721, 723, 724, 725, 726, 728, 731, 732, 733, 734, 735, 736, 737, 739, 740, 741, 742, 743, 747, 748, 749, 751, 752, 754, 756, 757, 758, 759, 760, 761, 762, 763, 764, 765, 767, 768, 769, 770, 771, 772, 773, 774, 775, 776, 778, 780, 782, 783, 784, 785, 786, 787, 788, 790, 791, 792, 793, 794, 796, 797, 798, 799, 800, 801, 802, 803, 804, 805, 806, 808, 809, 813, 814, 815, 817, 818, 820, 821, 822, 823, 824, 825, 826, 827, 828, 829, 830, 831, 832, 834, 836, 837, 838, 839, 840, 842, 843, 844, 845, 846, 847, 848, 849, 850, 851, 852, 853, 854, 855, 856, 857, 858, 859, 860, 861, 862, 863, 864, 865, 866, 867, 868, 870, 871, 872, 873, 874, 875, 876, 877, 879, 880, 881, 882, 883, 884, 885, 886, 888, 889]
[5, 8, 10, 17, 31, 32, 33, 42, 46, 68, 72, 80, 91, 104, 109, 116, 117, 120, 121, 129, 133, 135, 143, 154, 159, 163, 165, 169, 172, 192, 193, 202, 209, 220, 222, 235, 238, 257, 259, 292, 312, 376, 378, 384, 385, 388, 389, 391, 394, 397, 404, 405, 428, 430, 435, 436, 445, 457, 458, 478, 481, 490, 498, 504, 510, 516, 524, 526, 548, 549, 553, 558, 559, 567, 569, 573, 574, 594, 597, 599, 603, 629, 635, 637, 641, 645, 647, 664, 666, 667, 671, 680, 681, 704, 710, 717, 719, 728, 729, 753, 760, 767, 768, 769, 772, 774, 790, 795, 798, 803, 815, 820, 845, 847, 850, 860, 866, 876, 877, 878, 883, 884]

[0, 1, 3, 4, 5, 6, 7, 8, 9, 10, 11, 12, 13, 14, 15, 16, 17, 18, 19, 20, 21, 22, 23, 24, 25, 27, 28, 29, 30, 31, 33, 34, 35, 36, 37, 38, 39, 40, 41, 42, 43, 44, 45, 46, 47, 48, 49, 50, 51, 53, 54, 55, 56, 57, 58, 59, 60, 61, 62, 63, 65, 66, 67, 68, 69, 70, 71, 72, 73, 74, 75, 76, 78, 79, 80, 81, 82, 83, 84, 85, 86, 88, 89, 90, 91, 92, 93, 94, 95, 97, 99, 101, 102, 103, 104, 105, 106, 107, 108, 109, 110, 111, 112, 113, 114, 116, 117, 118, 119, 120, 122, 123, 124, 125, 126, 127, 128, 129, 130, 131, 132, 133, 134, 135, 136, 137, 139, 140, 141, 143, 144, 145, 146, 148, 149, 150, 151, 152, 153, 154, 155, 156, 158, 159, 160, 161, 163, 164, 165, 166, 167, 168, 169, 170, 171, 172, 173, 175, 179, 180, 181, 182, 183, 184, 185, 186, 187, 188, 189, 190, 191, 192, 193, 194, 195, 196, 197, 198, 199, 200, 201, 202, 203, 204, 205, 207, 208, 209, 210, 211, 212, 213, 214, 215, 216, 217, 218, 219, 220, 221, 223, 224, 225, 226, 227, 228, 229, 230, 231, 232, 233, 234, 235, 236, 237, 238, 239, 240, 241, 242, 243, 244, 245, 246, 247, 248, 249, 250, 251, 252, 253, 254, 255, 256, 257, 258, 259, 260, 261, 262, 263, 264, 265, 266, 267, 268, 269, 270, 271, 272, 274, 275, 276, 277, 278, 279, 280, 281, 282, 284, 286, 287, 288, 289, 290, 291, 292, 294, 295, 296, 297, 298, 300, 301, 303, 304, 305, 306, 307, 308, 309, 310, 311, 312, 313, 314, 315, 316, 317, 318, 319, 320, 321, 322, 323, 324, 325, 326, 327, 328, 329, 330, 331, 332, 333, 334, 335, 336, 337, 338, 339, 340, 341, 342, 343, 344, 346, 348, 349, 351, 352, 353, 354, 355, 356, 358, 359, 362, 363, 364, 365, 366, 368, 369, 370, 371, 373, 374, 375, 376, 377, 378, 379, 380, 381, 382, 384, 386, 387, 388, 389, 392, 393, 394, 395, 396, 397, 399, 400, 401, 402, 403, 404, 406, 407, 408, 409, 410, 411, 412, 413, 414, 415, 416, 417, 419, 420, 421, 422, 423, 424, 426, 427, 428, 429, 430, 431, 432, 433, 434, 435, 436, 437, 438, 441, 442, 443, 444, 445, 447, 448, 450, 452, 453, 454, 457, 458, 459, 460, 461, 463, 464, 465, 467, 468, 469, 470, 471, 472, 473, 474, 475, 476, 477, 479, 480, 481, 482, 483, 484, 485, 486, 487, 488, 489, 490, 491, 492, 493, 495, 496, 497, 498, 499, 501, 502, 503, 504, 506, 507, 508, 509, 510, 511, 512, 513, 514, 515, 516, 517, 518, 519, 521, 522, 523, 525, 527, 528, 530, 531, 532, 533, 534, 535, 536, 537, 538, 539, 540, 541, 542, 543, 545, 546, 547, 548, 549, 550, 551, 552, 553, 554, 555, 556, 557, 558, 559, 560, 562, 564, 565, 567, 569, 571, 572, 573, 576, 577, 578, 579, 580, 581, 582, 583, 584, 585, 588, 589, 590, 591, 592, 593, 595, 596, 597, 598, 599, 600, 601, 602, 603, 604, 606, 608, 609, 610, 612, 614, 615, 616, 617, 619, 620, 621, 622, 624, 625, 626, 627, 628, 629, 630, 631, 632, 633, 634, 635, 636, 637, 638, 639, 640, 641, 642, 643, 646, 648, 649, 650, 651, 653, 654, 655, 656, 657, 658, 659, 661, 662, 663, 664, 665, 666, 667, 668, 669, 670, 671, 672, 673, 674, 675, 676, 678, 679, 680, 681, 682, 684, 685, 686, 687, 688, 689, 690, 691, 692, 693, 694, 695, 696, 697, 698, 699, 700, 701, 702, 703, 704, 705, 706, 707, 708, 709, 710, 713, 714, 715, 716, 718, 720, 721, 722, 723, 724, 725, 726, 727, 728, 731, 732, 733, 734, 735, 736, 737, 739, 740, 741, 742, 743, 745, 746, 747, 748, 749, 751, 752, 754, 755, 756, 757, 758, 759, 760, 761, 762, 763, 764, 765, 766, 767, 768, 769, 770, 771, 772, 773, 774, 775, 776, 778, 780, 782, 783, 784, 785, 786, 787, 788, 790, 791, 792, 793, 794, 795, 796, 797, 798, 799, 800, 801, 802, 803, 804, 805, 806, 808, 809, 813, 814, 815, 817, 818, 820, 821, 822, 823, 824, 825, 826, 827, 828, 829, 830, 831, 832, 833, 834, 836, 837, 838, 839, 840, 842, 843, 844, 845, 846, 847, 848, 849, 850, 851, 852, 853, 854, 855, 856, 857, 858, 859, 860, 861, 862, 863, 864, 865, 866, 867, 868, 869, 870, 871, 872, 873, 874, 875, 876, 877, 878, 879, 880, 881, 882, 883, 884, 885, 886, 887, 888, 889]
[5, 8, 10, 17, 31, 32, 33, 42, 46, 68, 72, 80, 91, 104, 109, 116, 117, 120, 121, 129, 133, 135, 143, 154, 159, 163, 165, 169, 172, 192, 193, 202, 209, 220, 222, 235, 238, 257, 259, 292, 312, 376, 378, 384, 385, 388, 389, 391, 394, 397, 404, 405, 428, 430, 435, 436, 445, 457, 458, 478, 481, 490, 498, 504, 510, 516, 524, 526, 548, 549, 553, 558, 559, 567, 569, 573, 574, 594, 597, 599, 603, 629, 635, 637, 641, 645, 647, 664, 666, 667, 671, 680, 681, 704, 710, 717, 719, 728, 729, 753, 760, 767, 768, 769, 772, 774, 790, 795, 798, 803, 815, 820, 845, 847, 850, 860, 866, 876, 877, 878, 883, 884]

