[27, 51, 72, 74, 123, 139, 209, 235, 287, 324, 424, 426, 439, 503, 570, 575, 582, 652, 763, 776, 777, 842]
[9, 59, 125, 184, 229, 271, 331, 336, 358, 359, 387, 394, 413, 488, 490, 504, 527, 588, 678, 705, 856, 876]

[27, 51, 72, 74, 123, 139, 209, 235, 287, 324, 424, 426, 439, 503, 570, 575, 582, 652, 763, 776, 777, 842]
[3, 9, 26, 38, 43, 47, 59, 78, 81, 83, 84, 94, 96, 97, 102, 124, 125, 132, 134, 141, 145, 156, 184, 227, 229, 239, 242, 243, 249, 260, 261, 271, 289, 300, 306, 328, 331, 336, 348, 351, 358, 359, 371, 374, 387, 394, 398, 412, 413, 420, 422, 438, 446, 449, 450, 452, 457, 458, 486, 488, 490, 493, 496, 504, 506, 509, 510, 517, 520, 523, 527, 532, 533, 534, 538, 563, 564, 567, 588, 592, 601, 624, 626, 630, 633, 639, 645, 662, 668, 672, 675, 678, 705, 711, 713, 718, 720, 733, 743, 752, 760, 762, 773, 778, 782, 783, 798, 801, 821, 826, 837, 839, 844, 846, 847, 853, 854, 856, 859, 876, 878, 880]

[10, 14, 27, 51, 60, 72, 74, 77, 101, 105, 111, 115, 123, 131, 139, 145, 149, 155, 165, 172, 190, 193, 201, 207, 209, 212, 235, 240, 247, 254, 266, 278, 287, 291, 294, 297, 299, 313, 324, 326, 327, 330, 332, 339, 340, 341, 346, 357, 366, 372, 384, 388, 389, 424, 426, 439, 457, 469, 483, 503, 524, 532, 550, 557, 566, 567, 570, 575, 582, 595, 652, 671, 688, 700, 705, 709, 712, 725, 737, 752, 757, 763, 776, 777, 782, 792, 794, 808, 812, 815, 820, 821, 842, 854, 859, 871, 885]
[3, 9, 26, 38, 43, 47, 59, 78, 81, 83, 84, 94, 96, 97, 102, 124, 125, 132, 134, 141, 145, 156, 184, 227, 229, 239, 242, 243, 249, 260, 261, 271, 289, 300, 306, 328, 331, 336, 348, 351, 358, 359, 371, 374, 387, 394, 398, 412, 413, 420, 422, 438, 446, 449, 450, 452, 457, 458, 486, 488, 490, 493, 496, 504, 506, 509, 510, 517, 520, 523, 527, 532, 533, 534, 538, 563, 564, 567, 588, 592, 601, 624, 626, 630, 633, 639, 645, 662, 668, 672, 675, 678, 705, 711, 713, 718, 720, 733, 743, 752, 760, 762, 773, 778, 782, 783, 798, 801, 821, 826, 837, 839, 844, 846, 847, 853, 854, 856, 859, 876, 878, 880]

[2, 10, 14, 15, 16, 17, 26, 27, 31, 40, 48, 51, 55, 60, 72, 74, 77, 81, 85, 86, 101, 105, 110, 111, 113, 115, 123, 131, 139, 145, 149, 155, 157, 161, 165, 170, 172, 175, 180, 181, 190, 193, 201, 207, 209, 212, 235, 240, 247, 254, 266, 278, 287, 291, 292, 294, 297, 299, 300, 311, 313, 324, 326, 327, 330, 331, 332, 339, 340, 341, 346, 357, 364, 366, 368, 371, 372, 384, 388, 389, 405, 408, 424, 426, 429, 431, 434, 439, 455, 456, 457, 468, 469, 483, 484, 488, 503, 504, 505, 510, 511, 513, 521, 524, 530, 532, 550, 557, 563, 566, 567, 570, 575, 576, 578, 580, 582, 586, 595, 630, 641, 643, 652, 656, 662, 663, 667, 671, 676, 679, 685, 688, 691, 698, 700, 705, 709, 712, 716, 725, 730, 735, 737, 750, 752, 757, 759, 763, 776, 777, 782, 788, 792, 794, 796, 801, 804, 808, 812, 815, 820, 821, 834, 838, 842, 854, 858, 859, 868, 871, 876, 878, 885, 889]
[3, 9, 26, 38, 43, 47, 59, 78, 81, 83, 84, 94, 96, 97, 102, 124, 125, 132, 134, 141, 145, 156, 184, 227, 229, 239, 242, 243, 249, 260, 261, 271, 289, 300, 306, 328, 331, 336, 348, 351, 358, 359, 371, 374, 387, 394, 398, 412, 413, 420, 422, 438, 446, 449, 450, 452, 457, 458, 486, 488, 490, 493, 496, 504, 506, 509, 510, 517, 520, 523, 527, 532, 533, 534, 538, 563, 564, 567, 588, 592, 601, 624, 626, 630, 633, 639, 645, 662, 668, 672, 675, 678, 705, 711, 713, 718, 720, 733, 743, 752, 760, 762, 773, 778, 782, 783, 798, 801, 821, 826, 837, 839, 844, 846, 847, 853, 854, 856, 859, 876, 878, 880]

[2, 10, 13, 14, 15, 16, 17, 26, 27, 31, 40, 48, 49, 51, 55, 60, 66, 67, 72, 74, 77, 78, 79, 81, 85, 86, 101, 105, 107, 110, 111, 113, 115, 123, 125, 130, 131, 137, 138, 139, 145, 149, 155, 157, 160, 161, 164, 165, 167, 170, 172, 175, 180, 181, 184, 190, 193, 201, 207, 209, 212, 214, 224, 227, 235, 238, 240, 247, 253, 254, 257, 266, 274, 276, 278, 287, 291, 292, 294, 297, 299, 300, 311, 313, 319, 324, 326, 327, 330, 331, 332, 339, 340, 341, 346, 350, 354, 357, 364, 366, 368, 369, 371, 372, 375, 384, 388, 389, 402, 405, 408, 424, 426, 428, 429, 431, 433, 434, 439, 445, 451, 454, 455, 456, 457, 464, 468, 469, 475, 476, 477, 480, 483, 484, 485, 488, 491, 503, 504, 505, 510, 511, 513, 521, 524, 525, 526, 530, 532, 538, 543, 548, 550, 557, 563, 566, 567, 570, 575, 576, 578, 580, 582, 585, 586, 589, 591, 592, 595, 599, 622, 628, 630, 633, 635, 639, 641, 643, 652, 655, 656, 662, 663, 666, 667, 671, 676, 677, 678, 679, 685, 687, 688, 689, 691, 693, 697, 698, 700, 705, 706, 709, 712, 716, 725, 730, 735, 737, 750, 752, 757, 759, 763, 764, 769, 776, 777, 782, 787, 788, 792, 794, 796, 801, 804, 808, 812, 815, 820, 821, 824, 831, 834, 835, 838, 842, 854, 858, 859, 865, 868, 871, 873, 876, 878, 885, 886, 888, 889]
[3, 9, 26, 38, 43, 47, 59, 78, 81, 83, 84, 94, 96, 97, 102, 124, 125, 132, 134, 141, 145, 156, 184, 227, 229, 239, 242, 243, 249, 260, 261, 271, 289, 300, 306, 328, 331, 336, 348, 351, 358, 359, 371, 374, 387, 394, 398, 412, 413, 420, 422, 438, 446, 449, 450, 452, 457, 458, 486, 488, 490, 493, 496, 504, 506, 509, 510, 517, 520, 523, 527, 532, 533, 534, 538, 563, 564, 567, 588, 592, 601, 624, 626, 630, 633, 639, 645, 662, 668, 672, 675, 678, 705, 711, 713, 718, 720, 733, 743, 752, 760, 762, 773, 778, 782, 783, 798, 801, 821, 826, 837, 839, 844, 846, 847, 853, 854, 856, 859, 876, 878, 880]

[2, 5, 9, 10, 11, 13, 14, 15, 16, 17, 18, 26, 27, 31, 35, 38, 40, 48, 49, 51, 55, 60, 66, 67, 68, 72, 74, 77, 78, 79, 81, 85, 86, 92, 101, 102, 105, 107, 110, 111, 113, 115, 123, 125, 130, 131, 137, 138, 139, 145, 149, 153, 155, 157, 160, 161, 162, 164, 165, 167, 170, 172, 175, 179, 180, 181, 184, 190, 192, 193, 201, 207, 209, 212, 213, 214, 216, 224, 227, 230, 233, 235, 238, 240, 241, 247, 253, 254, 257, 266, 274, 276, 278, 279, 280, 287, 288, 291, 292, 294, 297, 299, 300, 303, 304, 310, 311, 313, 319, 324, 326, 327, 330, 331, 332, 339, 340, 341, 346, 350, 351, 354, 357, 360, 364, 366, 368, 369, 371, 372, 375, 377, 382, 384, 388, 389, 395, 401, 402, 405, 408, 409, 424, 426, 428, 429, 431, 433, 434, 437, 439, 441, 445, 451, 454, 455, 456, 457, 464, 466, 468, 469, 472, 473, 475, 476, 477, 480, 483, 484, 485, 488, 491, 494, 496, 503, 504, 505, 507, 508, 509, 510, 511, 513, 516, 521, 524, 525, 526, 530, 532, 538, 543, 547, 548, 550, 552, 557, 563, 566, 567, 570, 573, 575, 576, 578, 580, 582, 585, 586, 589, 591, 592, 595, 597, 599, 600, 608, 622, 623, 628, 630, 633, 635, 636, 639, 640, 641, 643, 652, 655, 656, 660, 661, 662, 663, 665, 666, 667, 670, 671, 673, 675, 676, 677, 678, 679, 684, 685, 686, 687, 688, 689, 691, 693, 695, 697, 698, 700, 703, 705, 706, 707, 709, 710, 712, 716, 721, 722, 725, 729, 730, 735, 737, 739, 740, 750, 752, 757, 759, 763, 764, 769, 776, 777, 782, 787, 788, 789, 792, 794, 796, 801, 803, 804, 808, 812, 815, 820, 821, 823, 824, 829, 831, 834, 835, 838, 842, 843, 854, 858, 859, 865, 868, 871, 873, 876, 877, 878, 879, 885, 886, 888, 889]
[3, 9, 26, 38, 43, 47, 59, 78, 81, 83, 84, 94, 96, 97, 102, 124, 125, 132, 134, 141, 145, 156, 184, 227, 229, 239, 242, 243, 249, 260, 261, 271, 289, 300, 306, 328, 331, 336, 348, 351, 358, 359, 371, 374, 387, 394, 398, 412, 413, 420, 422, 438, 446, 449, 450, 452, 457, 458, 486, 488, 490, 493, 496, 504, 506, 509, 510, 517, 520, 523, 527, 532, 533, 534, 538, 563, 564, 567, 588, 592, 601, 624, 626, 630, 633, 639, 645, 662, 668, 672, 675, 678, 705, 711, 713, 718, 720, 733, 743, 752, 760, 762, 773, 778, 782, 783, 798, 801, 821, 826, 837, 839, 844, 846, 847, 853, 854, 856, 859, 876, 878, 880]

[1, 2, 3, 5, 6, 8, 9, 10, 11, 13, 14, 15, 16, 17, 18, 26, 27, 31, 35, 38, 40, 48, 49, 51, 54, 55, 60, 61, 63, 66, 67, 68, 72, 74, 77, 78, 79, 81, 85, 86, 89, 90, 91, 92, 95, 101, 102, 104, 105, 107, 110, 111, 113, 115, 119, 122, 123, 125, 130, 131, 137, 138, 139, 143, 145, 149, 153, 155, 157, 160, 161, 162, 163, 164, 165, 167, 170, 172, 175, 176, 177, 179, 180, 181, 184, 185, 190, 192, 193, 197, 201, 202, 203, 207, 209, 212, 213, 214, 216, 220, 223, 224, 226, 227, 230, 231, 233, 235, 237, 238, 240, 241, 242, 244, 247, 253, 254, 257, 261, 262, 264, 266, 268, 273, 274, 276, 278, 279, 280, 287, 288, 291, 292, 293, 294, 297, 299, 300, 303, 304, 310, 311, 313, 319, 320, 324, 326, 327, 330, 331, 332, 339, 340, 341, 346, 347, 350, 351, 353, 354, 357, 360, 364, 366, 368, 369, 371, 372, 375, 377, 382, 384, 388, 389, 395, 401, 402, 405, 408, 409, 412, 424, 426, 428, 429, 431, 433, 434, 437, 439, 441, 445, 451, 454, 455, 456, 457, 460, 462, 464, 465, 466, 468, 469, 471, 472, 473, 475, 476, 477, 480, 483, 484, 485, 486, 488, 491, 494, 496, 503, 504, 505, 507, 508, 509, 510, 511, 512, 513, 516, 521, 522, 524, 525, 526, 527, 530, 532, 538, 543, 547, 548, 549, 550, 552, 557, 561, 563, 565, 566, 567, 570, 573, 575, 576, 578, 580, 582, 583, 585, 586, 589, 591, 592, 595, 597, 599, 600, 608, 613, 617, 622, 623, 628, 630, 633, 635, 636, 639, 640, 641, 643, 651, 652, 653, 655, 656, 660, 661, 662, 663, 665, 666, 667, 670, 671, 673, 675, 676, 677, 678, 679, 681, 684, 685, 686, 687, 688, 689, 691, 692, 693, 695, 696, 697, 698, 700, 703, 705, 706, 707, 709, 710, 712, 716, 719, 721, 722, 723, 725, 726, 729, 730, 735, 737, 739, 740, 750, 752, 754, 757, 758, 759, 763, 764, 769, 773, 776, 777, 781, 782, 784, 787, 788, 789, 792, 794, 796, 801, 803, 804, 808, 812, 813, 815, 818, 820, 821, 823, 824, 826, 829, 831, 834, 835, 838, 842, 843, 846, 854, 856, 857, 858, 859, 861, 865, 866, 868, 871, 873, 876, 877, 878, 879, 880, 885, 886, 888, 889]
[3, 9, 26, 38, 43, 47, 59, 78, 81, 83, 84, 94, 96, 97, 102, 124, 125, 132, 134, 141, 145, 156, 184, 227, 229, 239, 242, 243, 249, 260, 261, 271, 289, 300, 306, 328, 331, 336, 348, 351, 358, 359, 371, 374, 387, 394, 398, 412, 413, 420, 422, 438, 446, 449, 450, 452, 457, 458, 486, 488, 490, 493, 496, 504, 506, 509, 510, 517, 520, 523, 527, 532, 533, 534, 538, 563, 564, 567, 588, 592, 601, 624, 626, 630, 633, 639, 645, 662, 668, 672, 675, 678, 705, 711, 713, 718, 720, 733, 743, 752, 760, 762, 773, 778, 782, 783, 798, 801, 821, 826, 837, 839, 844, 846, 847, 853, 854, 856, 859, 876, 878, 880]

[1, 2, 3, 5, 6, 8, 9, 10, 11, 13, 14, 15, 16, 17, 18, 20, 26, 27, 31, 35, 38, 40, 43, 47, 48, 49, 51, 54, 55, 60, 61, 62, 63, 66, 67, 68, 70, 71, 72, 73, 74, 77, 78, 79, 81, 82, 83, 85, 86, 89, 90, 91, 92, 95, 100, 101, 102, 104, 105, 107, 109, 110, 111, 113, 115, 119, 122, 123, 125, 130, 131, 137, 138, 139, 141, 142, 143, 145, 146, 149, 150, 153, 155, 157, 160, 161, 162, 163, 164, 165, 167, 170, 172, 173, 175, 176, 177, 179, 180, 181, 184, 185, 190, 192, 193, 196, 197, 201, 202, 203, 207, 209, 212, 213, 214, 215, 216, 220, 223, 224, 226, 227, 230, 231, 233, 235, 237, 238, 240, 241, 242, 244, 247, 253, 254, 256, 257, 261, 262, 263, 264, 266, 267, 268, 269, 270, 273, 274, 276, 278, 279, 280, 282, 286, 287, 288, 291, 292, 293, 294, 297, 299, 300, 303, 304, 305, 309, 310, 311, 313, 314, 319, 320, 324, 326, 327, 330, 331, 332, 334, 339, 340, 341, 345, 346, 347, 348, 350, 351, 353, 354, 357, 360, 362, 364, 366, 368, 369, 371, 372, 375, 376, 377, 382, 384, 388, 389, 395, 396, 399, 400, 401, 402, 405, 406, 408, 409, 412, 417, 422, 423, 424, 426, 428, 429, 431, 433, 434, 437, 439, 441, 445, 451, 454, 455, 456, 457, 460, 462, 464, 465, 466, 468, 469, 470, 471, 472, 473, 475, 476, 477, 480, 483, 484, 485, 486, 488, 491, 492, 494, 496, 503, 504, 505, 507, 508, 509, 510, 511, 512, 513, 516, 521, 522, 524, 525, 526, 527, 530, 532, 534, 538, 539, 543, 544, 547, 548, 549, 550, 551, 552, 557, 561, 563, 565, 566, 567, 570, 573, 575, 576, 578, 580, 582, 583, 584, 585, 586, 588, 589, 591, 592, 595, 597, 599, 600, 607, 608, 613, 617, 618, 621, 622, 623, 628, 630, 633, 634, 635, 636, 637, 639, 640, 641, 643, 645, 651, 652, 653, 655, 656, 659, 660, 661, 662, 663, 665, 666, 667, 668, 669, 670, 671, 673, 675, 676, 677, 678, 679, 681, 684, 685, 686, 687, 688, 689, 691, 692, 693, 695, 696, 697, 698, 699, 700, 701, 702, 703, 705, 706, 707, 709, 710, 712, 716, 719, 721, 722, 723, 725, 726, 729, 730, 735, 737, 739, 740, 750, 752, 754, 757, 758, 759, 760, 762, 763, 764, 765, 769, 773, 775, 776, 777, 780, 781, 782, 784, 786, 787, 788, 789, 792, 794, 796, 801, 803, 804, 808, 812, 813, 815, 817, 818, 820, 821, 823, 824, 826, 829, 831, 834, 835, 837, 838, 839, 842, 843, 846, 851, 854, 856, 857, 858, 859, 861, 862, 865, 866, 868, 871, 872, 873, 874, 876, 877, 878, 879, 880, 883, 885, 886, 887, 888, 889]
[3, 9, 26, 38, 43, 47, 59, 78, 81, 83, 84, 94, 96, 97, 102, 124, 125, 132, 134, 141, 145, 156, 184, 227, 229, 239, 242, 243, 249, 260, 261, 271, 289, 300, 306, 328, 331, 336, 348, 351, 358, 359, 371, 374, 387, 394, 398, 412, 413, 420, 422, 438, 446, 449, 450, 452, 457, 458, 486, 488, 490, 493, 496, 504, 506, 509, 510, 517, 520, 523, 527, 532, 533, 534, 538, 563, 564, 567, 588, 592, 601, 624, 626, 630, 633, 639, 645, 662, 668, 672, 675, 678, 705, 711, 713, 718, 720, 733, 743, 752, 760, 762, 773, 778, 782, 783, 798, 801, 821, 826, 837, 839, 844, 846, 847, 853, 854, 856, 859, 876, 878, 880]

[1, 2, 3, 5, 6, 8, 9, 10, 11, 13, 14, 15, 16, 17, 18, 20, 25, 26, 27, 31, 35, 38, 40, 43, 46, 47, 48, 49, 50, 51, 52, 53, 54, 55, 58, 60, 61, 62, 63, 66, 67, 68, 69, 70, 71, 72, 73, 74, 77, 78, 79, 81, 82, 83, 85, 86, 89, 90, 91, 92, 93, 95, 100, 101, 102, 104, 105, 107, 109, 110, 111, 113, 115, 119, 121, 122, 123, 124, 125, 130, 131, 137, 138, 139, 141, 142, 143, 145, 146, 147, 148, 149, 150, 153, 154, 155, 157, 158, 160, 161, 162, 163, 164, 165, 167, 170, 172, 173, 175, 176, 177, 179, 180, 181, 184, 185, 187, 190, 192, 193, 196, 197, 201, 202, 203, 205, 207, 209, 212, 213, 214, 215, 216, 219, 220, 223, 224, 226, 227, 230, 231, 233, 235, 237, 238, 240, 241, 242, 244, 247, 253, 254, 256, 257, 260, 261, 262, 263, 264, 266, 267, 268, 269, 270, 271, 273, 274, 275, 276, 278, 279, 280, 282, 286, 287, 288, 291, 292, 293, 294, 295, 297, 299, 300, 303, 304, 305, 309, 310, 311, 313, 314, 315, 316, 319, 320, 322, 324, 325, 326, 327, 330, 331, 332, 334, 339, 340, 341, 345, 346, 347, 348, 350, 351, 353, 354, 355, 357, 360, 362, 363, 364, 366, 368, 369, 371, 372, 375, 376, 377, 380, 382, 383, 384, 388, 389, 390, 394, 395, 396, 399, 400, 401, 402, 405, 406, 407, 408, 409, 410, 412, 417, 420, 422, 423, 424, 426, 428, 429, 431, 433, 434, 437, 439, 441, 445, 448, 451, 453, 454, 455, 456, 457, 460, 462, 464, 465, 466, 468, 469, 470, 471, 472, 473, 475, 476, 477, 480, 483, 484, 485, 486, 488, 491, 492, 494, 496, 503, 504, 505, 507, 508, 509, 510, 511, 512, 513, 514, 516, 517, 520, 521, 522, 524, 525, 526, 527, 528, 530, 532, 534, 537, 538, 539, 543, 544, 545, 547, 548, 549, 550, 551, 552, 554, 557, 561, 563, 565, 566, 567, 570, 573, 575, 576, 577, 578, 580, 582, 583, 584, 585, 586, 587, 588, 589, 590, 591, 592, 593, 594, 595, 597, 599, 600, 603, 607, 608, 610, 613, 617, 618, 621, 622, 623, 628, 630, 631, 632, 633, 634, 635, 636, 637, 639, 640, 641, 643, 645, 651, 652, 653, 655, 656, 657, 659, 660, 661, 662, 663, 665, 666, 667, 668, 669, 670, 671, 673, 675, 676, 677, 678, 679, 681, 683, 684, 685, 686, 687, 688, 689, 691, 692, 693, 694, 695, 696, 697, 698, 699, 700, 701, 702, 703, 704, 705, 706, 707, 709, 710, 712, 716, 719, 721, 722, 723, 724, 725, 726, 728, 729, 730, 733, 735, 737, 739, 740, 743, 750, 752, 754, 757, 758, 759, 760, 762, 763, 764, 765, 767, 769, 770, 771, 773, 775, 776, 777, 780, 781, 782, 783, 784, 786, 787, 788, 789, 791, 792, 794, 795, 796, 801, 803, 804, 806, 808, 812, 813, 814, 815, 817, 818, 819, 820, 821, 823, 824, 826, 827, 829, 831, 834, 835, 837, 838, 839, 842, 843, 846, 848, 850, 851, 854, 855, 856, 857, 858, 859, 861, 862, 864, 865, 866, 868, 871, 872, 873, 874, 876, 877, 878, 879, 880, 883, 884, 885, 886, 887, 888, 889]
[3, 9, 26, 38, 43, 47, 59, 78, 81, 83, 84, 94, 96, 97, 102, 124, 125, 132, 134, 141, 145, 156, 184, 227, 229, 239, 242, 243, 249, 260, 261, 271, 289, 300, 306, 328, 331, 336, 348, 351, 358, 359, 371, 374, 387, 394, 398, 412, 413, 420, 422, 438, 446, 449, 450, 452, 457, 458, 486, 488, 490, 493, 496, 504, 506, 509, 510, 517, 520, 523, 527, 532, 533, 534, 538, 563, 564, 567, 588, 592, 601, 624, 626, 630, 633, 639, 645, 662, 668, 672, 675, 678, 705, 711, 713, 718, 720, 733, 743, 752, 760, 762, 773, 778, 782, 783, 798, 801, 821, 826, 837, 839, 844, 846, 847, 853, 854, 856, 859, 876, 878, 880]

[1, 2, 3, 5, 6, 7, 8, 9, 10, 11, 13, 14, 15, 16, 17, 18, 19, 20, 24, 25, 26, 27, 31, 32, 35, 36, 38, 39, 40, 41, 43, 46, 47, 48, 49, 50, 51, 52, 53, 54, 55, 56, 58, 60, 61, 62, 63, 66, 67, 68, 69, 70, 71, 72, 73, 74, 75, 77, 78, 79, 81, 82, 83, 85, 86, 89, 90, 91, 92, 93, 94, 95, 97, 100, 101, 102, 104, 105, 106, 107, 109, 110, 111, 113, 114, 115, 116, 119, 121, 122, 123, 124, 125, 127, 130, 131, 132, 133, 134, 136, 137, 138, 139, 141, 142, 143, 145, 146, 147, 148, 149, 150, 153, 154, 155, 157, 158, 160, 161, 162, 163, 164, 165, 167, 170, 171, 172, 173, 175, 176, 177, 179, 180, 181, 184, 185, 186, 187, 190, 191, 192, 193, 196, 197, 198, 201, 202, 203, 205, 207, 209, 211, 212, 213, 214, 215, 216, 217, 219, 220, 222, 223, 224, 226, 227, 228, 229, 230, 231, 233, 235, 237, 238, 240, 241, 242, 243, 244, 247, 249, 251, 253, 254, 256, 257, 258, 260, 261, 262, 263, 264, 266, 267, 268, 269, 270, 271, 273, 274, 275, 276, 278, 279, 280, 282, 283, 286, 287, 288, 289, 291, 292, 293, 294, 295, 297, 299, 300, 303, 304, 305, 309, 310, 311, 312, 313, 314, 315, 316, 319, 320, 322, 324, 325, 326, 327, 330, 331, 332, 334, 336, 339, 340, 341, 345, 346, 347, 348, 350, 351, 353, 354, 355, 357, 360, 361, 362, 363, 364, 366, 368, 369, 371, 372, 375, 376, 377, 380, 382, 383, 384, 385, 387, 388, 389, 390, 391, 394, 395, 396, 399, 400, 401, 402, 405, 406, 407, 408, 409, 410, 412, 413, 416, 417, 419, 420, 422, 423, 424, 426, 428, 429, 431, 433, 434, 435, 437, 439, 440, 441, 445, 448, 449, 451, 453, 454, 455, 456, 457, 459, 460, 461, 462, 464, 465, 466, 468, 469, 470, 471, 472, 473, 475, 476, 477, 480, 483, 484, 485, 486, 488, 490, 491, 492, 494, 495, 496, 497, 498, 499, 503, 504, 505, 507, 508, 509, 510, 511, 512, 513, 514, 516, 517, 520, 521, 522, 524, 525, 526, 527, 528, 530, 531, 532, 534, 537, 538, 539, 543, 544, 545, 547, 548, 549, 550, 551, 552, 554, 557, 558, 561, 562, 563, 565, 566, 567, 570, 572, 573, 575, 576, 577, 578, 580, 582, 583, 584, 585, 586, 587, 588, 589, 590, 591, 592, 593, 594, 595, 597, 599, 600, 603, 607, 608, 609, 610, 613, 617, 618, 621, 622, 623, 624, 627, 628, 630, 631, 632, 633, 634, 635, 636, 637, 639, 640, 641, 643, 645, 646, 647, 649, 650, 651, 652, 653, 655, 656, 657, 659, 660, 661, 662, 663, 665, 666, 667, 668, 669, 670, 671, 673, 675, 676, 677, 678, 679, 680, 681, 683, 684, 685, 686, 687, 688, 689, 691, 692, 693, 694, 695, 696, 697, 698, 699, 700, 701, 702, 703, 704, 705, 706, 707, 709, 710, 712, 714, 716, 719, 721, 722, 723, 724, 725, 726, 728, 729, 730, 733, 735, 737, 738, 739, 740, 742, 743, 745, 746, 747, 750, 751, 752, 754, 755, 757, 758, 759, 760, 761, 762, 763, 764, 765, 767, 769, 770, 771, 773, 775, 776, 777, 778, 780, 781, 782, 783, 784, 785, 786, 787, 788, 789, 791, 792, 794, 795, 796, 801, 803, 804, 806, 808, 810, 812, 813, 814, 815, 816, 817, 818, 819, 820, 821, 823, 824, 826, 827, 828, 829, 831, 833, 834, 835, 837, 838, 839, 842, 843, 846, 848, 850, 851, 854, 855, 856, 857, 858, 859, 861, 862, 864, 865, 866, 868, 871, 872, 873, 874, 876, 877, 878, 879, 880, 882, 883, 884, 885, 886, 887, 888, 889]
[3, 9, 26, 38, 43, 47, 59, 78, 81, 83, 84, 94, 96, 97, 102, 124, 125, 132, 134, 141, 145, 156, 184, 227, 229, 239, 242, 243, 249, 260, 261, 271, 289, 300, 306, 328, 331, 336, 348, 351, 358, 359, 371, 374, 387, 394, 398, 412, 413, 420, 422, 438, 446, 449, 450, 452, 457, 458, 486, 488, 490, 493, 496, 504, 506, 509, 510, 517, 520, 523, 527, 532, 533, 534, 538, 563, 564, 567, 588, 592, 601, 624, 626, 630, 633, 639, 645, 662, 668, 672, 675, 678, 705, 711, 713, 718, 720, 733, 743, 752, 760, 762, 773, 778, 782, 783, 798, 801, 821, 826, 837, 839, 844, 846, 847, 853, 854, 856, 859, 876, 878, 880]

[1, 2, 3, 4, 5, 6, 7, 8, 9, 10, 11, 13, 14, 15, 16, 17, 18, 19, 20, 24, 25, 26, 27, 31, 32, 34, 35, 36, 38, 39, 40, 41, 43, 44, 45, 46, 47, 48, 49, 50, 51, 52, 53, 54, 55, 56, 58, 60, 61, 62, 63, 66, 67, 68, 69, 70, 71, 72, 73, 74, 75, 77, 78, 79, 81, 82, 83, 85, 86, 87, 88, 89, 90, 91, 92, 93, 94, 95, 97, 98, 100, 101, 102, 104, 105, 106, 107, 109, 110, 111, 113, 114, 115, 116, 118, 119, 121, 122, 123, 124, 125, 127, 128, 129, 130, 131, 132, 133, 134, 135, 136, 137, 138, 139, 141, 142, 143, 144, 145, 146, 147, 148, 149, 150, 152, 153, 154, 155, 157, 158, 159, 160, 161, 162, 163, 164, 165, 167, 170, 171, 172, 173, 174, 175, 176, 177, 179, 180, 181, 184, 185, 186, 187, 190, 191, 192, 193, 194, 195, 196, 197, 198, 199, 201, 202, 203, 204, 205, 207, 209, 211, 212, 213, 214, 215, 216, 217, 219, 220, 222, 223, 224, 225, 226, 227, 228, 229, 230, 231, 233, 235, 237, 238, 239, 240, 241, 242, 243, 244, 245, 247, 249, 251, 253, 254, 255, 256, 257, 258, 260, 261, 262, 263, 264, 266, 267, 268, 269, 270, 271, 272, 273, 274, 275, 276, 278, 279, 280, 281, 282, 283, 285, 286, 287, 288, 289, 291, 292, 293, 294, 295, 297, 299, 300, 302, 303, 304, 305, 309, 310, 311, 312, 313, 314, 315, 316, 319, 320, 322, 324, 325, 326, 327, 330, 331, 332, 334, 336, 339, 340, 341, 343, 345, 346, 347, 348, 349, 350, 351, 353, 354, 355, 357, 360, 361, 362, 363, 364, 366, 368, 369, 370, 371, 372, 375, 376, 377, 380, 381, 382, 383, 384, 385, 387, 388, 389, 390, 391, 392, 394, 395, 396, 397, 399, 400, 401, 402, 405, 406, 407, 408, 409, 410, 411, 412, 413, 416, 417, 419, 420, 422, 423, 424, 426, 428, 429, 430, 431, 433, 434, 435, 437, 438, 439, 440, 441, 445, 448, 449, 450, 451, 452, 453, 454, 455, 456, 457, 459, 460, 461, 462, 463, 464, 465, 466, 468, 469, 470, 471, 472, 473, 475, 476, 477, 478, 479, 480, 483, 484, 485, 486, 488, 489, 490, 491, 492, 493, 494, 495, 496, 497, 498, 499, 503, 504, 505, 506, 507, 508, 509, 510, 511, 512, 513, 514, 515, 516, 517, 520, 521, 522, 524, 525, 526, 527, 528, 530, 531, 532, 534, 536, 537, 538, 539, 541, 543, 544, 545, 546, 547, 548, 549, 550, 551, 552, 554, 557, 558, 561, 562, 563, 564, 565, 566, 567, 570, 572, 573, 574, 575, 576, 577, 578, 580, 582, 583, 584, 585, 586, 587, 588, 589, 590, 591, 592, 593, 594, 595, 597, 599, 600, 602, 603, 605, 607, 608, 609, 610, 613, 615, 617, 618, 621, 622, 623, 624, 625, 627, 628, 630, 631, 632, 633, 634, 635, 636, 637, 639, 640, 641, 643, 645, 646, 647, 648, 649, 650, 651, 652, 653, 655, 656, 657, 659, 660, 661, 662, 663, 664, 665, 666, 667, 668, 669, 670, 671, 673, 674, 675, 676, 677, 678, 679, 680, 681, 683, 684, 685, 686, 687, 688, 689, 690, 691, 692, 693, 694, 695, 696, 697, 698, 699, 700, 701, 702, 703, 704, 705, 706, 707, 709, 710, 712, 714, 716, 718, 719, 720, 721, 722, 723, 724, 725, 726, 728, 729, 730, 731, 733, 734, 735, 737, 738, 739, 740, 742, 743, 745, 746, 747, 748, 749, 750, 751, 752, 753, 754, 755, 756, 757, 758, 759, 760, 761, 762, 763, 764, 765, 766, 767, 769, 770, 771, 773, 775, 776, 777, 778, 779, 780, 781, 782, 783, 784, 785, 786, 787, 788, 789, 791, 792, 794, 795, 796, 801, 802, 803, 804, 806, 808, 810, 812, 813, 814, 815, 816, 817, 818, 819, 820, 821, 822, 823, 824, 826, 827, 828, 829, 830, 831, 833, 834, 835, 837, 838, 839, 840, 842, 843, 846, 847, 848, 850, 851, 854, 855, 856, 857, 858, 859, 861, 862, 864, 865, 866, 867, 868, 871, 872, 873, 874, 876, 877, 878, 879, 880, 881, 882, 883, 884, 885, 886, 887, 888, 889]
[3, 9, 26, 38, 43, 47, 59, 78, 81, 83, 84, 94, 96, 97, 102, 124, 125, 132, 134, 141, 145, 156, 184, 227, 229, 239, 242, 243, 249, 260, 261, 271, 289, 300, 306, 328, 331, 336, 348, 351, 358, 359, 371, 374, 387, 394, 398, 412, 413, 420, 422, 438, 446, 449, 450, 452, 457, 458, 486, 488, 490, 493, 496, 504, 506, 509, 510, 517, 520, 523, 527, 532, 533, 534, 538, 563, 564, 567, 588, 592, 601, 624, 626, 630, 633, 639, 645, 662, 668, 672, 675, 678, 705, 711, 713, 718, 720, 733, 743, 752, 760, 762, 773, 778, 782, 783, 798, 801, 821, 826, 837, 839, 844, 846, 847, 853, 854, 856, 859, 876, 878, 880]

[0, 1, 2, 3, 4, 5, 6, 7, 8, 9, 10, 11, 13, 14, 15, 16, 17, 18, 19, 20, 24, 25, 26, 27, 29, 30, 31, 32, 33, 34, 35, 36, 38, 39, 40, 41, 42, 43, 44, 45, 46, 47, 48, 49, 50, 51, 52, 53, 54, 55, 56, 58, 60, 61, 62, 63, 64, 65, 66, 67, 68, 69, 70, 71, 72, 73, 74, 75, 77, 78, 79, 81, 82, 83, 85, 86, 87, 88, 89, 90, 91, 92, 93, 94, 95, 97, 98, 99, 100, 101, 102, 104, 105, 106, 107, 109, 110, 111, 112, 113, 114, 115, 116, 118, 119, 120, 121, 122, 123, 124, 125, 126, 127, 128, 129, 130, 131, 132, 133, 134, 135, 136, 137, 138, 139, 141, 142, 143, 144, 145, 146, 147, 148, 149, 150, 152, 153, 154, 155, 156, 157, 158, 159, 160, 161, 162, 163, 164, 165, 166, 167, 169, 170, 171, 172, 173, 174, 175, 176, 177, 179, 180, 181, 184, 185, 186, 187, 188, 190, 191, 192, 193, 194, 195, 196, 197, 198, 199, 200, 201, 202, 203, 204, 205, 207, 209, 211, 212, 213, 214, 215, 216, 217, 218, 219, 220, 222, 223, 224, 225, 226, 227, 228, 229, 230, 231, 233, 235, 237, 238, 239, 240, 241, 242, 243, 244, 245, 247, 248, 249, 250, 251, 253, 254, 255, 256, 257, 258, 259, 260, 261, 262, 263, 264, 266, 267, 268, 269, 270, 271, 272, 273, 274, 275, 276, 278, 279, 280, 281, 282, 283, 285, 286, 287, 288, 289, 290, 291, 292, 293, 294, 295, 297, 299, 300, 302, 303, 304, 305, 306, 307, 308, 309, 310, 311, 312, 313, 314, 315, 316, 319, 320, 322, 324, 325, 326, 327, 330, 331, 332, 333, 334, 335, 336, 339, 340, 341, 343, 344, 345, 346, 347, 348, 349, 350, 351, 353, 354, 355, 356, 357, 358, 360, 361, 362, 363, 364, 366, 367, 368, 369, 370, 371, 372, 373, 375, 376, 377, 379, 380, 381, 382, 383, 384, 385, 387, 388, 389, 390, 391, 392, 393, 394, 395, 396, 397, 398, 399, 400, 401, 402, 403, 405, 406, 407, 408, 409, 410, 411, 412, 413, 416, 417, 419, 420, 421, 422, 423, 424, 425, 426, 428, 429, 430, 431, 432, 433, 434, 435, 437, 438, 439, 440, 441, 444, 445, 446, 447, 448, 449, 450, 451, 452, 453, 454, 455, 456, 457, 458, 459, 460, 461, 462, 463, 464, 465, 466, 468, 469, 470, 471, 472, 473, 475, 476, 477, 478, 479, 480, 482, 483, 484, 485, 486, 487, 488, 489, 490, 491, 492, 493, 494, 495, 496, 497, 498, 499, 503, 504, 505, 506, 507, 508, 509, 510, 511, 512, 513, 514, 515, 516, 517, 518, 520, 521, 522, 523, 524, 525, 526, 527, 528, 529, 530, 531, 532, 533, 534, 535, 536, 537, 538, 539, 540, 541, 543, 544, 545, 546, 547, 548, 549, 550, 551, 552, 553, 554, 557, 558, 561, 562, 563, 564, 565, 566, 567, 568, 569, 570, 572, 573, 574, 575, 576, 577, 578, 580, 582, 583, 584, 585, 586, 587, 588, 589, 590, 591, 592, 593, 594, 595, 596, 597, 599, 600, 602, 603, 605, 606, 607, 608, 609, 610, 613, 615, 616, 617, 618, 619, 620, 621, 622, 623, 624, 625, 627, 628, 630, 631, 632, 633, 634, 635, 636, 637, 639, 640, 641, 642, 643, 645, 646, 647, 648, 649, 650, 651, 652, 653, 654, 655, 656, 657, 659, 660, 661, 662, 663, 664, 665, 666, 667, 668, 669, 670, 671, 673, 674, 675, 676, 677, 678, 679, 680, 681, 683, 684, 685, 686, 687, 688, 689, 690, 691, 692, 693, 694, 695, 696, 697, 698, 699, 700, 701, 702, 703, 704, 705, 706, 707, 709, 710, 711, 712, 714, 716, 717, 718, 719, 720, 721, 722, 723, 724, 725, 726, 727, 728, 729, 730, 731, 732, 733, 734, 735, 737, 738, 739, 740, 742, 743, 745, 746, 747, 748, 749, 750, 751, 752, 753, 754, 755, 756, 757, 758, 759, 760, 761, 762, 763, 764, 765, 766, 767, 768, 769, 770, 771, 773, 775, 776, 777, 778, 779, 780, 781, 782, 783, 784, 785, 786, 787, 788, 789, 790, 791, 792, 793, 794, 795, 796, 797, 800, 801, 802, 803, 804, 805, 806, 808, 809, 810, 811, 812, 813, 814, 815, 816, 817, 818, 819, 820, 821, 822, 823, 824, 825, 826, 827, 828, 829, 830, 831, 832, 833, 834, 835, 837, 838, 839, 840, 841, 842, 843, 846, 847, 848, 849, 850, 851, 854, 855, 856, 857, 858, 859, 860, 861, 862, 863, 864, 865, 866, 867, 868, 869, 870, 871, 872, 873, 874, 876, 877, 878, 879, 880, 881, 882, 883, 884, 885, 886, 887, 888, 889]
[3, 9, 26, 38, 43, 47, 59, 78, 81, 83, 84, 94, 96, 97, 102, 124, 125, 132, 134, 141, 145, 156, 184, 227, 229, 239, 242, 243, 249, 260, 261, 271, 289, 300, 306, 328, 331, 336, 348, 351, 358, 359, 371, 374, 387, 394, 398, 412, 413, 420, 422, 438, 446, 449, 450, 452, 457, 458, 486, 488, 490, 493, 496, 504, 506, 509, 510, 517, 520, 523, 527, 532, 533, 534, 538, 563, 564, 567, 588, 592, 601, 624, 626, 630, 633, 639, 645, 662, 668, 672, 675, 678, 705, 711, 713, 718, 720, 733, 743, 752, 760, 762, 773, 778, 782, 783, 798, 801, 821, 826, 837, 839, 844, 846, 847, 853, 854, 856, 859, 876, 878, 880]

