[11, 12, 15, 33, 55, 57, 146, 198, 234, 350, 441, 449, 457, 491, 661, 679, 683, 698, 751, 823, 833, 866]
[48, 84, 167, 178, 226, 230, 233, 236, 458, 487, 512, 527, 547, 555, 625, 677, 753, 779, 801, 824, 859, 881]

[11, 12, 15, 33, 55, 57, 146, 198, 234, 350, 441, 449, 457, 491, 661, 679, 683, 698, 751, 823, 833, 866]
[8, 17, 34, 42, 48, 69, 70, 74, 84, 86, 90, 93, 97, 109, 128, 152, 156, 167, 178, 186, 188, 199, 200, 213, 217, 226, 230, 233, 235, 236, 239, 265, 276, 282, 284, 288, 303, 305, 307, 308, 316, 319, 320, 327, 332, 351, 354, 368, 375, 380, 394, 410, 412, 418, 425, 443, 447, 454, 458, 467, 468, 473, 481, 487, 499, 504, 512, 516, 523, 527, 544, 547, 555, 571, 576, 613, 620, 622, 625, 629, 642, 647, 650, 654, 658, 660, 671, 674, 675, 677, 682, 705, 722, 731, 740, 741, 744, 747, 753, 763, 768, 771, 774, 777, 779, 783, 788, 799, 801, 805, 806, 815, 818, 824, 827, 846, 857, 859, 869, 876, 881, 882]

[6, 11, 12, 15, 27, 33, 44, 55, 57, 109, 114, 115, 116, 117, 146, 149, 157, 160, 161, 171, 179, 194, 198, 203, 213, 214, 220, 234, 246, 249, 251, 255, 299, 313, 315, 319, 350, 356, 362, 364, 368, 398, 407, 413, 416, 421, 426, 436, 441, 445, 449, 453, 457, 464, 476, 477, 482, 486, 491, 509, 513, 518, 521, 544, 556, 559, 572, 602, 603, 627, 650, 654, 661, 666, 679, 680, 683, 684, 698, 730, 740, 748, 751, 753, 774, 781, 785, 791, 795, 809, 817, 823, 833, 843, 858, 866, 868]
[8, 17, 34, 42, 48, 69, 70, 74, 84, 86, 90, 93, 97, 109, 128, 152, 156, 167, 178, 186, 188, 199, 200, 213, 217, 226, 230, 233, 235, 236, 239, 265, 276, 282, 284, 288, 303, 305, 307, 308, 316, 319, 320, 327, 332, 351, 354, 368, 375, 380, 394, 410, 412, 418, 425, 443, 447, 454, 458, 467, 468, 473, 481, 487, 499, 504, 512, 516, 523, 527, 544, 547, 555, 571, 576, 613, 620, 622, 625, 629, 642, 647, 650, 654, 658, 660, 671, 674, 675, 677, 682, 705, 722, 731, 740, 741, 744, 747, 753, 763, 768, 771, 774, 777, 779, 783, 788, 799, 801, 805, 806, 815, 818, 824, 827, 846, 857, 859, 869, 876, 881, 882]

[6, 11, 12, 15, 18, 19, 27, 33, 34, 44, 55, 57, 67, 90, 92, 97, 98, 108, 109, 113, 114, 115, 116, 117, 133, 146, 149, 157, 160, 161, 162, 171, 172, 179, 192, 194, 198, 203, 213, 214, 216, 217, 219, 220, 225, 234, 241, 246, 249, 251, 253, 254, 255, 262, 267, 269, 282, 299, 305, 309, 313, 315, 319, 328, 340, 344, 350, 356, 358, 362, 364, 368, 373, 398, 399, 400, 407, 413, 416, 421, 426, 436, 441, 445, 449, 453, 457, 464, 476, 477, 482, 486, 491, 498, 505, 509, 512, 513, 518, 521, 524, 539, 544, 549, 553, 554, 556, 559, 572, 602, 603, 604, 606, 609, 618, 620, 626, 627, 641, 643, 650, 654, 661, 666, 679, 680, 683, 684, 687, 695, 698, 701, 702, 705, 708, 730, 733, 740, 742, 748, 751, 753, 755, 763, 770, 774, 777, 781, 785, 788, 791, 793, 795, 796, 798, 803, 809, 817, 819, 822, 823, 828, 829, 833, 837, 843, 858, 863, 866, 868, 884, 889]
[8, 17, 34, 42, 48, 69, 70, 74, 84, 86, 90, 93, 97, 109, 128, 152, 156, 167, 178, 186, 188, 199, 200, 213, 217, 226, 230, 233, 235, 236, 239, 265, 276, 282, 284, 288, 303, 305, 307, 308, 316, 319, 320, 327, 332, 351, 354, 368, 375, 380, 394, 410, 412, 418, 425, 443, 447, 454, 458, 467, 468, 473, 481, 487, 499, 504, 512, 516, 523, 527, 544, 547, 555, 571, 576, 613, 620, 622, 625, 629, 642, 647, 650, 654, 658, 660, 671, 674, 675, 677, 682, 705, 722, 731, 740, 741, 744, 747, 753, 763, 768, 771, 774, 777, 779, 783, 788, 799, 801, 805, 806, 815, 818, 824, 827, 846, 857, 859, 869, 876, 881, 882]

[3, 6, 11, 12, 15, 18, 19, 27, 29, 33, 34, 35, 38, 41, 44, 48, 55, 57, 67, 77, 81, 83, 90, 92, 97, 98, 108, 109, 111, 113, 114, 115, 116, 117, 118, 121, 127, 133, 146, 148, 149, 154, 157, 159, 160, 161, 162, 171, 172, 179, 192, 193, 194, 198, 203, 206, 213, 214, 216, 217, 219, 220, 225, 233, 234, 235, 236, 240, 241, 243, 246, 249, 251, 253, 254, 255, 262, 267, 269, 279, 282, 299, 305, 309, 313, 315, 319, 323, 328, 338, 340, 344, 350, 356, 358, 362, 364, 367, 368, 373, 386, 389, 398, 399, 400, 403, 405, 407, 413, 416, 421, 426, 434, 436, 437, 440, 441, 445, 449, 453, 457, 464, 469, 473, 475, 476, 477, 482, 485, 486, 490, 491, 498, 499, 504, 505, 509, 512, 513, 518, 520, 521, 524, 539, 544, 549, 553, 554, 555, 556, 559, 572, 592, 596, 601, 602, 603, 604, 606, 609, 615, 617, 618, 620, 622, 626, 627, 629, 632, 633, 641, 642, 643, 650, 653, 654, 655, 659, 661, 662, 666, 668, 673, 674, 679, 680, 683, 684, 687, 689, 694, 695, 698, 699, 701, 702, 703, 704, 705, 708, 730, 733, 740, 742, 745, 748, 751, 753, 755, 757, 759, 763, 770, 774, 777, 779, 781, 785, 788, 791, 793, 795, 796, 798, 803, 807, 809, 814, 817, 819, 822, 823, 828, 829, 832, 833, 837, 841, 843, 852, 858, 863, 866, 868, 872, 884, 889]
[8, 17, 34, 42, 48, 69, 70, 74, 84, 86, 90, 93, 97, 109, 128, 152, 156, 167, 178, 186, 188, 199, 200, 213, 217, 226, 230, 233, 235, 236, 239, 265, 276, 282, 284, 288, 303, 305, 307, 308, 316, 319, 320, 327, 332, 351, 354, 368, 375, 380, 394, 410, 412, 418, 425, 443, 447, 454, 458, 467, 468, 473, 481, 487, 499, 504, 512, 516, 523, 527, 544, 547, 555, 571, 576, 613, 620, 622, 625, 629, 642, 647, 650, 654, 658, 660, 671, 674, 675, 677, 682, 705, 722, 731, 740, 741, 744, 747, 753, 763, 768, 771, 774, 777, 779, 783, 788, 799, 801, 805, 806, 815, 818, 824, 827, 846, 857, 859, 869, 876, 881, 882]

[3, 6, 7, 11, 12, 15, 18, 19, 27, 29, 30, 33, 34, 35, 38, 41, 44, 45, 48, 54, 55, 57, 67, 70, 77, 81, 83, 90, 92, 96, 97, 98, 100, 108, 109, 111, 113, 114, 115, 116, 117, 118, 121, 126, 127, 131, 133, 134, 136, 140, 146, 148, 149, 154, 157, 159, 160, 161, 162, 171, 172, 177, 179, 192, 193, 194, 198, 203, 205, 206, 209, 213, 214, 216, 217, 219, 220, 222, 225, 226, 233, 234, 235, 236, 237, 238, 240, 241, 243, 246, 249, 251, 253, 254, 255, 261, 262, 267, 269, 278, 279, 281, 282, 283, 284, 288, 299, 305, 307, 309, 313, 315, 319, 322, 323, 328, 329, 338, 340, 344, 350, 356, 358, 362, 364, 367, 368, 373, 382, 384, 386, 389, 391, 398, 399, 400, 403, 405, 407, 412, 413, 416, 421, 422, 426, 427, 434, 436, 437, 439, 440, 441, 443, 445, 449, 453, 457, 458, 464, 469, 473, 475, 476, 477, 482, 485, 486, 490, 491, 493, 495, 498, 499, 502, 504, 505, 509, 511, 512, 513, 515, 517, 518, 520, 521, 524, 529, 539, 544, 549, 551, 553, 554, 555, 556, 559, 565, 572, 590, 591, 592, 596, 601, 602, 603, 604, 606, 609, 615, 616, 617, 618, 620, 622, 626, 627, 629, 632, 633, 635, 639, 641, 642, 643, 648, 650, 653, 654, 655, 659, 660, 661, 662, 666, 668, 673, 674, 679, 680, 681, 683, 684, 687, 689, 694, 695, 698, 699, 701, 702, 703, 704, 705, 708, 724, 728, 730, 733, 740, 742, 745, 747, 748, 751, 752, 753, 755, 756, 757, 758, 759, 761, 763, 765, 769, 770, 774, 777, 779, 781, 785, 788, 791, 793, 794, 795, 796, 798, 799, 802, 803, 807, 809, 813, 814, 817, 819, 822, 823, 824, 828, 829, 832, 833, 837, 840, 841, 843, 852, 858, 863, 865, 866, 868, 870, 872, 875, 879, 880, 882, 884, 889]
[8, 17, 34, 42, 48, 69, 70, 74, 84, 86, 90, 93, 97, 109, 128, 152, 156, 167, 178, 186, 188, 199, 200, 213, 217, 226, 230, 233, 235, 236, 239, 265, 276, 282, 284, 288, 303, 305, 307, 308, 316, 319, 320, 327, 332, 351, 354, 368, 375, 380, 394, 410, 412, 418, 425, 443, 447, 454, 458, 467, 468, 473, 481, 487, 499, 504, 512, 516, 523, 527, 544, 547, 555, 571, 576, 613, 620, 622, 625, 629, 642, 647, 650, 654, 658, 660, 671, 674, 675, 677, 682, 705, 722, 731, 740, 741, 744, 747, 753, 763, 768, 771, 774, 777, 779, 783, 788, 799, 801, 805, 806, 815, 818, 824, 827, 846, 857, 859, 869, 876, 881, 882]

[1, 3, 6, 7, 11, 12, 15, 16, 18, 19, 25, 27, 29, 30, 32, 33, 34, 35, 37, 38, 41, 44, 45, 48, 49, 54, 55, 57, 60, 61, 67, 70, 77, 79, 81, 83, 90, 92, 96, 97, 98, 100, 102, 104, 105, 107, 108, 109, 111, 112, 113, 114, 115, 116, 117, 118, 121, 126, 127, 131, 133, 134, 135, 136, 138, 140, 144, 146, 148, 149, 154, 157, 159, 160, 161, 162, 167, 171, 172, 177, 179, 184, 192, 193, 194, 198, 199, 201, 202, 203, 205, 206, 207, 209, 210, 213, 214, 216, 217, 219, 220, 222, 224, 225, 226, 233, 234, 235, 236, 237, 238, 240, 241, 243, 246, 249, 251, 253, 254, 255, 261, 262, 267, 269, 275, 278, 279, 281, 282, 283, 284, 286, 288, 292, 294, 299, 305, 307, 309, 311, 313, 314, 315, 319, 322, 323, 325, 328, 329, 338, 340, 344, 350, 356, 358, 360, 361, 362, 364, 366, 367, 368, 371, 373, 382, 384, 386, 389, 391, 394, 398, 399, 400, 401, 403, 405, 407, 410, 412, 413, 416, 417, 421, 422, 426, 427, 434, 436, 437, 439, 440, 441, 442, 443, 444, 445, 448, 449, 450, 453, 456, 457, 458, 462, 464, 469, 473, 475, 476, 477, 478, 482, 485, 486, 490, 491, 493, 495, 498, 499, 502, 504, 505, 509, 511, 512, 513, 515, 516, 517, 518, 520, 521, 524, 529, 531, 537, 539, 544, 549, 551, 553, 554, 555, 556, 559, 561, 565, 569, 572, 590, 591, 592, 596, 598, 601, 602, 603, 604, 606, 609, 610, 614, 615, 616, 617, 618, 620, 621, 622, 626, 627, 629, 632, 633, 635, 639, 641, 642, 643, 648, 650, 653, 654, 655, 659, 660, 661, 662, 665, 666, 668, 669, 672, 673, 674, 675, 679, 680, 681, 683, 684, 687, 688, 689, 694, 695, 697, 698, 699, 701, 702, 703, 704, 705, 708, 716, 724, 725, 728, 730, 733, 734, 740, 741, 742, 743, 745, 747, 748, 751, 752, 753, 755, 756, 757, 758, 759, 761, 763, 764, 765, 769, 770, 771, 774, 777, 779, 781, 785, 786, 788, 791, 793, 794, 795, 796, 798, 799, 800, 802, 803, 805, 807, 809, 813, 814, 817, 819, 822, 823, 824, 828, 829, 832, 833, 835, 837, 840, 841, 843, 852, 856, 858, 863, 865, 866, 868, 870, 872, 875, 879, 880, 882, 884, 885, 889]
[8, 17, 34, 42, 48, 69, 70, 74, 84, 86, 90, 93, 97, 109, 128, 152, 156, 167, 178, 186, 188, 199, 200, 213, 217, 226, 230, 233, 235, 236, 239, 265, 276, 282, 284, 288, 303, 305, 307, 308, 316, 319, 320, 327, 332, 351, 354, 368, 375, 380, 394, 410, 412, 418, 425, 443, 447, 454, 458, 467, 468, 473, 481, 487, 499, 504, 512, 516, 523, 527, 544, 547, 555, 571, 576, 613, 620, 622, 625, 629, 642, 647, 650, 654, 658, 660, 671, 674, 675, 677, 682, 705, 722, 731, 740, 741, 744, 747, 753, 763, 768, 771, 774, 777, 779, 783, 788, 799, 801, 805, 806, 815, 818, 824, 827, 846, 857, 859, 869, 876, 881, 882]

[1, 3, 5, 6, 7, 8, 9, 11, 12, 14, 15, 16, 18, 19, 22, 25, 27, 29, 30, 32, 33, 34, 35, 37, 38, 41, 44, 45, 48, 49, 51, 52, 54, 55, 56, 57, 60, 61, 67, 70, 77, 79, 81, 83, 85, 90, 92, 93, 96, 97, 98, 100, 102, 104, 105, 107, 108, 109, 111, 112, 113, 114, 115, 116, 117, 118, 121, 126, 127, 131, 133, 134, 135, 136, 137, 138, 140, 142, 144, 146, 148, 149, 154, 157, 159, 160, 161, 162, 167, 171, 172, 177, 179, 182, 183, 184, 192, 193, 194, 198, 199, 201, 202, 203, 204, 205, 206, 207, 209, 210, 213, 214, 216, 217, 219, 220, 222, 223, 224, 225, 226, 232, 233, 234, 235, 236, 237, 238, 239, 240, 241, 243, 246, 249, 251, 253, 254, 255, 256, 258, 260, 261, 262, 267, 269, 270, 271, 275, 278, 279, 281, 282, 283, 284, 286, 288, 292, 294, 297, 298, 299, 305, 307, 309, 311, 313, 314, 315, 319, 321, 322, 323, 325, 328, 329, 337, 338, 339, 340, 344, 350, 351, 352, 355, 356, 357, 358, 360, 361, 362, 364, 366, 367, 368, 369, 370, 371, 373, 377, 378, 380, 382, 384, 386, 389, 391, 393, 394, 398, 399, 400, 401, 403, 405, 407, 410, 412, 413, 415, 416, 417, 421, 422, 426, 427, 430, 434, 436, 437, 438, 439, 440, 441, 442, 443, 444, 445, 448, 449, 450, 453, 456, 457, 458, 460, 462, 464, 468, 469, 473, 475, 476, 477, 478, 482, 485, 486, 489, 490, 491, 493, 495, 498, 499, 502, 504, 505, 506, 507, 509, 511, 512, 513, 515, 516, 517, 518, 519, 520, 521, 524, 529, 530, 531, 535, 537, 538, 539, 544, 547, 549, 551, 553, 554, 555, 556, 559, 560, 561, 565, 568, 569, 572, 585, 586, 588, 590, 591, 592, 596, 598, 601, 602, 603, 604, 606, 609, 610, 614, 615, 616, 617, 618, 620, 621, 622, 625, 626, 627, 629, 632, 633, 635, 636, 637, 638, 639, 641, 642, 643, 648, 650, 653, 654, 655, 659, 660, 661, 662, 665, 666, 668, 669, 670, 672, 673, 674, 675, 679, 680, 681, 683, 684, 687, 688, 689, 693, 694, 695, 697, 698, 699, 700, 701, 702, 703, 704, 705, 708, 709, 716, 724, 725, 727, 728, 730, 733, 734, 740, 741, 742, 743, 745, 747, 748, 751, 752, 753, 755, 756, 757, 758, 759, 760, 761, 763, 764, 765, 769, 770, 771, 774, 777, 779, 781, 785, 786, 788, 791, 793, 794, 795, 796, 798, 799, 800, 802, 803, 805, 807, 808, 809, 813, 814, 817, 819, 821, 822, 823, 824, 828, 829, 832, 833, 835, 837, 840, 841, 843, 847, 850, 852, 853, 856, 857, 858, 860, 863, 865, 866, 868, 870, 871, 872, 875, 879, 880, 882, 884, 885, 886, 889]
[8, 17, 34, 42, 48, 69, 70, 74, 84, 86, 90, 93, 97, 109, 128, 152, 156, 167, 178, 186, 188, 199, 200, 213, 217, 226, 230, 233, 235, 236, 239, 265, 276, 282, 284, 288, 303, 305, 307, 308, 316, 319, 320, 327, 332, 351, 354, 368, 375, 380, 394, 410, 412, 418, 425, 443, 447, 454, 458, 467, 468, 473, 481, 487, 499, 504, 512, 516, 523, 527, 544, 547, 555, 571, 576, 613, 620, 622, 625, 629, 642, 647, 650, 654, 658, 660, 671, 674, 675, 677, 682, 705, 722, 731, 740, 741, 744, 747, 753, 763, 768, 771, 774, 777, 779, 783, 788, 799, 801, 805, 806, 815, 818, 824, 827, 846, 857, 859, 869, 876, 881, 882]

[1, 3, 4, 5, 6, 7, 8, 9, 11, 12, 14, 15, 16, 18, 19, 20, 22, 24, 25, 27, 29, 30, 32, 33, 34, 35, 37, 38, 41, 43, 44, 45, 46, 48, 49, 51, 52, 53, 54, 55, 56, 57, 60, 61, 67, 69, 70, 73, 75, 77, 79, 81, 83, 85, 89, 90, 92, 93, 95, 96, 97, 98, 100, 102, 104, 105, 107, 108, 109, 111, 112, 113, 114, 115, 116, 117, 118, 121, 122, 125, 126, 127, 131, 133, 134, 135, 136, 137, 138, 140, 141, 142, 144, 146, 148, 149, 152, 154, 156, 157, 159, 160, 161, 162, 164, 167, 168, 169, 171, 172, 177, 179, 181, 182, 183, 184, 192, 193, 194, 196, 197, 198, 199, 201, 202, 203, 204, 205, 206, 207, 209, 210, 213, 214, 216, 217, 219, 220, 222, 223, 224, 225, 226, 228, 232, 233, 234, 235, 236, 237, 238, 239, 240, 241, 243, 246, 249, 251, 253, 254, 255, 256, 258, 260, 261, 262, 267, 269, 270, 271, 275, 278, 279, 281, 282, 283, 284, 285, 286, 288, 292, 294, 297, 298, 299, 302, 304, 305, 306, 307, 309, 311, 313, 314, 315, 319, 321, 322, 323, 325, 327, 328, 329, 331, 337, 338, 339, 340, 342, 344, 347, 350, 351, 352, 354, 355, 356, 357, 358, 360, 361, 362, 364, 366, 367, 368, 369, 370, 371, 372, 373, 377, 378, 380, 382, 384, 385, 386, 389, 391, 393, 394, 395, 398, 399, 400, 401, 403, 405, 407, 410, 411, 412, 413, 415, 416, 417, 421, 422, 424, 426, 427, 428, 430, 434, 435, 436, 437, 438, 439, 440, 441, 442, 443, 444, 445, 448, 449, 450, 453, 456, 457, 458, 460, 461, 462, 464, 468, 469, 473, 475, 476, 477, 478, 482, 485, 486, 488, 489, 490, 491, 493, 495, 497, 498, 499, 502, 504, 505, 506, 507, 508, 509, 511, 512, 513, 515, 516, 517, 518, 519, 520, 521, 524, 526, 527, 529, 530, 531, 535, 537, 538, 539, 544, 545, 546, 547, 549, 551, 553, 554, 555, 556, 558, 559, 560, 561, 565, 568, 569, 572, 574, 576, 577, 585, 586, 588, 589, 590, 591, 592, 595, 596, 598, 600, 601, 602, 603, 604, 606, 607, 608, 609, 610, 614, 615, 616, 617, 618, 620, 621, 622, 624, 625, 626, 627, 628, 629, 632, 633, 634, 635, 636, 637, 638, 639, 641, 642, 643, 647, 648, 650, 651, 653, 654, 655, 659, 660, 661, 662, 665, 666, 668, 669, 670, 672, 673, 674, 675, 679, 680, 681, 682, 683, 684, 686, 687, 688, 689, 693, 694, 695, 697, 698, 699, 700, 701, 702, 703, 704, 705, 708, 709, 711, 716, 724, 725, 727, 728, 730, 733, 734, 735, 740, 741, 742, 743, 745, 747, 748, 751, 752, 753, 755, 756, 757, 758, 759, 760, 761, 763, 764, 765, 768, 769, 770, 771, 774, 775, 776, 777, 779, 781, 782, 783, 785, 786, 788, 791, 792, 793, 794, 795, 796, 798, 799, 800, 802, 803, 804, 805, 807, 808, 809, 810, 811, 812, 813, 814, 816, 817, 819, 821, 822, 823, 824, 828, 829, 831, 832, 833, 835, 836, 837, 840, 841, 843, 845, 847, 850, 852, 853, 856, 857, 858, 860, 863, 864, 865, 866, 867, 868, 870, 871, 872, 873, 875, 878, 879, 880, 882, 884, 885, 886, 889]
[8, 17, 34, 42, 48, 69, 70, 74, 84, 86, 90, 93, 97, 109, 128, 152, 156, 167, 178, 186, 188, 199, 200, 213, 217, 226, 230, 233, 235, 236, 239, 265, 276, 282, 284, 288, 303, 305, 307, 308, 316, 319, 320, 327, 332, 351, 354, 368, 375, 380, 394, 410, 412, 418, 425, 443, 447, 454, 458, 467, 468, 473, 481, 487, 499, 504, 512, 516, 523, 527, 544, 547, 555, 571, 576, 613, 620, 622, 625, 629, 642, 647, 650, 654, 658, 660, 671, 674, 675, 677, 682, 705, 722, 731, 740, 741, 744, 747, 753, 763, 768, 771, 774, 777, 779, 783, 788, 799, 801, 805, 806, 815, 818, 824, 827, 846, 857, 859, 869, 876, 881, 882]

[1, 2, 3, 4, 5, 6, 7, 8, 9, 11, 12, 14, 15, 16, 18, 19, 20, 22, 24, 25, 27, 29, 30, 31, 32, 33, 34, 35, 37, 38, 40, 41, 42, 43, 44, 45, 46, 47, 48, 49, 51, 52, 53, 54, 55, 56, 57, 59, 60, 61, 64, 65, 67, 69, 70, 73, 74, 75, 77, 79, 81, 83, 85, 87, 88, 89, 90, 91, 92, 93, 95, 96, 97, 98, 100, 102, 104, 105, 106, 107, 108, 109, 111, 112, 113, 114, 115, 116, 117, 118, 121, 122, 125, 126, 127, 131, 133, 134, 135, 136, 137, 138, 140, 141, 142, 144, 145, 146, 148, 149, 151, 152, 154, 156, 157, 158, 159, 160, 161, 162, 164, 167, 168, 169, 171, 172, 176, 177, 179, 181, 182, 183, 184, 190, 192, 193, 194, 196, 197, 198, 199, 201, 202, 203, 204, 205, 206, 207, 209, 210, 213, 214, 216, 217, 219, 220, 222, 223, 224, 225, 226, 228, 229, 232, 233, 234, 235, 236, 237, 238, 239, 240, 241, 243, 246, 248, 249, 251, 253, 254, 255, 256, 258, 260, 261, 262, 263, 265, 266, 267, 269, 270, 271, 272, 275, 277, 278, 279, 281, 282, 283, 284, 285, 286, 287, 288, 292, 293, 294, 296, 297, 298, 299, 301, 302, 304, 305, 306, 307, 308, 309, 311, 312, 313, 314, 315, 317, 319, 321, 322, 323, 325, 327, 328, 329, 331, 334, 337, 338, 339, 340, 342, 344, 347, 349, 350, 351, 352, 354, 355, 356, 357, 358, 360, 361, 362, 364, 365, 366, 367, 368, 369, 370, 371, 372, 373, 377, 378, 380, 382, 384, 385, 386, 388, 389, 391, 392, 393, 394, 395, 398, 399, 400, 401, 403, 405, 407, 410, 411, 412, 413, 415, 416, 417, 421, 422, 424, 426, 427, 428, 430, 434, 435, 436, 437, 438, 439, 440, 441, 442, 443, 444, 445, 448, 449, 450, 452, 453, 456, 457, 458, 460, 461, 462, 464, 466, 468, 469, 470, 473, 475, 476, 477, 478, 482, 485, 486, 488, 489, 490, 491, 493, 495, 496, 497, 498, 499, 502, 504, 505, 506, 507, 508, 509, 511, 512, 513, 515, 516, 517, 518, 519, 520, 521, 522, 524, 526, 527, 528, 529, 530, 531, 535, 536, 537, 538, 539, 540, 544, 545, 546, 547, 549, 551, 553, 554, 555, 556, 557, 558, 559, 560, 561, 564, 565, 568, 569, 572, 574, 576, 577, 578, 582, 584, 585, 586, 588, 589, 590, 591, 592, 595, 596, 597, 598, 599, 600, 601, 602, 603, 604, 606, 607, 608, 609, 610, 613, 614, 615, 616, 617, 618, 620, 621, 622, 624, 625, 626, 627, 628, 629, 632, 633, 634, 635, 636, 637, 638, 639, 641, 642, 643, 647, 648, 650, 651, 653, 654, 655, 659, 660, 661, 662, 664, 665, 666, 668, 669, 670, 672, 673, 674, 675, 676, 679, 680, 681, 682, 683, 684, 686, 687, 688, 689, 691, 692, 693, 694, 695, 697, 698, 699, 700, 701, 702, 703, 704, 705, 708, 709, 711, 712, 715, 716, 717, 720, 721, 724, 725, 727, 728, 730, 732, 733, 734, 735, 736, 737, 740, 741, 742, 743, 745, 747, 748, 751, 752, 753, 754, 755, 756, 757, 758, 759, 760, 761, 763, 764, 765, 768, 769, 770, 771, 774, 775, 776, 777, 779, 781, 782, 783, 785, 786, 787, 788, 791, 792, 793, 794, 795, 796, 797, 798, 799, 800, 801, 802, 803, 804, 805, 807, 808, 809, 810, 811, 812, 813, 814, 816, 817, 818, 819, 821, 822, 823, 824, 828, 829, 830, 831, 832, 833, 834, 835, 836, 837, 840, 841, 843, 845, 846, 847, 850, 852, 853, 855, 856, 857, 858, 860, 863, 864, 865, 866, 867, 868, 870, 871, 872, 873, 875, 878, 879, 880, 882, 884, 885, 886, 887, 889]
[8, 17, 34, 42, 48, 69, 70, 74, 84, 86, 90, 93, 97, 109, 128, 152, 156, 167, 178, 186, 188, 199, 200, 213, 217, 226, 230, 233, 235, 236, 239, 265, 276, 282, 284, 288, 303, 305, 307, 308, 316, 319, 320, 327, 332, 351, 354, 368, 375, 380, 394, 410, 412, 418, 425, 443, 447, 454, 458, 467, 468, 473, 481, 487, 499, 504, 512, 516, 523, 527, 544, 547, 555, 571, 576, 613, 620, 622, 625, 629, 642, 647, 650, 654, 658, 660, 671, 674, 675, 677, 682, 705, 722, 731, 740, 741, 744, 747, 753, 763, 768, 771, 774, 777, 779, 783, 788, 799, 801, 805, 806, 815, 818, 824, 827, 846, 857, 859, 869, 876, 881, 882]

[0, 1, 2, 3, 4, 5, 6, 7, 8, 9, 11, 12, 13, 14, 15, 16, 18, 19, 20, 22, 24, 25, 26, 27, 29, 30, 31, 32, 33, 34, 35, 36, 37, 38, 39, 40, 41, 42, 43, 44, 45, 46, 47, 48, 49, 51, 52, 53, 54, 55, 56, 57, 59, 60, 61, 62, 64, 65, 67, 69, 70, 73, 74, 75, 77, 78, 79, 80, 81, 83, 85, 87, 88, 89, 90, 91, 92, 93, 94, 95, 96, 97, 98, 99, 100, 101, 102, 104, 105, 106, 107, 108, 109, 111, 112, 113, 114, 115, 116, 117, 118, 121, 122, 123, 125, 126, 127, 129, 131, 133, 134, 135, 136, 137, 138, 140, 141, 142, 144, 145, 146, 148, 149, 150, 151, 152, 153, 154, 156, 157, 158, 159, 160, 161, 162, 164, 166, 167, 168, 169, 171, 172, 173, 176, 177, 179, 181, 182, 183, 184, 187, 188, 189, 190, 192, 193, 194, 196, 197, 198, 199, 200, 201, 202, 203, 204, 205, 206, 207, 208, 209, 210, 212, 213, 214, 216, 217, 219, 220, 221, 222, 223, 224, 225, 226, 228, 229, 230, 232, 233, 234, 235, 236, 237, 238, 239, 240, 241, 243, 246, 247, 248, 249, 251, 252, 253, 254, 255, 256, 258, 260, 261, 262, 263, 264, 265, 266, 267, 269, 270, 271, 272, 275, 277, 278, 279, 281, 282, 283, 284, 285, 286, 287, 288, 292, 293, 294, 296, 297, 298, 299, 301, 302, 304, 305, 306, 307, 308, 309, 311, 312, 313, 314, 315, 317, 319, 320, 321, 322, 323, 324, 325, 327, 328, 329, 331, 334, 336, 337, 338, 339, 340, 341, 342, 344, 345, 347, 349, 350, 351, 352, 353, 354, 355, 356, 357, 358, 360, 361, 362, 363, 364, 365, 366, 367, 368, 369, 370, 371, 372, 373, 374, 375, 377, 378, 380, 382, 384, 385, 386, 388, 389, 391, 392, 393, 394, 395, 397, 398, 399, 400, 401, 403, 404, 405, 407, 409, 410, 411, 412, 413, 415, 416, 417, 420, 421, 422, 423, 424, 425, 426, 427, 428, 429, 430, 433, 434, 435, 436, 437, 438, 439, 440, 441, 442, 443, 444, 445, 448, 449, 450, 452, 453, 456, 457, 458, 460, 461, 462, 463, 464, 466, 468, 469, 470, 472, 473, 475, 476, 477, 478, 481, 482, 485, 486, 487, 488, 489, 490, 491, 493, 494, 495, 496, 497, 498, 499, 500, 502, 504, 505, 506, 507, 508, 509, 511, 512, 513, 515, 516, 517, 518, 519, 520, 521, 522, 524, 526, 527, 528, 529, 530, 531, 534, 535, 536, 537, 538, 539, 540, 544, 545, 546, 547, 549, 551, 552, 553, 554, 555, 556, 557, 558, 559, 560, 561, 563, 564, 565, 566, 567, 568, 569, 572, 574, 576, 577, 578, 582, 583, 584, 585, 586, 588, 589, 590, 591, 592, 595, 596, 597, 598, 599, 600, 601, 602, 603, 604, 605, 606, 607, 608, 609, 610, 613, 614, 615, 616, 617, 618, 620, 621, 622, 624, 625, 626, 627, 628, 629, 632, 633, 634, 635, 636, 637, 638, 639, 641, 642, 643, 645, 646, 647, 648, 649, 650, 651, 653, 654, 655, 656, 657, 659, 660, 661, 662, 664, 665, 666, 668, 669, 670, 672, 673, 674, 675, 676, 677, 679, 680, 681, 682, 683, 684, 686, 687, 688, 689, 691, 692, 693, 694, 695, 697, 698, 699, 700, 701, 702, 703, 704, 705, 708, 709, 711, 712, 714, 715, 716, 717, 720, 721, 724, 725, 726, 727, 728, 730, 732, 733, 734, 735, 736, 737, 739, 740, 741, 742, 743, 745, 747, 748, 751, 752, 753, 754, 755, 756, 757, 758, 759, 760, 761, 763, 764, 765, 766, 767, 768, 769, 770, 771, 772, 774, 775, 776, 777, 779, 781, 782, 783, 785, 786, 787, 788, 789, 790, 791, 792, 793, 794, 795, 796, 797, 798, 799, 800, 801, 802, 803, 804, 805, 807, 808, 809, 810, 811, 812, 813, 814, 816, 817, 818, 819, 821, 822, 823, 824, 826, 828, 829, 830, 831, 832, 833, 834, 835, 836, 837, 839, 840, 841, 843, 844, 845, 846, 847, 848, 850, 852, 853, 855, 856, 857, 858, 859, 860, 861, 863, 864, 865, 866, 867, 868, 870, 871, 872, 873, 875, 878, 879, 880, 882, 883, 884, 885, 886, 887, 889]
[8, 17, 34, 42, 48, 69, 70, 74, 84, 86, 90, 93, 97, 109, 128, 152, 156, 167, 178, 186, 188, 199, 200, 213, 217, 226, 230, 233, 235, 236, 239, 265, 276, 282, 284, 288, 303, 305, 307, 308, 316, 319, 320, 327, 332, 351, 354, 368, 375, 380, 394, 410, 412, 418, 425, 443, 447, 454, 458, 467, 468, 473, 481, 487, 499, 504, 512, 516, 523, 527, 544, 547, 555, 571, 576, 613, 620, 622, 625, 629, 642, 647, 650, 654, 658, 660, 671, 674, 675, 677, 682, 705, 722, 731, 740, 741, 744, 747, 753, 763, 768, 771, 774, 777, 779, 783, 788, 799, 801, 805, 806, 815, 818, 824, 827, 846, 857, 859, 869, 876, 881, 882]

[0, 1, 2, 3, 4, 5, 6, 7, 8, 9, 10, 11, 12, 13, 14, 15, 16, 18, 19, 20, 21, 22, 24, 25, 26, 27, 28, 29, 30, 31, 32, 33, 34, 35, 36, 37, 38, 39, 40, 41, 42, 43, 44, 45, 46, 47, 48, 49, 50, 51, 52, 53, 54, 55, 56, 57, 59, 60, 61, 62, 64, 65, 67, 68, 69, 70, 72, 73, 74, 75, 77, 78, 79, 80, 81, 83, 84, 85, 87, 88, 89, 90, 91, 92, 93, 94, 95, 96, 97, 98, 99, 100, 101, 102, 103, 104, 105, 106, 107, 108, 109, 111, 112, 113, 114, 115, 116, 117, 118, 121, 122, 123, 125, 126, 127, 129, 130, 131, 133, 134, 135, 136, 137, 138, 140, 141, 142, 144, 145, 146, 148, 149, 150, 151, 152, 153, 154, 155, 156, 157, 158, 159, 160, 161, 162, 164, 165, 166, 167, 168, 169, 171, 172, 173, 174, 175, 176, 177, 178, 179, 180, 181, 182, 183, 184, 187, 188, 189, 190, 192, 193, 194, 195, 196, 197, 198, 199, 200, 201, 202, 203, 204, 205, 206, 207, 208, 209, 210, 211, 212, 213, 214, 215, 216, 217, 218, 219, 220, 221, 222, 223, 224, 225, 226, 228, 229, 230, 232, 233, 234, 235, 236, 237, 238, 239, 240, 241, 242, 243, 245, 246, 247, 248, 249, 251, 252, 253, 254, 255, 256, 257, 258, 260, 261, 262, 263, 264, 265, 266, 267, 268, 269, 270, 271, 272, 273, 274, 275, 277, 278, 279, 281, 282, 283, 284, 285, 286, 287, 288, 290, 291, 292, 293, 294, 295, 296, 297, 298, 299, 300, 301, 302, 304, 305, 306, 307, 308, 309, 311, 312, 313, 314, 315, 317, 318, 319, 320, 321, 322, 323, 324, 325, 327, 328, 329, 330, 331, 332, 333, 334, 335, 336, 337, 338, 339, 340, 341, 342, 343, 344, 345, 347, 349, 350, 351, 352, 353, 354, 355, 356, 357, 358, 360, 361, 362, 363, 364, 365, 366, 367, 368, 369, 370, 371, 372, 373, 374, 375, 376, 377, 378, 380, 382, 384, 385, 386, 388, 389, 390, 391, 392, 393, 394, 395, 396, 397, 398, 399, 400, 401, 403, 404, 405, 407, 409, 410, 411, 412, 413, 414, 415, 416, 417, 418, 420, 421, 422, 423, 424, 425, 426, 427, 428, 429, 430, 433, 434, 435, 436, 437, 438, 439, 440, 441, 442, 443, 444, 445, 446, 448, 449, 450, 452, 453, 455, 456, 457, 458, 460, 461, 462, 463, 464, 465, 466, 467, 468, 469, 470, 472, 473, 474, 475, 476, 477, 478, 479, 481, 482, 483, 484, 485, 486, 487, 488, 489, 490, 491, 493, 494, 495, 496, 497, 498, 499, 500, 501, 502, 504, 505, 506, 507, 508, 509, 511, 512, 513, 515, 516, 517, 518, 519, 520, 521, 522, 524, 526, 527, 528, 529, 530, 531, 532, 534, 535, 536, 537, 538, 539, 540, 542, 544, 545, 546, 547, 549, 551, 552, 553, 554, 555, 556, 557, 558, 559, 560, 561, 562, 563, 564, 565, 566, 567, 568, 569, 570, 572, 574, 575, 576, 577, 578, 579, 582, 583, 584, 585, 586, 588, 589, 590, 591, 592, 593, 595, 596, 597, 598, 599, 600, 601, 602, 603, 604, 605, 606, 607, 608, 609, 610, 613, 614, 615, 616, 617, 618, 619, 620, 621, 622, 624, 625, 626, 627, 628, 629, 632, 633, 634, 635, 636, 637, 638, 639, 640, 641, 642, 643, 645, 646, 647, 648, 649, 650, 651, 653, 654, 655, 656, 657, 658, 659, 660, 661, 662, 664, 665, 666, 668, 669, 670, 671, 672, 673, 674, 675, 676, 677, 678, 679, 680, 681, 682, 683, 684, 686, 687, 688, 689, 691, 692, 693, 694, 695, 697, 698, 699, 700, 701, 702, 703, 704, 705, 708, 709, 711, 712, 714, 715, 716, 717, 720, 721, 724, 725, 726, 727, 728, 729, 730, 732, 733, 734, 735, 736, 737, 738, 739, 740, 741, 742, 743, 745, 747, 748, 749, 750, 751, 752, 753, 754, 755, 756, 757, 758, 759, 760, 761, 762, 763, 764, 765, 766, 767, 768, 769, 770, 771, 772, 774, 775, 776, 777, 779, 780, 781, 782, 783, 784, 785, 786, 787, 788, 789, 790, 791, 792, 793, 794, 795, 796, 797, 798, 799, 800, 801, 802, 803, 804, 805, 807, 808, 809, 810, 811, 812, 813, 814, 816, 817, 818, 819, 821, 822, 823, 824, 826, 827, 828, 829, 830, 831, 832, 833, 834, 835, 836, 837, 838, 839, 840, 841, 843, 844, 845, 846, 847, 848, 850, 851, 852, 853, 855, 856, 857, 858, 859, 860, 861, 862, 863, 864, 865, 866, 867, 868, 869, 870, 871, 872, 873, 874, 875, 877, 878, 879, 880, 882, 883, 884, 885, 886, 887, 888, 889]
[8, 17, 34, 42, 48, 69, 70, 74, 84, 86, 90, 93, 97, 109, 128, 152, 156, 167, 178, 186, 188, 199, 200, 213, 217, 226, 230, 233, 235, 236, 239, 265, 276, 282, 284, 288, 303, 305, 307, 308, 316, 319, 320, 327, 332, 351, 354, 368, 375, 380, 394, 410, 412, 418, 425, 443, 447, 454, 458, 467, 468, 473, 481, 487, 499, 504, 512, 516, 523, 527, 544, 547, 555, 571, 576, 613, 620, 622, 625, 629, 642, 647, 650, 654, 658, 660, 671, 674, 675, 677, 682, 705, 722, 731, 740, 741, 744, 747, 753, 763, 768, 771, 774, 777, 779, 783, 788, 799, 801, 805, 806, 815, 818, 824, 827, 846, 857, 859, 869, 876, 881, 882]

