[123, 145, 167, 193, 207, 341, 350, 375, 377, 393, 394, 442, 480, 485, 562, 617, 619, 644, 699, 737, 875, 883]
[31, 78, 87, 90, 225, 226, 230, 296, 374, 434, 454, 476, 506, 516, 521, 622, 685, 703, 765, 787, 814, 864]

[123, 145, 167, 193, 207, 341, 350, 375, 377, 393, 394, 442, 480, 485, 562, 617, 619, 644, 699, 737, 875, 883]
[17, 31, 34, 40, 50, 56, 63, 69, 73, 78, 81, 87, 90, 104, 119, 120, 125, 127, 137, 164, 199, 210, 213, 219, 225, 226, 230, 237, 243, 263, 284, 286, 296, 297, 304, 308, 335, 336, 357, 365, 366, 368, 374, 387, 392, 398, 399, 403, 410, 414, 430, 434, 435, 451, 453, 454, 463, 464, 476, 489, 495, 506, 514, 516, 519, 521, 530, 532, 533, 537, 538, 539, 542, 547, 557, 560, 564, 572, 598, 604, 606, 622, 623, 626, 655, 665, 667, 669, 672, 676, 685, 689, 690, 692, 697, 703, 705, 706, 726, 732, 739, 750, 751, 755, 756, 760, 762, 765, 771, 773, 774, 787, 793, 802, 809, 814, 836, 839, 842, 861, 864, 872]

[3, 7, 8, 20, 24, 38, 44, 53, 65, 68, 73, 75, 77, 89, 101, 108, 123, 125, 138, 145, 167, 187, 193, 203, 204, 206, 207, 212, 223, 240, 252, 256, 283, 288, 295, 298, 308, 310, 340, 341, 350, 358, 360, 375, 377, 393, 394, 396, 410, 442, 446, 447, 462, 466, 473, 480, 485, 488, 506, 510, 512, 545, 549, 553, 562, 589, 600, 617, 619, 627, 644, 657, 658, 662, 680, 685, 699, 710, 716, 718, 737, 738, 748, 754, 758, 785, 790, 814, 815, 840, 846, 857, 860, 866, 874, 875, 883]
[17, 31, 34, 40, 50, 56, 63, 69, 73, 78, 81, 87, 90, 104, 119, 120, 125, 127, 137, 164, 199, 210, 213, 219, 225, 226, 230, 237, 243, 263, 284, 286, 296, 297, 304, 308, 335, 336, 357, 365, 366, 368, 374, 387, 392, 398, 399, 403, 410, 414, 430, 434, 435, 451, 453, 454, 463, 464, 476, 489, 495, 506, 514, 516, 519, 521, 530, 532, 533, 537, 538, 539, 542, 547, 557, 560, 564, 572, 598, 604, 606, 622, 623, 626, 655, 665, 667, 669, 672, 676, 685, 689, 690, 692, 697, 703, 705, 706, 726, 732, 739, 750, 751, 755, 756, 760, 762, 765, 771, 773, 774, 787, 793, 802, 809, 814, 836, 839, 842, 861, 864, 872]

[3, 7, 8, 20, 24, 38, 40, 44, 46, 49, 53, 58, 65, 68, 69, 73, 75, 77, 81, 85, 89, 96, 101, 108, 110, 111, 123, 125, 138, 145, 146, 152, 162, 167, 168, 176, 181, 187, 193, 195, 201, 203, 204, 206, 207, 212, 223, 224, 226, 235, 240, 252, 255, 256, 261, 267, 276, 283, 288, 295, 298, 301, 306, 308, 310, 316, 323, 340, 341, 348, 350, 358, 360, 370, 371, 372, 375, 377, 393, 394, 396, 400, 410, 420, 427, 433, 437, 441, 442, 446, 447, 456, 462, 464, 466, 469, 473, 478, 480, 485, 488, 490, 499, 505, 506, 510, 512, 514, 515, 518, 521, 545, 549, 553, 555, 562, 580, 583, 589, 600, 604, 607, 617, 619, 627, 630, 637, 644, 656, 657, 658, 662, 666, 680, 685, 699, 710, 716, 718, 737, 738, 748, 751, 753, 754, 758, 762, 765, 772, 781, 785, 790, 796, 799, 814, 815, 821, 840, 844, 846, 853, 857, 859, 860, 864, 866, 869, 874, 875, 883, 887, 889]
[17, 31, 34, 40, 50, 56, 63, 69, 73, 78, 81, 87, 90, 104, 119, 120, 125, 127, 137, 164, 199, 210, 213, 219, 225, 226, 230, 237, 243, 263, 284, 286, 296, 297, 304, 308, 335, 336, 357, 365, 366, 368, 374, 387, 392, 398, 399, 403, 410, 414, 430, 434, 435, 451, 453, 454, 463, 464, 476, 489, 495, 506, 514, 516, 519, 521, 530, 532, 533, 537, 538, 539, 542, 547, 557, 560, 564, 572, 598, 604, 606, 622, 623, 626, 655, 665, 667, 669, 672, 676, 685, 689, 690, 692, 697, 703, 705, 706, 726, 732, 739, 750, 751, 755, 756, 760, 762, 765, 771, 773, 774, 787, 793, 802, 809, 814, 836, 839, 842, 861, 864, 872]

[3, 7, 8, 13, 18, 20, 24, 37, 38, 40, 41, 44, 45, 46, 49, 51, 53, 58, 59, 60, 65, 68, 69, 72, 73, 75, 77, 81, 83, 85, 89, 96, 97, 99, 100, 101, 103, 104, 108, 110, 111, 117, 123, 125, 128, 136, 138, 142, 145, 146, 152, 156, 162, 167, 168, 176, 181, 187, 193, 195, 198, 201, 203, 204, 206, 207, 212, 215, 223, 224, 226, 233, 235, 237, 239, 240, 252, 255, 256, 261, 267, 273, 276, 278, 283, 288, 292, 295, 297, 298, 301, 304, 306, 308, 310, 311, 312, 316, 323, 340, 341, 348, 350, 353, 358, 359, 360, 370, 371, 372, 375, 377, 379, 382, 383, 390, 392, 393, 394, 396, 400, 410, 414, 420, 427, 432, 433, 437, 441, 442, 443, 446, 447, 456, 461, 462, 464, 466, 469, 473, 474, 478, 480, 485, 488, 490, 491, 499, 505, 506, 509, 510, 512, 514, 515, 518, 521, 529, 533, 539, 545, 549, 550, 553, 555, 562, 565, 571, 580, 581, 583, 589, 600, 604, 607, 613, 617, 619, 623, 624, 627, 630, 637, 644, 647, 656, 657, 658, 662, 663, 666, 676, 680, 682, 685, 699, 705, 710, 716, 718, 720, 726, 733, 734, 737, 738, 748, 751, 753, 754, 758, 762, 765, 772, 778, 781, 785, 790, 795, 796, 799, 808, 814, 815, 821, 822, 840, 843, 844, 846, 847, 850, 852, 853, 854, 857, 859, 860, 864, 866, 869, 874, 875, 883, 884, 887, 889]
[17, 31, 34, 40, 50, 56, 63, 69, 73, 78, 81, 87, 90, 104, 119, 120, 125, 127, 137, 164, 199, 210, 213, 219, 225, 226, 230, 237, 243, 263, 284, 286, 296, 297, 304, 308, 335, 336, 357, 365, 366, 368, 374, 387, 392, 398, 399, 403, 410, 414, 430, 434, 435, 451, 453, 454, 463, 464, 476, 489, 495, 506, 514, 516, 519, 521, 530, 532, 533, 537, 538, 539, 542, 547, 557, 560, 564, 572, 598, 604, 606, 622, 623, 626, 655, 665, 667, 669, 672, 676, 685, 689, 690, 692, 697, 703, 705, 706, 726, 732, 739, 750, 751, 755, 756, 760, 762, 765, 771, 773, 774, 787, 793, 802, 809, 814, 836, 839, 842, 861, 864, 872]

[3, 4, 7, 8, 11, 13, 14, 18, 20, 21, 24, 28, 36, 37, 38, 40, 41, 44, 45, 46, 49, 51, 53, 58, 59, 60, 65, 67, 68, 69, 72, 73, 75, 77, 81, 83, 85, 89, 92, 96, 97, 99, 100, 101, 103, 104, 108, 110, 111, 117, 120, 122, 123, 125, 127, 128, 131, 132, 135, 136, 138, 140, 142, 145, 146, 152, 156, 162, 167, 168, 171, 175, 176, 178, 179, 181, 184, 185, 187, 192, 193, 195, 196, 198, 201, 203, 204, 206, 207, 212, 215, 221, 223, 224, 226, 233, 235, 237, 239, 240, 252, 255, 256, 261, 267, 273, 275, 276, 278, 279, 283, 288, 292, 293, 295, 297, 298, 301, 304, 306, 308, 310, 311, 312, 313, 316, 321, 323, 337, 340, 341, 348, 350, 352, 353, 358, 359, 360, 367, 370, 371, 372, 373, 375, 377, 379, 382, 383, 384, 386, 390, 392, 393, 394, 396, 400, 410, 414, 415, 420, 421, 427, 428, 432, 433, 437, 438, 441, 442, 443, 446, 447, 453, 455, 456, 457, 461, 462, 464, 466, 467, 469, 473, 474, 475, 478, 480, 485, 486, 488, 490, 491, 499, 505, 506, 508, 509, 510, 512, 514, 515, 518, 521, 529, 532, 533, 536, 538, 539, 542, 544, 545, 549, 550, 553, 555, 562, 565, 571, 580, 581, 583, 589, 600, 601, 604, 607, 613, 617, 619, 621, 622, 623, 624, 627, 630, 633, 637, 641, 642, 644, 646, 647, 652, 654, 656, 657, 658, 662, 663, 664, 666, 670, 672, 676, 678, 679, 680, 682, 684, 685, 688, 699, 704, 705, 708, 710, 716, 718, 720, 726, 730, 733, 734, 737, 738, 740, 748, 751, 753, 754, 758, 762, 765, 772, 778, 781, 785, 790, 795, 796, 799, 801, 808, 814, 815, 820, 821, 822, 840, 841, 842, 843, 844, 846, 847, 850, 852, 853, 854, 857, 859, 860, 864, 866, 869, 874, 875, 883, 884, 887, 889]
[17, 31, 34, 40, 50, 56, 63, 69, 73, 78, 81, 87, 90, 104, 119, 120, 125, 127, 137, 164, 199, 210, 213, 219, 225, 226, 230, 237, 243, 263, 284, 286, 296, 297, 304, 308, 335, 336, 357, 365, 366, 368, 374, 387, 392, 398, 399, 403, 410, 414, 430, 434, 435, 451, 453, 454, 463, 464, 476, 489, 495, 506, 514, 516, 519, 521, 530, 532, 533, 537, 538, 539, 542, 547, 557, 560, 564, 572, 598, 604, 606, 622, 623, 626, 655, 665, 667, 669, 672, 676, 685, 689, 690, 692, 697, 703, 705, 706, 726, 732, 739, 750, 751, 755, 756, 760, 762, 765, 771, 773, 774, 787, 793, 802, 809, 814, 836, 839, 842, 861, 864, 872]

[2, 3, 4, 7, 8, 11, 13, 14, 15, 18, 20, 21, 23, 24, 28, 36, 37, 38, 39, 40, 41, 44, 45, 46, 49, 51, 53, 56, 58, 59, 60, 63, 65, 67, 68, 69, 71, 72, 73, 75, 77, 81, 83, 85, 89, 92, 96, 97, 99, 100, 101, 103, 104, 108, 110, 111, 113, 117, 119, 120, 122, 123, 125, 127, 128, 131, 132, 135, 136, 138, 140, 141, 142, 143, 145, 146, 152, 156, 162, 167, 168, 171, 175, 176, 178, 179, 181, 184, 185, 187, 192, 193, 195, 196, 198, 201, 203, 204, 206, 207, 212, 215, 216, 220, 221, 223, 224, 226, 227, 233, 235, 237, 239, 240, 252, 255, 256, 259, 261, 267, 273, 275, 276, 278, 279, 283, 288, 292, 293, 295, 297, 298, 300, 301, 304, 305, 306, 308, 309, 310, 311, 312, 313, 316, 321, 323, 326, 328, 333, 337, 340, 341, 348, 350, 351, 352, 353, 357, 358, 359, 360, 362, 363, 365, 367, 370, 371, 372, 373, 375, 377, 379, 382, 383, 384, 386, 387, 390, 392, 393, 394, 396, 400, 410, 412, 414, 415, 420, 421, 425, 427, 428, 431, 432, 433, 437, 438, 439, 441, 442, 443, 446, 447, 452, 453, 455, 456, 457, 461, 462, 464, 466, 467, 469, 472, 473, 474, 475, 476, 478, 480, 481, 485, 486, 487, 488, 490, 491, 494, 497, 499, 505, 506, 508, 509, 510, 512, 514, 515, 518, 519, 521, 523, 529, 532, 533, 534, 536, 538, 539, 541, 542, 544, 545, 549, 550, 553, 555, 559, 560, 561, 562, 565, 571, 580, 581, 583, 589, 600, 601, 604, 605, 607, 611, 613, 617, 618, 619, 620, 621, 622, 623, 624, 627, 628, 630, 633, 634, 637, 641, 642, 644, 646, 647, 649, 651, 652, 654, 655, 656, 657, 658, 661, 662, 663, 664, 666, 670, 672, 676, 678, 679, 680, 681, 682, 684, 685, 688, 695, 699, 704, 705, 708, 710, 716, 718, 720, 726, 730, 733, 734, 737, 738, 740, 742, 743, 748, 751, 753, 754, 755, 756, 758, 762, 764, 765, 767, 771, 772, 774, 778, 781, 785, 789, 790, 795, 796, 799, 800, 801, 808, 814, 815, 818, 820, 821, 822, 825, 827, 837, 840, 841, 842, 843, 844, 846, 847, 850, 852, 853, 854, 856, 857, 859, 860, 864, 865, 866, 869, 874, 875, 878, 879, 883, 884, 887, 889]
[17, 31, 34, 40, 50, 56, 63, 69, 73, 78, 81, 87, 90, 104, 119, 120, 125, 127, 137, 164, 199, 210, 213, 219, 225, 226, 230, 237, 243, 263, 284, 286, 296, 297, 304, 308, 335, 336, 357, 365, 366, 368, 374, 387, 392, 398, 399, 403, 410, 414, 430, 434, 435, 451, 453, 454, 463, 464, 476, 489, 495, 506, 514, 516, 519, 521, 530, 532, 533, 537, 538, 539, 542, 547, 557, 560, 564, 572, 598, 604, 606, 622, 623, 626, 655, 665, 667, 669, 672, 676, 685, 689, 690, 692, 697, 703, 705, 706, 726, 732, 739, 750, 751, 755, 756, 760, 762, 765, 771, 773, 774, 787, 793, 802, 809, 814, 836, 839, 842, 861, 864, 872]

[2, 3, 4, 7, 8, 11, 12, 13, 14, 15, 18, 20, 21, 23, 24, 26, 28, 29, 34, 35, 36, 37, 38, 39, 40, 41, 44, 45, 46, 49, 51, 53, 56, 58, 59, 60, 63, 65, 67, 68, 69, 70, 71, 72, 73, 75, 77, 78, 81, 83, 85, 89, 90, 92, 93, 96, 97, 99, 100, 101, 103, 104, 107, 108, 110, 111, 113, 114, 117, 119, 120, 122, 123, 125, 127, 128, 129, 131, 132, 135, 136, 138, 140, 141, 142, 143, 145, 146, 149, 152, 153, 156, 162, 167, 168, 171, 175, 176, 178, 179, 181, 184, 185, 187, 189, 192, 193, 194, 195, 196, 198, 200, 201, 202, 203, 204, 206, 207, 208, 212, 213, 215, 216, 220, 221, 223, 224, 226, 227, 229, 233, 235, 237, 238, 239, 240, 241, 251, 252, 255, 256, 258, 259, 261, 265, 267, 273, 275, 276, 278, 279, 283, 287, 288, 292, 293, 295, 297, 298, 300, 301, 304, 305, 306, 308, 309, 310, 311, 312, 313, 316, 321, 323, 326, 328, 330, 332, 333, 337, 338, 340, 341, 348, 350, 351, 352, 353, 357, 358, 359, 360, 362, 363, 365, 367, 368, 370, 371, 372, 373, 375, 376, 377, 379, 382, 383, 384, 386, 387, 390, 392, 393, 394, 396, 400, 410, 411, 412, 413, 414, 415, 417, 420, 421, 425, 427, 428, 431, 432, 433, 436, 437, 438, 439, 441, 442, 443, 446, 447, 452, 453, 455, 456, 457, 461, 462, 464, 466, 467, 469, 472, 473, 474, 475, 476, 478, 480, 481, 485, 486, 487, 488, 490, 491, 494, 497, 499, 505, 506, 508, 509, 510, 512, 513, 514, 515, 516, 518, 519, 521, 523, 529, 532, 533, 534, 536, 538, 539, 540, 541, 542, 544, 545, 549, 550, 553, 554, 555, 559, 560, 561, 562, 565, 571, 576, 580, 581, 583, 589, 593, 600, 601, 602, 604, 605, 607, 608, 609, 610, 611, 613, 615, 616, 617, 618, 619, 620, 621, 622, 623, 624, 625, 627, 628, 630, 633, 634, 637, 641, 642, 643, 644, 646, 647, 649, 651, 652, 653, 654, 655, 656, 657, 658, 659, 661, 662, 663, 664, 666, 668, 670, 672, 673, 676, 678, 679, 680, 681, 682, 684, 685, 688, 691, 692, 693, 695, 698, 699, 704, 705, 707, 708, 710, 716, 717, 718, 720, 725, 726, 730, 733, 734, 737, 738, 739, 740, 741, 742, 743, 748, 751, 753, 754, 755, 756, 758, 762, 764, 765, 767, 769, 771, 772, 774, 778, 781, 785, 786, 789, 790, 792, 795, 796, 798, 799, 800, 801, 807, 808, 814, 815, 818, 820, 821, 822, 824, 825, 827, 831, 833, 837, 839, 840, 841, 842, 843, 844, 846, 847, 850, 852, 853, 854, 856, 857, 859, 860, 864, 865, 866, 869, 874, 875, 877, 878, 879, 883, 884, 885, 886, 887, 889]
[17, 31, 34, 40, 50, 56, 63, 69, 73, 78, 81, 87, 90, 104, 119, 120, 125, 127, 137, 164, 199, 210, 213, 219, 225, 226, 230, 237, 243, 263, 284, 286, 296, 297, 304, 308, 335, 336, 357, 365, 366, 368, 374, 387, 392, 398, 399, 403, 410, 414, 430, 434, 435, 451, 453, 454, 463, 464, 476, 489, 495, 506, 514, 516, 519, 521, 530, 532, 533, 537, 538, 539, 542, 547, 557, 560, 564, 572, 598, 604, 606, 622, 623, 626, 655, 665, 667, 669, 672, 676, 685, 689, 690, 692, 697, 703, 705, 706, 726, 732, 739, 750, 751, 755, 756, 760, 762, 765, 771, 773, 774, 787, 793, 802, 809, 814, 836, 839, 842, 861, 864, 872]

[1, 2, 3, 4, 5, 7, 8, 11, 12, 13, 14, 15, 18, 20, 21, 23, 24, 25, 26, 28, 29, 33, 34, 35, 36, 37, 38, 39, 40, 41, 44, 45, 46, 49, 51, 53, 55, 56, 58, 59, 60, 63, 65, 66, 67, 68, 69, 70, 71, 72, 73, 75, 77, 78, 79, 80, 81, 83, 84, 85, 89, 90, 92, 93, 96, 97, 98, 99, 100, 101, 103, 104, 106, 107, 108, 109, 110, 111, 113, 114, 117, 119, 120, 121, 122, 123, 125, 127, 128, 129, 130, 131, 132, 135, 136, 138, 140, 141, 142, 143, 145, 146, 147, 149, 152, 153, 156, 157, 159, 160, 162, 164, 167, 168, 171, 173, 174, 175, 176, 178, 179, 181, 183, 184, 185, 187, 189, 192, 193, 194, 195, 196, 198, 199, 200, 201, 202, 203, 204, 206, 207, 208, 210, 212, 213, 215, 216, 220, 221, 223, 224, 226, 227, 229, 232, 233, 235, 237, 238, 239, 240, 241, 251, 252, 255, 256, 258, 259, 261, 265, 266, 267, 273, 275, 276, 278, 279, 281, 283, 286, 287, 288, 289, 291, 292, 293, 295, 297, 298, 300, 301, 302, 304, 305, 306, 308, 309, 310, 311, 312, 313, 316, 318, 321, 322, 323, 325, 326, 327, 328, 330, 332, 333, 337, 338, 340, 341, 343, 348, 350, 351, 352, 353, 356, 357, 358, 359, 360, 362, 363, 364, 365, 367, 368, 370, 371, 372, 373, 375, 376, 377, 379, 381, 382, 383, 384, 385, 386, 387, 390, 392, 393, 394, 395, 396, 399, 400, 401, 410, 411, 412, 413, 414, 415, 417, 420, 421, 424, 425, 426, 427, 428, 431, 432, 433, 436, 437, 438, 439, 440, 441, 442, 443, 446, 447, 448, 452, 453, 455, 456, 457, 458, 461, 462, 464, 466, 467, 469, 472, 473, 474, 475, 476, 478, 479, 480, 481, 485, 486, 487, 488, 489, 490, 491, 494, 497, 499, 500, 505, 506, 508, 509, 510, 512, 513, 514, 515, 516, 518, 519, 521, 523, 526, 529, 532, 533, 534, 536, 538, 539, 540, 541, 542, 544, 545, 549, 550, 551, 553, 554, 555, 559, 560, 561, 562, 563, 565, 571, 576, 580, 581, 583, 585, 586, 587, 589, 593, 595, 600, 601, 602, 604, 605, 607, 608, 609, 610, 611, 612, 613, 615, 616, 617, 618, 619, 620, 621, 622, 623, 624, 625, 627, 628, 630, 633, 634, 637, 641, 642, 643, 644, 646, 647, 649, 651, 652, 653, 654, 655, 656, 657, 658, 659, 661, 662, 663, 664, 666, 667, 668, 669, 670, 672, 673, 674, 676, 678, 679, 680, 681, 682, 684, 685, 687, 688, 689, 691, 692, 693, 695, 698, 699, 704, 705, 707, 708, 710, 712, 713, 716, 717, 718, 720, 721, 725, 726, 730, 733, 734, 737, 738, 739, 740, 741, 742, 743, 745, 748, 751, 753, 754, 755, 756, 758, 762, 763, 764, 765, 766, 767, 769, 771, 772, 774, 777, 778, 781, 785, 786, 789, 790, 792, 793, 795, 796, 798, 799, 800, 801, 807, 808, 814, 815, 818, 820, 821, 822, 824, 825, 827, 829, 831, 833, 834, 837, 839, 840, 841, 842, 843, 844, 846, 847, 850, 852, 853, 854, 856, 857, 859, 860, 864, 865, 866, 869, 874, 875, 876, 877, 878, 879, 883, 884, 885, 886, 887, 889]
[17, 31, 34, 40, 50, 56, 63, 69, 73, 78, 81, 87, 90, 104, 119, 120, 125, 127, 137, 164, 199, 210, 213, 219, 225, 226, 230, 237, 243, 263, 284, 286, 296, 297, 304, 308, 335, 336, 357, 365, 366, 368, 374, 387, 392, 398, 399, 403, 410, 414, 430, 434, 435, 451, 453, 454, 463, 464, 476, 489, 495, 506, 514, 516, 519, 521, 530, 532, 533, 537, 538, 539, 542, 547, 557, 560, 564, 572, 598, 604, 606, 622, 623, 626, 655, 665, 667, 669, 672, 676, 685, 689, 690, 692, 697, 703, 705, 706, 726, 732, 739, 750, 751, 755, 756, 760, 762, 765, 771, 773, 774, 787, 793, 802, 809, 814, 836, 839, 842, 861, 864, 872]

[0, 1, 2, 3, 4, 5, 7, 8, 11, 12, 13, 14, 15, 18, 20, 21, 23, 24, 25, 26, 27, 28, 29, 31, 33, 34, 35, 36, 37, 38, 39, 40, 41, 42, 44, 45, 46, 47, 49, 51, 52, 53, 54, 55, 56, 58, 59, 60, 62, 63, 65, 66, 67, 68, 69, 70, 71, 72, 73, 75, 77, 78, 79, 80, 81, 82, 83, 84, 85, 89, 90, 92, 93, 96, 97, 98, 99, 100, 101, 103, 104, 106, 107, 108, 109, 110, 111, 112, 113, 114, 117, 118, 119, 120, 121, 122, 123, 125, 127, 128, 129, 130, 131, 132, 134, 135, 136, 138, 140, 141, 142, 143, 145, 146, 147, 149, 150, 152, 153, 154, 156, 157, 159, 160, 162, 164, 167, 168, 169, 171, 172, 173, 174, 175, 176, 178, 179, 181, 183, 184, 185, 187, 188, 189, 190, 192, 193, 194, 195, 196, 198, 199, 200, 201, 202, 203, 204, 206, 207, 208, 210, 212, 213, 214, 215, 216, 220, 221, 223, 224, 225, 226, 227, 229, 232, 233, 235, 237, 238, 239, 240, 241, 248, 250, 251, 252, 255, 256, 257, 258, 259, 261, 262, 263, 265, 266, 267, 273, 275, 276, 278, 279, 281, 282, 283, 284, 286, 287, 288, 289, 291, 292, 293, 295, 297, 298, 299, 300, 301, 302, 303, 304, 305, 306, 308, 309, 310, 311, 312, 313, 316, 318, 319, 321, 322, 323, 325, 326, 327, 328, 330, 332, 333, 337, 338, 340, 341, 343, 344, 345, 346, 347, 348, 350, 351, 352, 353, 355, 356, 357, 358, 359, 360, 362, 363, 364, 365, 367, 368, 370, 371, 372, 373, 375, 376, 377, 379, 381, 382, 383, 384, 385, 386, 387, 390, 392, 393, 394, 395, 396, 399, 400, 401, 403, 408, 410, 411, 412, 413, 414, 415, 417, 419, 420, 421, 423, 424, 425, 426, 427, 428, 431, 432, 433, 435, 436, 437, 438, 439, 440, 441, 442, 443, 445, 446, 447, 448, 449, 450, 452, 453, 455, 456, 457, 458, 461, 462, 464, 466, 467, 469, 471, 472, 473, 474, 475, 476, 477, 478, 479, 480, 481, 483, 485, 486, 487, 488, 489, 490, 491, 494, 497, 499, 500, 505, 506, 507, 508, 509, 510, 511, 512, 513, 514, 515, 516, 518, 519, 520, 521, 523, 526, 527, 528, 529, 532, 533, 534, 536, 538, 539, 540, 541, 542, 544, 545, 546, 549, 550, 551, 552, 553, 554, 555, 558, 559, 560, 561, 562, 563, 565, 568, 569, 571, 576, 580, 581, 583, 585, 586, 587, 589, 593, 595, 600, 601, 602, 604, 605, 607, 608, 609, 610, 611, 612, 613, 615, 616, 617, 618, 619, 620, 621, 622, 623, 624, 625, 627, 628, 629, 630, 633, 634, 637, 641, 642, 643, 644, 645, 646, 647, 649, 650, 651, 652, 653, 654, 655, 656, 657, 658, 659, 661, 662, 663, 664, 666, 667, 668, 669, 670, 671, 672, 673, 674, 676, 678, 679, 680, 681, 682, 684, 685, 686, 687, 688, 689, 690, 691, 692, 693, 694, 695, 698, 699, 704, 705, 707, 708, 710, 712, 713, 716, 717, 718, 720, 721, 723, 725, 726, 730, 731, 733, 734, 737, 738, 739, 740, 741, 742, 743, 745, 748, 749, 751, 752, 753, 754, 755, 756, 758, 760, 762, 763, 764, 765, 766, 767, 769, 771, 772, 774, 775, 776, 777, 778, 781, 782, 785, 786, 789, 790, 791, 792, 793, 794, 795, 796, 798, 799, 800, 801, 803, 807, 808, 812, 814, 815, 817, 818, 820, 821, 822, 823, 824, 825, 827, 829, 831, 833, 834, 837, 839, 840, 841, 842, 843, 844, 846, 847, 850, 851, 852, 853, 854, 856, 857, 859, 860, 862, 864, 865, 866, 869, 871, 874, 875, 876, 877, 878, 879, 880, 883, 884, 885, 886, 887, 889]
[17, 31, 34, 40, 50, 56, 63, 69, 73, 78, 81, 87, 90, 104, 119, 120, 125, 127, 137, 164, 199, 210, 213, 219, 225, 226, 230, 237, 243, 263, 284, 286, 296, 297, 304, 308, 335, 336, 357, 365, 366, 368, 374, 387, 392, 398, 399, 403, 410, 414, 430, 434, 435, 451, 453, 454, 463, 464, 476, 489, 495, 506, 514, 516, 519, 521, 530, 532, 533, 537, 538, 539, 542, 547, 557, 560, 564, 572, 598, 604, 606, 622, 623, 626, 655, 665, 667, 669, 672, 676, 685, 689, 690, 692, 697, 703, 705, 706, 726, 732, 739, 750, 751, 755, 756, 760, 762, 765, 771, 773, 774, 787, 793, 802, 809, 814, 836, 839, 842, 861, 864, 872]

[0, 1, 2, 3, 4, 5, 7, 8, 11, 12, 13, 14, 15, 18, 20, 21, 23, 24, 25, 26, 27, 28, 29, 31, 32, 33, 34, 35, 36, 37, 38, 39, 40, 41, 42, 44, 45, 46, 47, 48, 49, 51, 52, 53, 54, 55, 56, 58, 59, 60, 62, 63, 64, 65, 66, 67, 68, 69, 70, 71, 72, 73, 75, 77, 78, 79, 80, 81, 82, 83, 84, 85, 86, 89, 90, 91, 92, 93, 96, 97, 98, 99, 100, 101, 103, 104, 105, 106, 107, 108, 109, 110, 111, 112, 113, 114, 117, 118, 119, 120, 121, 122, 123, 124, 125, 127, 128, 129, 130, 131, 132, 134, 135, 136, 137, 138, 140, 141, 142, 143, 145, 146, 147, 149, 150, 152, 153, 154, 155, 156, 157, 159, 160, 161, 162, 164, 165, 167, 168, 169, 170, 171, 172, 173, 174, 175, 176, 178, 179, 181, 183, 184, 185, 187, 188, 189, 190, 192, 193, 194, 195, 196, 198, 199, 200, 201, 202, 203, 204, 206, 207, 208, 210, 211, 212, 213, 214, 215, 216, 218, 219, 220, 221, 223, 224, 225, 226, 227, 229, 232, 233, 235, 237, 238, 239, 240, 241, 245, 248, 250, 251, 252, 253, 254, 255, 256, 257, 258, 259, 261, 262, 263, 265, 266, 267, 270, 273, 275, 276, 278, 279, 281, 282, 283, 284, 286, 287, 288, 289, 291, 292, 293, 294, 295, 297, 298, 299, 300, 301, 302, 303, 304, 305, 306, 307, 308, 309, 310, 311, 312, 313, 314, 316, 318, 319, 321, 322, 323, 324, 325, 326, 327, 328, 330, 332, 333, 334, 336, 337, 338, 340, 341, 343, 344, 345, 346, 347, 348, 350, 351, 352, 353, 355, 356, 357, 358, 359, 360, 362, 363, 364, 365, 367, 368, 370, 371, 372, 373, 374, 375, 376, 377, 379, 381, 382, 383, 384, 385, 386, 387, 389, 390, 391, 392, 393, 394, 395, 396, 399, 400, 401, 402, 403, 405, 407, 408, 410, 411, 412, 413, 414, 415, 417, 419, 420, 421, 422, 423, 424, 425, 426, 427, 428, 431, 432, 433, 435, 436, 437, 438, 439, 440, 441, 442, 443, 445, 446, 447, 448, 449, 450, 451, 452, 453, 454, 455, 456, 457, 458, 461, 462, 464, 465, 466, 467, 469, 470, 471, 472, 473, 474, 475, 476, 477, 478, 479, 480, 481, 482, 483, 485, 486, 487, 488, 489, 490, 491, 494, 496, 497, 499, 500, 504, 505, 506, 507, 508, 509, 510, 511, 512, 513, 514, 515, 516, 517, 518, 519, 520, 521, 523, 524, 526, 527, 528, 529, 530, 532, 533, 534, 536, 538, 539, 540, 541, 542, 544, 545, 546, 548, 549, 550, 551, 552, 553, 554, 555, 557, 558, 559, 560, 561, 562, 563, 564, 565, 566, 568, 569, 571, 575, 576, 578, 580, 581, 583, 585, 586, 587, 588, 589, 592, 593, 595, 597, 600, 601, 602, 604, 605, 607, 608, 609, 610, 611, 612, 613, 615, 616, 617, 618, 619, 620, 621, 622, 623, 624, 625, 627, 628, 629, 630, 633, 634, 635, 636, 637, 639, 641, 642, 643, 644, 645, 646, 647, 649, 650, 651, 652, 653, 654, 655, 656, 657, 658, 659, 661, 662, 663, 664, 665, 666, 667, 668, 669, 670, 671, 672, 673, 674, 676, 678, 679, 680, 681, 682, 684, 685, 686, 687, 688, 689, 690, 691, 692, 693, 694, 695, 698, 699, 702, 704, 705, 706, 707, 708, 709, 710, 712, 713, 715, 716, 717, 718, 720, 721, 723, 724, 725, 726, 730, 731, 733, 734, 736, 737, 738, 739, 740, 741, 742, 743, 745, 748, 749, 751, 752, 753, 754, 755, 756, 758, 760, 761, 762, 763, 764, 765, 766, 767, 769, 771, 772, 774, 775, 776, 777, 778, 780, 781, 782, 783, 785, 786, 789, 790, 791, 792, 793, 794, 795, 796, 798, 799, 800, 801, 802, 803, 804, 806, 807, 808, 809, 812, 813, 814, 815, 817, 818, 820, 821, 822, 823, 824, 825, 827, 829, 831, 833, 834, 836, 837, 839, 840, 841, 842, 843, 844, 846, 847, 849, 850, 851, 852, 853, 854, 856, 857, 859, 860, 861, 862, 864, 865, 866, 869, 871, 873, 874, 875, 876, 877, 878, 879, 880, 881, 882, 883, 884, 885, 886, 887, 889]
[17, 31, 34, 40, 50, 56, 63, 69, 73, 78, 81, 87, 90, 104, 119, 120, 125, 127, 137, 164, 199, 210, 213, 219, 225, 226, 230, 237, 243, 263, 284, 286, 296, 297, 304, 308, 335, 336, 357, 365, 366, 368, 374, 387, 392, 398, 399, 403, 410, 414, 430, 434, 435, 451, 453, 454, 463, 464, 476, 489, 495, 506, 514, 516, 519, 521, 530, 532, 533, 537, 538, 539, 542, 547, 557, 560, 564, 572, 598, 604, 606, 622, 623, 626, 655, 665, 667, 669, 672, 676, 685, 689, 690, 692, 697, 703, 705, 706, 726, 732, 739, 750, 751, 755, 756, 760, 762, 765, 771, 773, 774, 787, 793, 802, 809, 814, 836, 839, 842, 861, 864, 872]

[0, 1, 2, 3, 4, 5, 7, 8, 9, 11, 12, 13, 14, 15, 18, 19, 20, 21, 23, 24, 25, 26, 27, 28, 29, 31, 32, 33, 34, 35, 36, 37, 38, 39, 40, 41, 42, 43, 44, 45, 46, 47, 48, 49, 51, 52, 53, 54, 55, 56, 58, 59, 60, 61, 62, 63, 64, 65, 66, 67, 68, 69, 70, 71, 72, 73, 74, 75, 77, 78, 79, 80, 81, 82, 83, 84, 85, 86, 89, 90, 91, 92, 93, 96, 97, 98, 99, 100, 101, 102, 103, 104, 105, 106, 107, 108, 109, 110, 111, 112, 113, 114, 115, 117, 118, 119, 120, 121, 122, 123, 124, 125, 126, 127, 128, 129, 130, 131, 132, 134, 135, 136, 137, 138, 139, 140, 141, 142, 143, 145, 146, 147, 149, 150, 151, 152, 153, 154, 155, 156, 157, 159, 160, 161, 162, 163, 164, 165, 167, 168, 169, 170, 171, 172, 173, 174, 175, 176, 177, 178, 179, 180, 181, 183, 184, 185, 187, 188, 189, 190, 192, 193, 194, 195, 196, 198, 199, 200, 201, 202, 203, 204, 205, 206, 207, 208, 209, 210, 211, 212, 213, 214, 215, 216, 218, 219, 220, 221, 222, 223, 224, 225, 226, 227, 229, 231, 232, 233, 235, 236, 237, 238, 239, 240, 241, 242, 245, 248, 250, 251, 252, 253, 254, 255, 256, 257, 258, 259, 261, 262, 263, 265, 266, 267, 270, 271, 272, 273, 275, 276, 278, 279, 281, 282, 283, 284, 286, 287, 288, 289, 291, 292, 293, 294, 295, 296, 297, 298, 299, 300, 301, 302, 303, 304, 305, 306, 307, 308, 309, 310, 311, 312, 313, 314, 315, 316, 318, 319, 320, 321, 322, 323, 324, 325, 326, 327, 328, 330, 332, 333, 334, 336, 337, 338, 339, 340, 341, 343, 344, 345, 346, 347, 348, 350, 351, 352, 353, 355, 356, 357, 358, 359, 360, 362, 363, 364, 365, 366, 367, 368, 370, 371, 372, 373, 374, 375, 376, 377, 379, 381, 382, 383, 384, 385, 386, 387, 388, 389, 390, 391, 392, 393, 394, 395, 396, 399, 400, 401, 402, 403, 404, 405, 406, 407, 408, 410, 411, 412, 413, 414, 415, 416, 417, 418, 419, 420, 421, 422, 423, 424, 425, 426, 427, 428, 431, 432, 433, 435, 436, 437, 438, 439, 440, 441, 442, 443, 444, 445, 446, 447, 448, 449, 450, 451, 452, 453, 454, 455, 456, 457, 458, 460, 461, 462, 464, 465, 466, 467, 469, 470, 471, 472, 473, 474, 475, 476, 477, 478, 479, 480, 481, 482, 483, 484, 485, 486, 487, 488, 489, 490, 491, 492, 494, 495, 496, 497, 499, 500, 503, 504, 505, 506, 507, 508, 509, 510, 511, 512, 513, 514, 515, 516, 517, 518, 519, 520, 521, 522, 523, 524, 525, 526, 527, 528, 529, 530, 532, 533, 534, 536, 537, 538, 539, 540, 541, 542, 543, 544, 545, 546, 547, 548, 549, 550, 551, 552, 553, 554, 555, 557, 558, 559, 560, 561, 562, 563, 564, 565, 566, 567, 568, 569, 571, 572, 573, 575, 576, 578, 579, 580, 581, 582, 583, 585, 586, 587, 588, 589, 592, 593, 594, 595, 597, 598, 599, 600, 601, 602, 603, 604, 605, 607, 608, 609, 610, 611, 612, 613, 615, 616, 617, 618, 619, 620, 621, 622, 623, 624, 625, 627, 628, 629, 630, 633, 634, 635, 636, 637, 638, 639, 641, 642, 643, 644, 645, 646, 647, 648, 649, 650, 651, 652, 653, 654, 655, 656, 657, 658, 659, 660, 661, 662, 663, 664, 665, 666, 667, 668, 669, 670, 671, 672, 673, 674, 675, 676, 677, 678, 679, 680, 681, 682, 683, 684, 685, 686, 687, 688, 689, 690, 691, 692, 693, 694, 695, 696, 698, 699, 700, 702, 704, 705, 706, 707, 708, 709, 710, 711, 712, 713, 714, 715, 716, 717, 718, 720, 721, 723, 724, 725, 726, 729, 730, 731, 732, 733, 734, 735, 736, 737, 738, 739, 740, 741, 742, 743, 745, 746, 748, 749, 750, 751, 752, 753, 754, 755, 756, 758, 760, 761, 762, 763, 764, 765, 766, 767, 769, 771, 772, 774, 775, 776, 777, 778, 780, 781, 782, 783, 785, 786, 789, 790, 791, 792, 793, 794, 795, 796, 797, 798, 799, 800, 801, 802, 803, 804, 806, 807, 808, 809, 812, 813, 814, 815, 817, 818, 820, 821, 822, 823, 824, 825, 827, 828, 829, 830, 831, 832, 833, 834, 836, 837, 839, 840, 841, 842, 843, 844, 845, 846, 847, 849, 850, 851, 852, 853, 854, 856, 857, 859, 860, 861, 862, 864, 865, 866, 867, 869, 870, 871, 872, 873, 874, 875, 876, 877, 878, 879, 880, 881, 882, 883, 884, 885, 886, 887, 888, 889]
[17, 31, 34, 40, 50, 56, 63, 69, 73, 78, 81, 87, 90, 104, 119, 120, 125, 127, 137, 164, 199, 210, 213, 219, 225, 226, 230, 237, 243, 263, 284, 286, 296, 297, 304, 308, 335, 336, 357, 365, 366, 368, 374, 387, 392, 398, 399, 403, 410, 414, 430, 434, 435, 451, 453, 454, 463, 464, 476, 489, 495, 506, 514, 516, 519, 521, 530, 532, 533, 537, 538, 539, 542, 547, 557, 560, 564, 572, 598, 604, 606, 622, 623, 626, 655, 665, 667, 669, 672, 676, 685, 689, 690, 692, 697, 703, 705, 706, 726, 732, 739, 750, 751, 755, 756, 760, 762, 765, 771, 773, 774, 787, 793, 802, 809, 814, 836, 839, 842, 861, 864, 872]

