[89, 121, 147, 172, 204, 301, 352, 353, 403, 462, 498, 620, 636, 678, 752, 756, 780, 821, 835, 837, 856, 869]
[10, 111, 139, 157, 317, 344, 345, 376, 399, 417, 460, 476, 488, 508, 548, 583, 643, 680, 695, 715, 758, 870]

[89, 121, 147, 172, 204, 301, 352, 353, 403, 462, 498, 620, 636, 678, 752, 756, 780, 821, 835, 837, 856, 869]
[0, 4, 7, 10, 11, 28, 37, 49, 52, 54, 56, 70, 81, 92, 95, 97, 99, 101, 102, 108, 111, 112, 126, 134, 139, 157, 160, 161, 163, 168, 176, 177, 183, 190, 208, 213, 218, 222, 228, 231, 233, 234, 244, 246, 250, 255, 257, 271, 272, 278, 279, 285, 300, 306, 317, 327, 344, 345, 348, 358, 371, 375, 376, 380, 385, 394, 399, 417, 418, 424, 425, 433, 435, 436, 441, 443, 460, 466, 468, 474, 476, 488, 490, 500, 501, 508, 515, 540, 548, 554, 569, 582, 583, 603, 610, 615, 633, 635, 643, 668, 669, 670, 680, 695, 707, 711, 715, 719, 732, 741, 758, 774, 776, 787, 796, 814, 824, 843, 853, 863, 868, 870]

[25, 48, 59, 77, 89, 102, 109, 115, 121, 139, 141, 147, 153, 159, 160, 169, 172, 181, 182, 187, 200, 204, 216, 236, 258, 262, 269, 286, 297, 301, 304, 308, 345, 352, 353, 365, 375, 378, 383, 403, 408, 409, 410, 420, 422, 452, 453, 460, 462, 470, 475, 476, 497, 498, 502, 508, 531, 544, 555, 575, 584, 593, 602, 613, 620, 628, 636, 643, 653, 654, 659, 670, 672, 678, 680, 681, 693, 728, 752, 756, 757, 759, 780, 797, 815, 816, 817, 821, 824, 831, 835, 837, 844, 851, 856, 869, 879]
[0, 4, 7, 10, 11, 28, 37, 49, 52, 54, 56, 70, 81, 92, 95, 97, 99, 101, 102, 108, 111, 112, 126, 134, 139, 157, 160, 161, 163, 168, 176, 177, 183, 190, 208, 213, 218, 222, 228, 231, 233, 234, 244, 246, 250, 255, 257, 271, 272, 278, 279, 285, 300, 306, 317, 327, 344, 345, 348, 358, 371, 375, 376, 380, 385, 394, 399, 417, 418, 424, 425, 433, 435, 436, 441, 443, 460, 466, 468, 474, 476, 488, 490, 500, 501, 508, 515, 540, 548, 554, 569, 582, 583, 603, 610, 615, 633, 635, 643, 668, 669, 670, 680, 695, 707, 711, 715, 719, 732, 741, 758, 774, 776, 787, 796, 814, 824, 843, 853, 863, 868, 870]

[18, 20, 25, 48, 52, 54, 59, 67, 71, 77, 89, 100, 102, 109, 111, 115, 116, 121, 139, 141, 147, 150, 151, 153, 155, 159, 160, 167, 169, 172, 176, 181, 182, 187, 197, 200, 204, 207, 209, 214, 216, 236, 249, 250, 253, 258, 262, 269, 286, 297, 298, 301, 303, 304, 308, 319, 326, 335, 345, 347, 352, 353, 354, 355, 365, 369, 375, 378, 383, 388, 396, 403, 405, 408, 409, 410, 420, 422, 448, 452, 453, 459, 460, 462, 470, 471, 475, 476, 493, 497, 498, 502, 508, 531, 537, 541, 544, 555, 557, 575, 584, 593, 595, 602, 607, 613, 620, 624, 628, 636, 639, 642, 643, 645, 653, 654, 656, 657, 659, 661, 664, 668, 670, 671, 672, 678, 680, 681, 683, 688, 693, 710, 714, 718, 727, 728, 738, 752, 753, 756, 757, 759, 762, 780, 790, 791, 797, 804, 815, 816, 817, 818, 821, 824, 830, 831, 833, 835, 837, 844, 846, 850, 851, 852, 856, 858, 859, 864, 869, 872, 879, 887]
[0, 4, 7, 10, 11, 28, 37, 49, 52, 54, 56, 70, 81, 92, 95, 97, 99, 101, 102, 108, 111, 112, 126, 134, 139, 157, 160, 161, 163, 168, 176, 177, 183, 190, 208, 213, 218, 222, 228, 231, 233, 234, 244, 246, 250, 255, 257, 271, 272, 278, 279, 285, 300, 306, 317, 327, 344, 345, 348, 358, 371, 375, 376, 380, 385, 394, 399, 417, 418, 424, 425, 433, 435, 436, 441, 443, 460, 466, 468, 474, 476, 488, 490, 500, 501, 508, 515, 540, 548, 554, 569, 582, 583, 603, 610, 615, 633, 635, 643, 668, 669, 670, 680, 695, 707, 711, 715, 719, 732, 741, 758, 774, 776, 787, 796, 814, 824, 843, 853, 863, 868, 870]

[16, 18, 20, 21, 22, 25, 26, 39, 40, 42, 48, 52, 54, 56, 59, 67, 68, 71, 75, 77, 89, 100, 102, 109, 111, 115, 116, 121, 128, 130, 139, 141, 147, 150, 151, 152, 153, 155, 159, 160, 162, 167, 169, 171, 172, 176, 181, 182, 187, 195, 197, 200, 202, 204, 205, 207, 209, 214, 216, 218, 225, 228, 236, 239, 244, 249, 250, 252, 253, 258, 262, 269, 286, 293, 295, 297, 298, 301, 303, 304, 306, 308, 311, 315, 319, 326, 335, 345, 347, 352, 353, 354, 355, 359, 365, 368, 369, 370, 375, 378, 380, 383, 388, 396, 403, 405, 408, 409, 410, 419, 420, 422, 427, 430, 443, 448, 452, 453, 459, 460, 462, 470, 471, 475, 476, 493, 496, 497, 498, 502, 508, 510, 522, 529, 531, 537, 541, 544, 553, 555, 557, 560, 561, 565, 574, 575, 577, 584, 593, 595, 598, 602, 606, 607, 613, 615, 620, 624, 628, 633, 635, 636, 639, 641, 642, 643, 645, 649, 653, 654, 656, 657, 658, 659, 661, 664, 668, 670, 671, 672, 678, 680, 681, 683, 688, 693, 708, 710, 714, 718, 725, 727, 728, 738, 743, 744, 745, 752, 753, 756, 757, 759, 760, 762, 780, 782, 786, 790, 791, 795, 797, 802, 804, 806, 809, 813, 815, 816, 817, 818, 819, 821, 824, 828, 829, 830, 831, 832, 833, 835, 837, 839, 844, 846, 850, 851, 852, 856, 858, 859, 864, 869, 871, 872, 879, 884, 887]
[0, 4, 7, 10, 11, 28, 37, 49, 52, 54, 56, 70, 81, 92, 95, 97, 99, 101, 102, 108, 111, 112, 126, 134, 139, 157, 160, 161, 163, 168, 176, 177, 183, 190, 208, 213, 218, 222, 228, 231, 233, 234, 244, 246, 250, 255, 257, 271, 272, 278, 279, 285, 300, 306, 317, 327, 344, 345, 348, 358, 371, 375, 376, 380, 385, 394, 399, 417, 418, 424, 425, 433, 435, 436, 441, 443, 460, 466, 468, 474, 476, 488, 490, 500, 501, 508, 515, 540, 548, 554, 569, 582, 583, 603, 610, 615, 633, 635, 643, 668, 669, 670, 680, 695, 707, 711, 715, 719, 732, 741, 758, 774, 776, 787, 796, 814, 824, 843, 853, 863, 868, 870]

[2, 10, 16, 18, 20, 21, 22, 25, 26, 29, 34, 39, 40, 41, 42, 48, 52, 54, 56, 58, 59, 61, 66, 67, 68, 71, 75, 76, 77, 80, 85, 89, 100, 102, 103, 106, 109, 111, 115, 116, 117, 121, 128, 130, 139, 141, 147, 150, 151, 152, 153, 155, 159, 160, 162, 167, 169, 171, 172, 176, 177, 181, 182, 187, 189, 193, 195, 197, 200, 202, 204, 205, 207, 209, 210, 214, 216, 218, 225, 228, 236, 239, 244, 249, 250, 252, 253, 258, 262, 269, 280, 281, 285, 286, 291, 293, 294, 295, 296, 297, 298, 300, 301, 303, 304, 306, 307, 308, 311, 313, 315, 317, 319, 326, 331, 335, 345, 347, 352, 353, 354, 355, 359, 365, 368, 369, 370, 375, 378, 380, 381, 383, 386, 388, 392, 396, 398, 403, 405, 407, 408, 409, 410, 419, 420, 422, 427, 430, 440, 443, 445, 446, 448, 449, 450, 452, 453, 456, 459, 460, 462, 464, 469, 470, 471, 475, 476, 493, 494, 496, 497, 498, 502, 506, 508, 510, 513, 522, 529, 531, 532, 537, 538, 541, 544, 553, 555, 557, 560, 561, 563, 565, 568, 571, 572, 574, 575, 577, 581, 584, 593, 595, 598, 602, 606, 607, 613, 615, 618, 620, 624, 625, 628, 633, 635, 636, 639, 641, 642, 643, 645, 649, 652, 653, 654, 656, 657, 658, 659, 661, 664, 668, 670, 671, 672, 678, 679, 680, 681, 683, 687, 688, 690, 693, 696, 708, 709, 710, 714, 718, 723, 725, 726, 727, 728, 730, 731, 738, 743, 744, 745, 748, 749, 752, 753, 756, 757, 759, 760, 762, 765, 771, 774, 777, 780, 782, 786, 790, 791, 793, 795, 797, 802, 804, 806, 808, 809, 813, 815, 816, 817, 818, 819, 821, 822, 824, 828, 829, 830, 831, 832, 833, 835, 837, 839, 842, 843, 844, 846, 850, 851, 852, 856, 858, 859, 864, 866, 869, 871, 872, 879, 884, 885, 887]
[0, 4, 7, 10, 11, 28, 37, 49, 52, 54, 56, 70, 81, 92, 95, 97, 99, 101, 102, 108, 111, 112, 126, 134, 139, 157, 160, 161, 163, 168, 176, 177, 183, 190, 208, 213, 218, 222, 228, 231, 233, 234, 244, 246, 250, 255, 257, 271, 272, 278, 279, 285, 300, 306, 317, 327, 344, 345, 348, 358, 371, 375, 376, 380, 385, 394, 399, 417, 418, 424, 425, 433, 435, 436, 441, 443, 460, 466, 468, 474, 476, 488, 490, 500, 501, 508, 515, 540, 548, 554, 569, 582, 583, 603, 610, 615, 633, 635, 643, 668, 669, 670, 680, 695, 707, 711, 715, 719, 732, 741, 758, 774, 776, 787, 796, 814, 824, 843, 853, 863, 868, 870]

[2, 10, 16, 17, 18, 20, 21, 22, 24, 25, 26, 29, 34, 39, 40, 41, 42, 48, 49, 52, 54, 56, 58, 59, 61, 66, 67, 68, 69, 71, 75, 76, 77, 80, 81, 85, 89, 90, 100, 102, 103, 106, 109, 111, 115, 116, 117, 121, 123, 128, 130, 131, 133, 134, 137, 139, 141, 147, 150, 151, 152, 153, 155, 159, 160, 162, 167, 169, 171, 172, 176, 177, 181, 182, 185, 187, 188, 189, 191, 193, 194, 195, 197, 200, 201, 202, 204, 205, 206, 207, 209, 210, 214, 215, 216, 218, 225, 227, 228, 236, 239, 241, 244, 249, 250, 252, 253, 255, 258, 262, 267, 269, 273, 280, 281, 285, 286, 288, 291, 293, 294, 295, 296, 297, 298, 300, 301, 303, 304, 306, 307, 308, 311, 313, 315, 317, 319, 322, 326, 327, 331, 335, 339, 341, 345, 347, 352, 353, 354, 355, 357, 359, 361, 365, 368, 369, 370, 373, 375, 378, 379, 380, 381, 383, 386, 388, 392, 396, 397, 398, 399, 403, 405, 406, 407, 408, 409, 410, 419, 420, 422, 426, 427, 429, 430, 437, 440, 441, 443, 445, 446, 447, 448, 449, 450, 452, 453, 456, 459, 460, 462, 464, 469, 470, 471, 475, 476, 478, 479, 482, 486, 489, 493, 494, 496, 497, 498, 502, 505, 506, 508, 510, 513, 522, 523, 529, 531, 532, 537, 538, 541, 544, 551, 552, 553, 554, 555, 557, 560, 561, 563, 565, 567, 568, 570, 571, 572, 574, 575, 577, 581, 584, 591, 593, 594, 595, 598, 602, 605, 606, 607, 613, 615, 618, 620, 624, 625, 626, 628, 633, 635, 636, 637, 639, 641, 642, 643, 645, 648, 649, 652, 653, 654, 656, 657, 658, 659, 661, 664, 665, 668, 670, 671, 672, 678, 679, 680, 681, 683, 687, 688, 690, 693, 696, 707, 708, 709, 710, 714, 718, 723, 725, 726, 727, 728, 729, 730, 731, 738, 743, 744, 745, 748, 749, 752, 753, 756, 757, 759, 760, 761, 762, 765, 771, 774, 777, 779, 780, 782, 784, 786, 789, 790, 791, 793, 795, 797, 801, 802, 804, 806, 808, 809, 813, 815, 816, 817, 818, 819, 820, 821, 822, 823, 824, 827, 828, 829, 830, 831, 832, 833, 835, 837, 839, 842, 843, 844, 846, 850, 851, 852, 856, 857, 858, 859, 860, 863, 864, 866, 869, 871, 872, 873, 875, 879, 881, 884, 885, 887]
[0, 4, 7, 10, 11, 28, 37, 49, 52, 54, 56, 70, 81, 92, 95, 97, 99, 101, 102, 108, 111, 112, 126, 134, 139, 157, 160, 161, 163, 168, 176, 177, 183, 190, 208, 213, 218, 222, 228, 231, 233, 234, 244, 246, 250, 255, 257, 271, 272, 278, 279, 285, 300, 306, 317, 327, 344, 345, 348, 358, 371, 375, 376, 380, 385, 394, 399, 417, 418, 424, 425, 433, 435, 436, 441, 443, 460, 466, 468, 474, 476, 488, 490, 500, 501, 508, 515, 540, 548, 554, 569, 582, 583, 603, 610, 615, 633, 635, 643, 668, 669, 670, 680, 695, 707, 711, 715, 719, 732, 741, 758, 774, 776, 787, 796, 814, 824, 843, 853, 863, 868, 870]

[2, 10, 14, 16, 17, 18, 20, 21, 22, 24, 25, 26, 29, 34, 36, 39, 40, 41, 42, 46, 48, 49, 52, 54, 56, 58, 59, 61, 66, 67, 68, 69, 71, 75, 76, 77, 78, 80, 81, 83, 85, 89, 90, 92, 100, 102, 103, 106, 109, 110, 111, 115, 116, 117, 121, 123, 128, 130, 131, 133, 134, 137, 138, 139, 140, 141, 146, 147, 150, 151, 152, 153, 155, 159, 160, 162, 167, 168, 169, 171, 172, 176, 177, 181, 182, 185, 187, 188, 189, 191, 193, 194, 195, 197, 200, 201, 202, 203, 204, 205, 206, 207, 209, 210, 214, 215, 216, 218, 219, 225, 227, 228, 230, 235, 236, 238, 239, 241, 244, 249, 250, 252, 253, 255, 258, 262, 267, 269, 271, 273, 274, 279, 280, 281, 285, 286, 288, 290, 291, 293, 294, 295, 296, 297, 298, 300, 301, 303, 304, 306, 307, 308, 311, 313, 315, 317, 319, 320, 322, 326, 327, 330, 331, 334, 335, 338, 339, 341, 345, 346, 347, 352, 353, 354, 355, 357, 359, 360, 361, 365, 366, 368, 369, 370, 373, 375, 378, 379, 380, 381, 383, 386, 388, 392, 396, 397, 398, 399, 403, 405, 406, 407, 408, 409, 410, 415, 418, 419, 420, 422, 426, 427, 429, 430, 437, 440, 441, 443, 445, 446, 447, 448, 449, 450, 451, 452, 453, 456, 459, 460, 462, 464, 465, 468, 469, 470, 471, 475, 476, 477, 478, 479, 482, 486, 489, 493, 494, 496, 497, 498, 499, 501, 502, 505, 506, 508, 509, 510, 511, 513, 517, 520, 522, 523, 525, 526, 527, 528, 529, 531, 532, 537, 538, 540, 541, 544, 551, 552, 553, 554, 555, 557, 560, 561, 563, 565, 566, 567, 568, 570, 571, 572, 574, 575, 577, 578, 579, 580, 581, 584, 588, 591, 593, 594, 595, 598, 602, 604, 605, 606, 607, 609, 613, 615, 618, 620, 624, 625, 626, 627, 628, 633, 635, 636, 637, 639, 641, 642, 643, 645, 646, 648, 649, 652, 653, 654, 656, 657, 658, 659, 660, 661, 664, 665, 668, 670, 671, 672, 677, 678, 679, 680, 681, 683, 687, 688, 690, 693, 696, 700, 707, 708, 709, 710, 711, 712, 713, 714, 718, 719, 723, 725, 726, 727, 728, 729, 730, 731, 734, 735, 738, 742, 743, 744, 745, 748, 749, 752, 753, 756, 757, 759, 760, 761, 762, 765, 768, 771, 774, 777, 779, 780, 782, 784, 785, 786, 788, 789, 790, 791, 792, 793, 795, 797, 798, 801, 802, 803, 804, 806, 808, 809, 811, 812, 813, 815, 816, 817, 818, 819, 820, 821, 822, 823, 824, 825, 827, 828, 829, 830, 831, 832, 833, 835, 837, 839, 840, 842, 843, 844, 846, 850, 851, 852, 856, 857, 858, 859, 860, 863, 864, 866, 869, 870, 871, 872, 873, 875, 879, 881, 884, 885, 886, 887]
[0, 4, 7, 10, 11, 28, 37, 49, 52, 54, 56, 70, 81, 92, 95, 97, 99, 101, 102, 108, 111, 112, 126, 134, 139, 157, 160, 161, 163, 168, 176, 177, 183, 190, 208, 213, 218, 222, 228, 231, 233, 234, 244, 246, 250, 255, 257, 271, 272, 278, 279, 285, 300, 306, 317, 327, 344, 345, 348, 358, 371, 375, 376, 380, 385, 394, 399, 417, 418, 424, 425, 433, 435, 436, 441, 443, 460, 466, 468, 474, 476, 488, 490, 500, 501, 508, 515, 540, 548, 554, 569, 582, 583, 603, 610, 615, 633, 635, 643, 668, 669, 670, 680, 695, 707, 711, 715, 719, 732, 741, 758, 774, 776, 787, 796, 814, 824, 843, 853, 863, 868, 870]

[2, 9, 10, 14, 16, 17, 18, 20, 21, 22, 24, 25, 26, 29, 34, 36, 39, 40, 41, 42, 46, 48, 49, 51, 52, 54, 56, 58, 59, 61, 65, 66, 67, 68, 69, 71, 72, 75, 76, 77, 78, 80, 81, 83, 85, 89, 90, 92, 97, 98, 100, 101, 102, 103, 104, 106, 109, 110, 111, 115, 116, 117, 121, 122, 123, 128, 130, 131, 132, 133, 134, 136, 137, 138, 139, 140, 141, 145, 146, 147, 148, 150, 151, 152, 153, 155, 157, 158, 159, 160, 162, 167, 168, 169, 171, 172, 175, 176, 177, 178, 180, 181, 182, 183, 185, 186, 187, 188, 189, 191, 193, 194, 195, 196, 197, 200, 201, 202, 203, 204, 205, 206, 207, 209, 210, 214, 215, 216, 217, 218, 219, 220, 225, 227, 228, 230, 235, 236, 238, 239, 241, 244, 249, 250, 252, 253, 254, 255, 258, 262, 267, 268, 269, 270, 271, 273, 274, 279, 280, 281, 285, 286, 288, 290, 291, 293, 294, 295, 296, 297, 298, 300, 301, 303, 304, 305, 306, 307, 308, 309, 311, 313, 315, 317, 319, 320, 322, 326, 327, 330, 331, 333, 334, 335, 338, 339, 341, 345, 346, 347, 351, 352, 353, 354, 355, 357, 359, 360, 361, 365, 366, 367, 368, 369, 370, 373, 375, 378, 379, 380, 381, 383, 386, 387, 388, 389, 392, 396, 397, 398, 399, 400, 403, 404, 405, 406, 407, 408, 409, 410, 415, 418, 419, 420, 422, 425, 426, 427, 428, 429, 430, 435, 437, 440, 441, 443, 445, 446, 447, 448, 449, 450, 451, 452, 453, 456, 459, 460, 462, 464, 465, 468, 469, 470, 471, 475, 476, 477, 478, 479, 482, 485, 486, 489, 493, 494, 496, 497, 498, 499, 500, 501, 502, 504, 505, 506, 508, 509, 510, 511, 513, 517, 520, 521, 522, 523, 525, 526, 527, 528, 529, 531, 532, 537, 538, 540, 541, 543, 544, 551, 552, 553, 554, 555, 556, 557, 560, 561, 563, 565, 566, 567, 568, 570, 571, 572, 574, 575, 577, 578, 579, 580, 581, 584, 588, 589, 591, 593, 594, 595, 597, 598, 600, 602, 604, 605, 606, 607, 608, 609, 613, 615, 616, 618, 620, 624, 625, 626, 627, 628, 632, 633, 635, 636, 637, 639, 640, 641, 642, 643, 645, 646, 648, 649, 651, 652, 653, 654, 655, 656, 657, 658, 659, 660, 661, 664, 665, 666, 667, 668, 669, 670, 671, 672, 677, 678, 679, 680, 681, 682, 683, 687, 688, 690, 693, 696, 697, 700, 701, 706, 707, 708, 709, 710, 711, 712, 713, 714, 718, 719, 723, 724, 725, 726, 727, 728, 729, 730, 731, 734, 735, 736, 738, 740, 741, 742, 743, 744, 745, 748, 749, 750, 752, 753, 755, 756, 757, 759, 760, 761, 762, 765, 768, 770, 771, 774, 777, 779, 780, 782, 784, 785, 786, 788, 789, 790, 791, 792, 793, 795, 797, 798, 799, 800, 801, 802, 803, 804, 806, 808, 809, 811, 812, 813, 815, 816, 817, 818, 819, 820, 821, 822, 823, 824, 825, 826, 827, 828, 829, 830, 831, 832, 833, 835, 837, 838, 839, 840, 841, 842, 843, 844, 845, 846, 847, 850, 851, 852, 856, 857, 858, 859, 860, 863, 864, 866, 869, 870, 871, 872, 873, 875, 879, 881, 884, 885, 886, 887, 889]
[0, 4, 7, 10, 11, 28, 37, 49, 52, 54, 56, 70, 81, 92, 95, 97, 99, 101, 102, 108, 111, 112, 126, 134, 139, 157, 160, 161, 163, 168, 176, 177, 183, 190, 208, 213, 218, 222, 228, 231, 233, 234, 244, 246, 250, 255, 257, 271, 272, 278, 279, 285, 300, 306, 317, 327, 344, 345, 348, 358, 371, 375, 376, 380, 385, 394, 399, 417, 418, 424, 425, 433, 435, 436, 441, 443, 460, 466, 468, 474, 476, 488, 490, 500, 501, 508, 515, 540, 548, 554, 569, 582, 583, 603, 610, 615, 633, 635, 643, 668, 669, 670, 680, 695, 707, 711, 715, 719, 732, 741, 758, 774, 776, 787, 796, 814, 824, 843, 853, 863, 868, 870]

[2, 3, 5, 6, 9, 10, 14, 16, 17, 18, 19, 20, 21, 22, 24, 25, 26, 27, 28, 29, 31, 34, 36, 39, 40, 41, 42, 46, 48, 49, 51, 52, 54, 55, 56, 58, 59, 61, 62, 63, 64, 65, 66, 67, 68, 69, 71, 72, 75, 76, 77, 78, 80, 81, 83, 85, 86, 89, 90, 92, 97, 98, 100, 101, 102, 103, 104, 106, 109, 110, 111, 115, 116, 117, 119, 121, 122, 123, 126, 127, 128, 129, 130, 131, 132, 133, 134, 136, 137, 138, 139, 140, 141, 145, 146, 147, 148, 149, 150, 151, 152, 153, 155, 156, 157, 158, 159, 160, 162, 165, 167, 168, 169, 171, 172, 173, 175, 176, 177, 178, 180, 181, 182, 183, 185, 186, 187, 188, 189, 191, 193, 194, 195, 196, 197, 198, 200, 201, 202, 203, 204, 205, 206, 207, 208, 209, 210, 212, 214, 215, 216, 217, 218, 219, 220, 225, 227, 228, 230, 231, 234, 235, 236, 238, 239, 241, 244, 248, 249, 250, 252, 253, 254, 255, 258, 261, 262, 263, 265, 267, 268, 269, 270, 271, 272, 273, 274, 279, 280, 281, 284, 285, 286, 288, 290, 291, 292, 293, 294, 295, 296, 297, 298, 300, 301, 302, 303, 304, 305, 306, 307, 308, 309, 310, 311, 313, 315, 317, 319, 320, 321, 322, 325, 326, 327, 330, 331, 333, 334, 335, 336, 338, 339, 340, 341, 345, 346, 347, 349, 350, 351, 352, 353, 354, 355, 356, 357, 359, 360, 361, 363, 365, 366, 367, 368, 369, 370, 372, 373, 375, 376, 378, 379, 380, 381, 383, 386, 387, 388, 389, 391, 392, 396, 397, 398, 399, 400, 403, 404, 405, 406, 407, 408, 409, 410, 413, 415, 417, 418, 419, 420, 422, 425, 426, 427, 428, 429, 430, 435, 437, 440, 441, 443, 445, 446, 447, 448, 449, 450, 451, 452, 453, 455, 456, 459, 460, 462, 463, 464, 465, 468, 469, 470, 471, 473, 474, 475, 476, 477, 478, 479, 482, 485, 486, 489, 493, 494, 496, 497, 498, 499, 500, 501, 502, 504, 505, 506, 507, 508, 509, 510, 511, 513, 514, 516, 517, 520, 521, 522, 523, 525, 526, 527, 528, 529, 531, 532, 535, 537, 538, 539, 540, 541, 543, 544, 549, 551, 552, 553, 554, 555, 556, 557, 560, 561, 563, 565, 566, 567, 568, 570, 571, 572, 573, 574, 575, 577, 578, 579, 580, 581, 582, 584, 587, 588, 589, 591, 593, 594, 595, 597, 598, 599, 600, 602, 604, 605, 606, 607, 608, 609, 613, 615, 616, 617, 618, 620, 624, 625, 626, 627, 628, 632, 633, 635, 636, 637, 638, 639, 640, 641, 642, 643, 644, 645, 646, 648, 649, 650, 651, 652, 653, 654, 655, 656, 657, 658, 659, 660, 661, 664, 665, 666, 667, 668, 669, 670, 671, 672, 677, 678, 679, 680, 681, 682, 683, 687, 688, 689, 690, 691, 693, 694, 696, 697, 700, 701, 705, 706, 707, 708, 709, 710, 711, 712, 713, 714, 717, 718, 719, 723, 724, 725, 726, 727, 728, 729, 730, 731, 732, 734, 735, 736, 738, 740, 741, 742, 743, 744, 745, 748, 749, 750, 752, 753, 755, 756, 757, 758, 759, 760, 761, 762, 763, 765, 768, 769, 770, 771, 774, 777, 779, 780, 782, 784, 785, 786, 788, 789, 790, 791, 792, 793, 795, 797, 798, 799, 800, 801, 802, 803, 804, 806, 808, 809, 810, 811, 812, 813, 815, 816, 817, 818, 819, 820, 821, 822, 823, 824, 825, 826, 827, 828, 829, 830, 831, 832, 833, 835, 836, 837, 838, 839, 840, 841, 842, 843, 844, 845, 846, 847, 850, 851, 852, 856, 857, 858, 859, 860, 863, 864, 866, 869, 870, 871, 872, 873, 875, 879, 881, 882, 884, 885, 886, 887, 889]
[0, 4, 7, 10, 11, 28, 37, 49, 52, 54, 56, 70, 81, 92, 95, 97, 99, 101, 102, 108, 111, 112, 126, 134, 139, 157, 160, 161, 163, 168, 176, 177, 183, 190, 208, 213, 218, 222, 228, 231, 233, 234, 244, 246, 250, 255, 257, 271, 272, 278, 279, 285, 300, 306, 317, 327, 344, 345, 348, 358, 371, 375, 376, 380, 385, 394, 399, 417, 418, 424, 425, 433, 435, 436, 441, 443, 460, 466, 468, 474, 476, 488, 490, 500, 501, 508, 515, 540, 548, 554, 569, 582, 583, 603, 610, 615, 633, 635, 643, 668, 669, 670, 680, 695, 707, 711, 715, 719, 732, 741, 758, 774, 776, 787, 796, 814, 824, 843, 853, 863, 868, 870]

[0, 1, 2, 3, 5, 6, 9, 10, 12, 14, 16, 17, 18, 19, 20, 21, 22, 24, 25, 26, 27, 28, 29, 31, 32, 34, 36, 37, 39, 40, 41, 42, 43, 46, 47, 48, 49, 51, 52, 54, 55, 56, 58, 59, 61, 62, 63, 64, 65, 66, 67, 68, 69, 70, 71, 72, 73, 75, 76, 77, 78, 80, 81, 82, 83, 84, 85, 86, 89, 90, 92, 96, 97, 98, 100, 101, 102, 103, 104, 106, 109, 110, 111, 112, 115, 116, 117, 119, 120, 121, 122, 123, 124, 125, 126, 127, 128, 129, 130, 131, 132, 133, 134, 136, 137, 138, 139, 140, 141, 143, 144, 145, 146, 147, 148, 149, 150, 151, 152, 153, 154, 155, 156, 157, 158, 159, 160, 161, 162, 164, 165, 166, 167, 168, 169, 171, 172, 173, 175, 176, 177, 178, 179, 180, 181, 182, 183, 185, 186, 187, 188, 189, 191, 192, 193, 194, 195, 196, 197, 198, 200, 201, 202, 203, 204, 205, 206, 207, 208, 209, 210, 211, 212, 214, 215, 216, 217, 218, 219, 220, 221, 224, 225, 226, 227, 228, 230, 231, 232, 234, 235, 236, 238, 239, 241, 243, 244, 248, 249, 250, 252, 253, 254, 255, 258, 261, 262, 263, 265, 266, 267, 268, 269, 270, 271, 272, 273, 274, 279, 280, 281, 282, 283, 284, 285, 286, 288, 290, 291, 292, 293, 294, 295, 296, 297, 298, 300, 301, 302, 303, 304, 305, 306, 307, 308, 309, 310, 311, 313, 314, 315, 317, 318, 319, 320, 321, 322, 324, 325, 326, 327, 330, 331, 333, 334, 335, 336, 338, 339, 340, 341, 345, 346, 347, 348, 349, 350, 351, 352, 353, 354, 355, 356, 357, 358, 359, 360, 361, 363, 365, 366, 367, 368, 369, 370, 371, 372, 373, 375, 376, 378, 379, 380, 381, 383, 384, 386, 387, 388, 389, 390, 391, 392, 394, 396, 397, 398, 399, 400, 402, 403, 404, 405, 406, 407, 408, 409, 410, 413, 415, 416, 417, 418, 419, 420, 422, 423, 425, 426, 427, 428, 429, 430, 435, 437, 440, 441, 442, 443, 445, 446, 447, 448, 449, 450, 451, 452, 453, 455, 456, 459, 460, 462, 463, 464, 465, 468, 469, 470, 471, 473, 474, 475, 476, 477, 478, 479, 482, 483, 485, 486, 487, 489, 493, 494, 496, 497, 498, 499, 500, 501, 502, 504, 505, 506, 507, 508, 509, 510, 511, 513, 514, 515, 516, 517, 520, 521, 522, 523, 524, 525, 526, 527, 528, 529, 531, 532, 535, 537, 538, 539, 540, 541, 543, 544, 545, 547, 549, 551, 552, 553, 554, 555, 556, 557, 558, 560, 561, 563, 565, 566, 567, 568, 569, 570, 571, 572, 573, 574, 575, 577, 578, 579, 580, 581, 582, 584, 587, 588, 589, 591, 593, 594, 595, 597, 598, 599, 600, 601, 602, 603, 604, 605, 606, 607, 608, 609, 611, 613, 615, 616, 617, 618, 620, 623, 624, 625, 626, 627, 628, 632, 633, 634, 635, 636, 637, 638, 639, 640, 641, 642, 643, 644, 645, 646, 647, 648, 649, 650, 651, 652, 653, 654, 655, 656, 657, 658, 659, 660, 661, 664, 665, 666, 667, 668, 669, 670, 671, 672, 674, 675, 677, 678, 679, 680, 681, 682, 683, 687, 688, 689, 690, 691, 693, 694, 695, 696, 697, 700, 701, 705, 706, 707, 708, 709, 710, 711, 712, 713, 714, 716, 717, 718, 719, 722, 723, 724, 725, 726, 727, 728, 729, 730, 731, 732, 734, 735, 736, 738, 740, 741, 742, 743, 744, 745, 747, 748, 749, 750, 751, 752, 753, 755, 756, 757, 758, 759, 760, 761, 762, 763, 764, 765, 766, 767, 768, 769, 770, 771, 772, 774, 776, 777, 779, 780, 782, 784, 785, 786, 788, 789, 790, 791, 792, 793, 795, 796, 797, 798, 799, 800, 801, 802, 803, 804, 805, 806, 807, 808, 809, 810, 811, 812, 813, 815, 816, 817, 818, 819, 820, 821, 822, 823, 824, 825, 826, 827, 828, 829, 830, 831, 832, 833, 835, 836, 837, 838, 839, 840, 841, 842, 843, 844, 845, 846, 847, 848, 849, 850, 851, 852, 856, 857, 858, 859, 860, 862, 863, 864, 866, 867, 869, 870, 871, 872, 873, 875, 879, 880, 881, 882, 883, 884, 885, 886, 887, 889]
[0, 4, 7, 10, 11, 28, 37, 49, 52, 54, 56, 70, 81, 92, 95, 97, 99, 101, 102, 108, 111, 112, 126, 134, 139, 157, 160, 161, 163, 168, 176, 177, 183, 190, 208, 213, 218, 222, 228, 231, 233, 234, 244, 246, 250, 255, 257, 271, 272, 278, 279, 285, 300, 306, 317, 327, 344, 345, 348, 358, 371, 375, 376, 380, 385, 394, 399, 417, 418, 424, 425, 433, 435, 436, 441, 443, 460, 466, 468, 474, 476, 488, 490, 500, 501, 508, 515, 540, 548, 554, 569, 582, 583, 603, 610, 615, 633, 635, 643, 668, 669, 670, 680, 695, 707, 711, 715, 719, 732, 741, 758, 774, 776, 787, 796, 814, 824, 843, 853, 863, 868, 870]

[0, 1, 2, 3, 5, 6, 9, 10, 12, 13, 14, 15, 16, 17, 18, 19, 20, 21, 22, 24, 25, 26, 27, 28, 29, 30, 31, 32, 34, 36, 37, 39, 40, 41, 42, 43, 44, 45, 46, 47, 48, 49, 50, 51, 52, 53, 54, 55, 56, 57, 58, 59, 61, 62, 63, 64, 65, 66, 67, 68, 69, 70, 71, 72, 73, 74, 75, 76, 77, 78, 79, 80, 81, 82, 83, 84, 85, 86, 89, 90, 91, 92, 96, 97, 98, 100, 101, 102, 103, 104, 106, 107, 109, 110, 111, 112, 115, 116, 117, 119, 120, 121, 122, 123, 124, 125, 126, 127, 128, 129, 130, 131, 132, 133, 134, 136, 137, 138, 139, 140, 141, 143, 144, 145, 146, 147, 148, 149, 150, 151, 152, 153, 154, 155, 156, 157, 158, 159, 160, 161, 162, 164, 165, 166, 167, 168, 169, 171, 172, 173, 175, 176, 177, 178, 179, 180, 181, 182, 183, 184, 185, 186, 187, 188, 189, 190, 191, 192, 193, 194, 195, 196, 197, 198, 199, 200, 201, 202, 203, 204, 205, 206, 207, 208, 209, 210, 211, 212, 213, 214, 215, 216, 217, 218, 219, 220, 221, 222, 223, 224, 225, 226, 227, 228, 229, 230, 231, 232, 234, 235, 236, 238, 239, 240, 241, 243, 244, 247, 248, 249, 250, 252, 253, 254, 255, 258, 260, 261, 262, 263, 265, 266, 267, 268, 269, 270, 271, 272, 273, 274, 276, 277, 279, 280, 281, 282, 283, 284, 285, 286, 287, 288, 290, 291, 292, 293, 294, 295, 296, 297, 298, 299, 300, 301, 302, 303, 304, 305, 306, 307, 308, 309, 310, 311, 312, 313, 314, 315, 316, 317, 318, 319, 320, 321, 322, 323, 324, 325, 326, 327, 329, 330, 331, 333, 334, 335, 336, 337, 338, 339, 340, 341, 345, 346, 347, 348, 349, 350, 351, 352, 353, 354, 355, 356, 357, 358, 359, 360, 361, 362, 363, 364, 365, 366, 367, 368, 369, 370, 371, 372, 373, 375, 376, 378, 379, 380, 381, 383, 384, 386, 387, 388, 389, 390, 391, 392, 394, 395, 396, 397, 398, 399, 400, 402, 403, 404, 405, 406, 407, 408, 409, 410, 411, 413, 415, 416, 417, 418, 419, 420, 422, 423, 424, 425, 426, 427, 428, 429, 430, 435, 437, 439, 440, 441, 442, 443, 445, 446, 447, 448, 449, 450, 451, 452, 453, 455, 456, 458, 459, 460, 461, 462, 463, 464, 465, 467, 468, 469, 470, 471, 473, 474, 475, 476, 477, 478, 479, 482, 483, 484, 485, 486, 487, 489, 493, 494, 496, 497, 498, 499, 500, 501, 502, 503, 504, 505, 506, 507, 508, 509, 510, 511, 513, 514, 515, 516, 517, 518, 520, 521, 522, 523, 524, 525, 526, 527, 528, 529, 531, 532, 534, 535, 537, 538, 539, 540, 541, 542, 543, 544, 545, 546, 547, 548, 549, 551, 552, 553, 554, 555, 556, 557, 558, 560, 561, 563, 564, 565, 566, 567, 568, 569, 570, 571, 572, 573, 574, 575, 577, 578, 579, 580, 581, 582, 584, 586, 587, 588, 589, 591, 592, 593, 594, 595, 596, 597, 598, 599, 600, 601, 602, 603, 604, 605, 606, 607, 608, 609, 611, 613, 614, 615, 616, 617, 618, 620, 621, 622, 623, 624, 625, 626, 627, 628, 631, 632, 633, 634, 635, 636, 637, 638, 639, 640, 641, 642, 643, 644, 645, 646, 647, 648, 649, 650, 651, 652, 653, 654, 655, 656, 657, 658, 659, 660, 661, 664, 665, 666, 667, 668, 669, 670, 671, 672, 673, 674, 675, 676, 677, 678, 679, 680, 681, 682, 683, 684, 686, 687, 688, 689, 690, 691, 693, 694, 695, 696, 697, 699, 700, 701, 702, 704, 705, 706, 707, 708, 709, 710, 711, 712, 713, 714, 716, 717, 718, 719, 721, 722, 723, 724, 725, 726, 727, 728, 729, 730, 731, 732, 733, 734, 735, 736, 737, 738, 739, 740, 741, 742, 743, 744, 745, 746, 747, 748, 749, 750, 751, 752, 753, 754, 755, 756, 757, 758, 759, 760, 761, 762, 763, 764, 765, 766, 767, 768, 769, 770, 771, 772, 773, 774, 775, 776, 777, 778, 779, 780, 781, 782, 783, 784, 785, 786, 787, 788, 789, 790, 791, 792, 793, 795, 796, 797, 798, 799, 800, 801, 802, 803, 804, 805, 806, 807, 808, 809, 810, 811, 812, 813, 815, 816, 817, 818, 819, 820, 821, 822, 823, 824, 825, 826, 827, 828, 829, 830, 831, 832, 833, 835, 836, 837, 838, 839, 840, 841, 842, 843, 844, 845, 846, 847, 848, 849, 850, 851, 852, 855, 856, 857, 858, 859, 860, 862, 863, 864, 865, 866, 867, 869, 870, 871, 872, 873, 875, 878, 879, 880, 881, 882, 883, 884, 885, 886, 887, 889]
[0, 4, 7, 10, 11, 28, 37, 49, 52, 54, 56, 70, 81, 92, 95, 97, 99, 101, 102, 108, 111, 112, 126, 134, 139, 157, 160, 161, 163, 168, 176, 177, 183, 190, 208, 213, 218, 222, 228, 231, 233, 234, 244, 246, 250, 255, 257, 271, 272, 278, 279, 285, 300, 306, 317, 327, 344, 345, 348, 358, 371, 375, 376, 380, 385, 394, 399, 417, 418, 424, 425, 433, 435, 436, 441, 443, 460, 466, 468, 474, 476, 488, 490, 500, 501, 508, 515, 540, 548, 554, 569, 582, 583, 603, 610, 615, 633, 635, 643, 668, 669, 670, 680, 695, 707, 711, 715, 719, 732, 741, 758, 774, 776, 787, 796, 814, 824, 843, 853, 863, 868, 870]

