[11, 19, 97, 148, 231, 287, 306, 330, 354, 365, 388, 460, 556, 618, 624, 646, 653, 682, 773, 777, 796, 859]
[40, 86, 184, 281, 325, 372, 377, 380, 446, 487, 489, 518, 568, 570, 647, 661, 690, 707, 785, 804, 822, 838]

[11, 19, 97, 148, 231, 287, 306, 330, 354, 365, 388, 460, 556, 618, 624, 646, 653, 682, 773, 777, 796, 859]
[16, 18, 25, 31, 36, 40, 54, 56, 58, 61, 62, 73, 86, 87, 88, 92, 100, 111, 112, 117, 122, 127, 161, 184, 186, 196, 221, 227, 228, 263, 265, 271, 272, 273, 277, 281, 292, 294, 300, 318, 319, 325, 328, 331, 346, 355, 357, 359, 361, 363, 372, 377, 380, 423, 434, 439, 446, 461, 472, 487, 489, 501, 502, 510, 513, 518, 519, 521, 525, 526, 532, 548, 562, 568, 570, 575, 582, 584, 591, 592, 593, 594, 602, 610, 614, 631, 640, 647, 661, 662, 664, 673, 690, 700, 707, 711, 719, 727, 729, 738, 739, 750, 753, 758, 760, 765, 785, 802, 804, 806, 807, 815, 822, 828, 831, 838, 851, 856, 860, 868, 883, 884]

[11, 12, 14, 19, 29, 54, 63, 74, 90, 97, 109, 118, 148, 153, 163, 167, 171, 176, 179, 181, 197, 199, 218, 226, 231, 238, 248, 269, 270, 287, 289, 294, 296, 305, 306, 308, 311, 323, 326, 330, 338, 346, 354, 355, 365, 380, 388, 402, 405, 417, 429, 431, 441, 448, 460, 474, 483, 485, 497, 499, 501, 502, 507, 525, 556, 567, 600, 618, 624, 636, 637, 646, 653, 654, 660, 668, 682, 709, 717, 720, 734, 744, 754, 759, 773, 777, 781, 796, 802, 811, 824, 836, 838, 839, 852, 859, 889]
[16, 18, 25, 31, 36, 40, 54, 56, 58, 61, 62, 73, 86, 87, 88, 92, 100, 111, 112, 117, 122, 127, 161, 184, 186, 196, 221, 227, 228, 263, 265, 271, 272, 273, 277, 281, 292, 294, 300, 318, 319, 325, 328, 331, 346, 355, 357, 359, 361, 363, 372, 377, 380, 423, 434, 439, 446, 461, 472, 487, 489, 501, 502, 510, 513, 518, 519, 521, 525, 526, 532, 548, 562, 568, 570, 575, 582, 584, 591, 592, 593, 594, 602, 610, 614, 631, 640, 647, 661, 662, 664, 673, 690, 700, 707, 711, 719, 727, 729, 738, 739, 750, 753, 758, 760, 765, 785, 802, 804, 806, 807, 815, 822, 828, 831, 838, 851, 856, 860, 868, 883, 884]

[10, 11, 12, 13, 14, 19, 29, 30, 47, 48, 54, 60, 62, 63, 74, 86, 90, 97, 99, 109, 118, 129, 141, 148, 153, 154, 163, 164, 165, 167, 168, 171, 173, 176, 179, 181, 197, 198, 199, 218, 220, 226, 231, 238, 243, 248, 269, 270, 283, 287, 289, 294, 296, 302, 305, 306, 308, 311, 318, 323, 326, 330, 336, 338, 344, 346, 349, 351, 352, 354, 355, 356, 358, 363, 365, 380, 388, 402, 405, 406, 408, 417, 429, 431, 441, 442, 446, 448, 455, 459, 460, 461, 464, 466, 474, 477, 483, 485, 492, 494, 497, 499, 501, 502, 505, 507, 511, 518, 525, 526, 530, 538, 540, 549, 555, 556, 560, 567, 582, 588, 593, 600, 618, 622, 624, 636, 637, 641, 646, 652, 653, 654, 660, 662, 668, 673, 675, 678, 682, 695, 706, 709, 717, 720, 734, 744, 754, 755, 759, 763, 766, 768, 773, 776, 777, 781, 782, 796, 802, 811, 821, 824, 836, 838, 839, 844, 852, 855, 859, 867, 875, 889]
[16, 18, 25, 31, 36, 40, 54, 56, 58, 61, 62, 73, 86, 87, 88, 92, 100, 111, 112, 117, 122, 127, 161, 184, 186, 196, 221, 227, 228, 263, 265, 271, 272, 273, 277, 281, 292, 294, 300, 318, 319, 325, 328, 331, 346, 355, 357, 359, 361, 363, 372, 377, 380, 423, 434, 439, 446, 461, 472, 487, 489, 501, 502, 510, 513, 518, 519, 521, 525, 526, 532, 548, 562, 568, 570, 575, 582, 584, 591, 592, 593, 594, 602, 610, 614, 631, 640, 647, 661, 662, 664, 673, 690, 700, 707, 711, 719, 727, 729, 738, 739, 750, 753, 758, 760, 765, 785, 802, 804, 806, 807, 815, 822, 828, 831, 838, 851, 856, 860, 868, 883, 884]

[10, 11, 12, 13, 14, 18, 19, 25, 28, 29, 30, 34, 38, 47, 48, 49, 50, 54, 55, 60, 62, 63, 74, 81, 86, 90, 97, 99, 109, 118, 120, 124, 129, 131, 141, 148, 152, 153, 154, 163, 164, 165, 167, 168, 171, 173, 176, 179, 181, 185, 197, 198, 199, 217, 218, 220, 226, 229, 231, 238, 243, 248, 259, 269, 270, 272, 283, 286, 287, 289, 294, 296, 298, 302, 305, 306, 307, 308, 311, 316, 318, 320, 323, 326, 330, 336, 338, 342, 344, 346, 349, 351, 352, 354, 355, 356, 358, 363, 365, 367, 372, 380, 382, 388, 390, 392, 402, 405, 406, 408, 417, 424, 428, 429, 431, 436, 439, 441, 442, 446, 448, 455, 456, 458, 459, 460, 461, 464, 466, 472, 474, 477, 483, 485, 490, 492, 494, 497, 499, 501, 502, 505, 507, 509, 511, 515, 518, 525, 526, 528, 530, 531, 538, 539, 540, 541, 547, 549, 554, 555, 556, 560, 567, 574, 579, 582, 584, 585, 588, 592, 593, 600, 604, 610, 618, 621, 622, 624, 629, 636, 637, 638, 640, 641, 642, 646, 649, 650, 652, 653, 654, 660, 662, 665, 668, 673, 675, 678, 681, 682, 685, 693, 694, 695, 706, 709, 717, 720, 722, 723, 726, 734, 744, 749, 754, 755, 756, 759, 763, 766, 768, 773, 776, 777, 781, 782, 796, 799, 800, 802, 811, 821, 823, 824, 835, 836, 838, 839, 844, 852, 855, 859, 867, 874, 875, 877, 889]
[16, 18, 25, 31, 36, 40, 54, 56, 58, 61, 62, 73, 86, 87, 88, 92, 100, 111, 112, 117, 122, 127, 161, 184, 186, 196, 221, 227, 228, 263, 265, 271, 272, 273, 277, 281, 292, 294, 300, 318, 319, 325, 328, 331, 346, 355, 357, 359, 361, 363, 372, 377, 380, 423, 434, 439, 446, 461, 472, 487, 489, 501, 502, 510, 513, 518, 519, 521, 525, 526, 532, 548, 562, 568, 570, 575, 582, 584, 591, 592, 593, 594, 602, 610, 614, 631, 640, 647, 661, 662, 664, 673, 690, 700, 707, 711, 719, 727, 729, 738, 739, 750, 753, 758, 760, 765, 785, 802, 804, 806, 807, 815, 822, 828, 831, 838, 851, 856, 860, 868, 883, 884]

[0, 10, 11, 12, 13, 14, 18, 19, 25, 28, 29, 30, 31, 34, 38, 47, 48, 49, 50, 51, 53, 54, 55, 59, 60, 62, 63, 74, 77, 81, 86, 90, 97, 99, 105, 107, 108, 109, 113, 114, 118, 120, 124, 129, 131, 138, 141, 148, 152, 153, 154, 163, 164, 165, 167, 168, 171, 173, 176, 179, 180, 181, 182, 185, 188, 196, 197, 198, 199, 214, 217, 218, 220, 226, 229, 231, 238, 243, 248, 257, 259, 261, 267, 268, 269, 270, 272, 283, 286, 287, 289, 292, 294, 296, 297, 298, 302, 305, 306, 307, 308, 311, 316, 318, 320, 322, 323, 325, 326, 330, 335, 336, 338, 341, 342, 344, 345, 346, 349, 351, 352, 354, 355, 356, 358, 363, 365, 367, 372, 373, 375, 376, 380, 382, 383, 388, 390, 392, 400, 402, 405, 406, 408, 417, 418, 424, 428, 429, 431, 433, 434, 436, 437, 439, 440, 441, 442, 446, 448, 455, 456, 458, 459, 460, 461, 464, 466, 472, 474, 477, 478, 483, 485, 486, 490, 492, 493, 494, 497, 499, 501, 502, 505, 507, 509, 511, 515, 518, 522, 524, 525, 526, 528, 530, 531, 535, 538, 539, 540, 541, 544, 547, 549, 554, 555, 556, 560, 563, 567, 570, 572, 574, 577, 579, 582, 584, 585, 587, 588, 592, 593, 600, 601, 603, 604, 610, 612, 618, 620, 621, 622, 624, 629, 633, 636, 637, 638, 639, 640, 641, 642, 646, 649, 650, 652, 653, 654, 655, 658, 660, 662, 665, 668, 673, 675, 678, 680, 681, 682, 685, 693, 694, 695, 705, 706, 709, 717, 720, 722, 723, 726, 729, 731, 734, 744, 746, 749, 754, 755, 756, 758, 759, 761, 762, 763, 766, 768, 773, 775, 776, 777, 781, 782, 792, 794, 796, 799, 800, 802, 803, 811, 814, 818, 821, 823, 824, 834, 835, 836, 838, 839, 844, 852, 855, 859, 867, 874, 875, 876, 877, 886, 889]
[16, 18, 25, 31, 36, 40, 54, 56, 58, 61, 62, 73, 86, 87, 88, 92, 100, 111, 112, 117, 122, 127, 161, 184, 186, 196, 221, 227, 228, 263, 265, 271, 272, 273, 277, 281, 292, 294, 300, 318, 319, 325, 328, 331, 346, 355, 357, 359, 361, 363, 372, 377, 380, 423, 434, 439, 446, 461, 472, 487, 489, 501, 502, 510, 513, 518, 519, 521, 525, 526, 532, 548, 562, 568, 570, 575, 582, 584, 591, 592, 593, 594, 602, 610, 614, 631, 640, 647, 661, 662, 664, 673, 690, 700, 707, 711, 719, 727, 729, 738, 739, 750, 753, 758, 760, 765, 785, 802, 804, 806, 807, 815, 822, 828, 831, 838, 851, 856, 860, 868, 883, 884]

[0, 10, 11, 12, 13, 14, 16, 18, 19, 21, 25, 27, 28, 29, 30, 31, 34, 38, 40, 47, 48, 49, 50, 51, 53, 54, 55, 56, 59, 60, 62, 63, 67, 74, 75, 77, 81, 86, 89, 90, 97, 99, 104, 105, 106, 107, 108, 109, 110, 112, 113, 114, 118, 119, 120, 124, 128, 129, 131, 138, 140, 141, 148, 149, 152, 153, 154, 160, 163, 164, 165, 167, 168, 169, 171, 173, 174, 176, 179, 180, 181, 182, 185, 186, 188, 195, 196, 197, 198, 199, 202, 209, 214, 217, 218, 220, 226, 229, 231, 233, 238, 243, 248, 249, 254, 257, 259, 261, 262, 263, 267, 268, 269, 270, 272, 273, 274, 283, 286, 287, 289, 292, 293, 294, 296, 297, 298, 302, 305, 306, 307, 308, 311, 314, 316, 318, 320, 322, 323, 325, 326, 330, 335, 336, 337, 338, 341, 342, 344, 345, 346, 349, 351, 352, 353, 354, 355, 356, 358, 363, 365, 367, 372, 373, 374, 375, 376, 380, 382, 383, 388, 390, 391, 392, 400, 402, 404, 405, 406, 408, 413, 417, 418, 419, 420, 424, 428, 429, 431, 433, 434, 436, 437, 439, 440, 441, 442, 446, 448, 455, 456, 458, 459, 460, 461, 464, 466, 472, 474, 477, 478, 483, 485, 486, 490, 492, 493, 494, 495, 497, 499, 501, 502, 505, 506, 507, 509, 511, 512, 515, 518, 519, 522, 524, 525, 526, 528, 530, 531, 535, 538, 539, 540, 541, 544, 547, 549, 554, 555, 556, 560, 563, 567, 570, 572, 574, 577, 578, 579, 582, 584, 585, 587, 588, 592, 593, 600, 601, 603, 604, 610, 612, 617, 618, 620, 621, 622, 624, 626, 629, 633, 634, 636, 637, 638, 639, 640, 641, 642, 643, 646, 647, 649, 650, 652, 653, 654, 655, 656, 658, 660, 662, 665, 667, 668, 673, 675, 678, 680, 681, 682, 685, 690, 693, 694, 695, 698, 705, 706, 707, 709, 711, 717, 718, 719, 720, 722, 723, 726, 727, 729, 731, 734, 744, 745, 746, 747, 749, 754, 755, 756, 758, 759, 761, 762, 763, 765, 766, 768, 772, 773, 775, 776, 777, 781, 782, 783, 788, 792, 794, 796, 797, 799, 800, 802, 803, 806, 809, 811, 814, 818, 821, 822, 823, 824, 833, 834, 835, 836, 838, 839, 844, 846, 850, 852, 855, 856, 859, 862, 867, 874, 875, 876, 877, 886, 888, 889]
[16, 18, 25, 31, 36, 40, 54, 56, 58, 61, 62, 73, 86, 87, 88, 92, 100, 111, 112, 117, 122, 127, 161, 184, 186, 196, 221, 227, 228, 263, 265, 271, 272, 273, 277, 281, 292, 294, 300, 318, 319, 325, 328, 331, 346, 355, 357, 359, 361, 363, 372, 377, 380, 423, 434, 439, 446, 461, 472, 487, 489, 501, 502, 510, 513, 518, 519, 521, 525, 526, 532, 548, 562, 568, 570, 575, 582, 584, 591, 592, 593, 594, 602, 610, 614, 631, 640, 647, 661, 662, 664, 673, 690, 700, 707, 711, 719, 727, 729, 738, 739, 750, 753, 758, 760, 765, 785, 802, 804, 806, 807, 815, 822, 828, 831, 838, 851, 856, 860, 868, 883, 884]

[0, 10, 11, 12, 13, 14, 15, 16, 18, 19, 21, 25, 27, 28, 29, 30, 31, 34, 35, 38, 40, 41, 42, 47, 48, 49, 50, 51, 53, 54, 55, 56, 57, 59, 60, 62, 63, 64, 65, 67, 74, 75, 77, 81, 86, 89, 90, 93, 97, 99, 104, 105, 106, 107, 108, 109, 110, 112, 113, 114, 115, 118, 119, 120, 124, 128, 129, 131, 132, 138, 140, 141, 146, 148, 149, 152, 153, 154, 160, 161, 163, 164, 165, 167, 168, 169, 171, 173, 174, 176, 179, 180, 181, 182, 185, 186, 188, 192, 193, 195, 196, 197, 198, 199, 202, 209, 210, 213, 214, 217, 218, 219, 220, 226, 229, 231, 233, 236, 238, 243, 246, 248, 249, 253, 254, 257, 259, 261, 262, 263, 267, 268, 269, 270, 272, 273, 274, 283, 284, 286, 287, 289, 292, 293, 294, 296, 297, 298, 302, 305, 306, 307, 308, 311, 314, 315, 316, 318, 320, 322, 323, 325, 326, 330, 331, 335, 336, 337, 338, 339, 341, 342, 344, 345, 346, 347, 349, 350, 351, 352, 353, 354, 355, 356, 358, 360, 361, 363, 365, 366, 367, 372, 373, 374, 375, 376, 380, 382, 383, 388, 390, 391, 392, 395, 400, 402, 404, 405, 406, 408, 412, 413, 417, 418, 419, 420, 424, 428, 429, 431, 432, 433, 434, 436, 437, 439, 440, 441, 442, 444, 446, 448, 449, 450, 455, 456, 457, 458, 459, 460, 461, 464, 466, 470, 472, 474, 475, 477, 478, 483, 485, 486, 490, 492, 493, 494, 495, 497, 499, 501, 502, 505, 506, 507, 509, 511, 512, 515, 518, 519, 522, 524, 525, 526, 528, 530, 531, 535, 538, 539, 540, 541, 543, 544, 547, 549, 553, 554, 555, 556, 560, 561, 563, 564, 567, 569, 570, 572, 574, 575, 577, 578, 579, 582, 584, 585, 587, 588, 592, 593, 594, 600, 601, 603, 604, 608, 610, 611, 612, 613, 614, 615, 617, 618, 620, 621, 622, 624, 626, 628, 629, 630, 633, 634, 636, 637, 638, 639, 640, 641, 642, 643, 646, 647, 649, 650, 652, 653, 654, 655, 656, 658, 660, 662, 663, 665, 667, 668, 670, 673, 675, 678, 680, 681, 682, 683, 684, 685, 690, 693, 694, 695, 698, 702, 705, 706, 707, 709, 711, 716, 717, 718, 719, 720, 722, 723, 726, 727, 729, 731, 732, 734, 738, 742, 744, 745, 746, 747, 749, 754, 755, 756, 757, 758, 759, 761, 762, 763, 765, 766, 768, 772, 773, 775, 776, 777, 781, 782, 783, 786, 788, 792, 794, 796, 797, 799, 800, 801, 802, 803, 806, 809, 811, 812, 814, 816, 818, 819, 821, 822, 823, 824, 833, 834, 835, 836, 837, 838, 839, 843, 844, 845, 846, 847, 850, 852, 855, 856, 859, 862, 866, 867, 873, 874, 875, 876, 877, 882, 885, 886, 888, 889]
[16, 18, 25, 31, 36, 40, 54, 56, 58, 61, 62, 73, 86, 87, 88, 92, 100, 111, 112, 117, 122, 127, 161, 184, 186, 196, 221, 227, 228, 263, 265, 271, 272, 273, 277, 281, 292, 294, 300, 318, 319, 325, 328, 331, 346, 355, 357, 359, 361, 363, 372, 377, 380, 423, 434, 439, 446, 461, 472, 487, 489, 501, 502, 510, 513, 518, 519, 521, 525, 526, 532, 548, 562, 568, 570, 575, 582, 584, 591, 592, 593, 594, 602, 610, 614, 631, 640, 647, 661, 662, 664, 673, 690, 700, 707, 711, 719, 727, 729, 738, 739, 750, 753, 758, 760, 765, 785, 802, 804, 806, 807, 815, 822, 828, 831, 838, 851, 856, 860, 868, 883, 884]

[0, 2, 4, 7, 9, 10, 11, 12, 13, 14, 15, 16, 18, 19, 21, 25, 27, 28, 29, 30, 31, 34, 35, 37, 38, 40, 41, 42, 47, 48, 49, 50, 51, 53, 54, 55, 56, 57, 59, 60, 62, 63, 64, 65, 67, 72, 74, 75, 77, 79, 81, 86, 88, 89, 90, 93, 97, 99, 104, 105, 106, 107, 108, 109, 110, 111, 112, 113, 114, 115, 118, 119, 120, 124, 128, 129, 131, 132, 133, 134, 138, 140, 141, 146, 148, 149, 152, 153, 154, 160, 161, 163, 164, 165, 167, 168, 169, 171, 173, 174, 176, 179, 180, 181, 182, 183, 184, 185, 186, 188, 189, 192, 193, 195, 196, 197, 198, 199, 202, 203, 208, 209, 210, 211, 213, 214, 217, 218, 219, 220, 221, 222, 223, 225, 226, 229, 231, 233, 234, 236, 238, 242, 243, 246, 248, 249, 252, 253, 254, 257, 259, 260, 261, 262, 263, 264, 266, 267, 268, 269, 270, 272, 273, 274, 275, 282, 283, 284, 286, 287, 289, 290, 292, 293, 294, 296, 297, 298, 302, 305, 306, 307, 308, 311, 314, 315, 316, 318, 320, 322, 323, 325, 326, 328, 330, 331, 335, 336, 337, 338, 339, 341, 342, 343, 344, 345, 346, 347, 349, 350, 351, 352, 353, 354, 355, 356, 358, 359, 360, 361, 363, 365, 366, 367, 372, 373, 374, 375, 376, 378, 380, 381, 382, 383, 387, 388, 390, 391, 392, 395, 398, 400, 401, 402, 403, 404, 405, 406, 408, 412, 413, 414, 417, 418, 419, 420, 421, 422, 424, 427, 428, 429, 431, 432, 433, 434, 436, 437, 439, 440, 441, 442, 443, 444, 446, 448, 449, 450, 455, 456, 457, 458, 459, 460, 461, 463, 464, 465, 466, 470, 472, 474, 475, 476, 477, 478, 480, 482, 483, 485, 486, 490, 492, 493, 494, 495, 497, 499, 501, 502, 504, 505, 506, 507, 509, 511, 512, 515, 518, 519, 520, 522, 524, 525, 526, 528, 530, 531, 535, 538, 539, 540, 541, 543, 544, 547, 549, 553, 554, 555, 556, 558, 560, 561, 563, 564, 567, 569, 570, 571, 572, 573, 574, 575, 577, 578, 579, 582, 584, 585, 587, 588, 592, 593, 594, 597, 599, 600, 601, 603, 604, 606, 608, 610, 611, 612, 613, 614, 615, 616, 617, 618, 619, 620, 621, 622, 624, 625, 626, 627, 628, 629, 630, 632, 633, 634, 636, 637, 638, 639, 640, 641, 642, 643, 646, 647, 649, 650, 652, 653, 654, 655, 656, 658, 660, 662, 663, 665, 667, 668, 670, 673, 674, 675, 678, 680, 681, 682, 683, 684, 685, 690, 693, 694, 695, 698, 702, 703, 705, 706, 707, 709, 711, 716, 717, 718, 719, 720, 722, 723, 726, 727, 729, 730, 731, 732, 734, 735, 738, 742, 743, 744, 745, 746, 747, 748, 749, 754, 755, 756, 757, 758, 759, 761, 762, 763, 765, 766, 767, 768, 772, 773, 775, 776, 777, 778, 780, 781, 782, 783, 784, 786, 788, 792, 794, 795, 796, 797, 799, 800, 801, 802, 803, 806, 809, 810, 811, 812, 814, 816, 818, 819, 821, 822, 823, 824, 826, 828, 832, 833, 834, 835, 836, 837, 838, 839, 843, 844, 845, 846, 847, 850, 852, 855, 856, 859, 860, 862, 863, 866, 867, 873, 874, 875, 876, 877, 882, 885, 886, 888, 889]
[16, 18, 25, 31, 36, 40, 54, 56, 58, 61, 62, 73, 86, 87, 88, 92, 100, 111, 112, 117, 122, 127, 161, 184, 186, 196, 221, 227, 228, 263, 265, 271, 272, 273, 277, 281, 292, 294, 300, 318, 319, 325, 328, 331, 346, 355, 357, 359, 361, 363, 372, 377, 380, 423, 434, 439, 446, 461, 472, 487, 489, 501, 502, 510, 513, 518, 519, 521, 525, 526, 532, 548, 562, 568, 570, 575, 582, 584, 591, 592, 593, 594, 602, 610, 614, 631, 640, 647, 661, 662, 664, 673, 690, 700, 707, 711, 719, 727, 729, 738, 739, 750, 753, 758, 760, 765, 785, 802, 804, 806, 807, 815, 822, 828, 831, 838, 851, 856, 860, 868, 883, 884]

[0, 2, 4, 6, 7, 9, 10, 11, 12, 13, 14, 15, 16, 18, 19, 20, 21, 25, 27, 28, 29, 30, 31, 33, 34, 35, 37, 38, 39, 40, 41, 42, 47, 48, 49, 50, 51, 53, 54, 55, 56, 57, 59, 60, 61, 62, 63, 64, 65, 67, 69, 71, 72, 74, 75, 76, 77, 79, 81, 86, 88, 89, 90, 93, 97, 99, 100, 103, 104, 105, 106, 107, 108, 109, 110, 111, 112, 113, 114, 115, 116, 118, 119, 120, 123, 124, 126, 128, 129, 131, 132, 133, 134, 137, 138, 140, 141, 146, 148, 149, 152, 153, 154, 156, 159, 160, 161, 163, 164, 165, 167, 168, 169, 171, 173, 174, 176, 178, 179, 180, 181, 182, 183, 184, 185, 186, 188, 189, 191, 192, 193, 194, 195, 196, 197, 198, 199, 202, 203, 207, 208, 209, 210, 211, 213, 214, 217, 218, 219, 220, 221, 222, 223, 225, 226, 229, 230, 231, 233, 234, 236, 238, 242, 243, 244, 245, 246, 248, 249, 251, 252, 253, 254, 256, 257, 259, 260, 261, 262, 263, 264, 266, 267, 268, 269, 270, 272, 273, 274, 275, 282, 283, 284, 286, 287, 289, 290, 292, 293, 294, 296, 297, 298, 302, 305, 306, 307, 308, 309, 311, 312, 313, 314, 315, 316, 318, 320, 322, 323, 325, 326, 328, 330, 331, 335, 336, 337, 338, 339, 340, 341, 342, 343, 344, 345, 346, 347, 348, 349, 350, 351, 352, 353, 354, 355, 356, 358, 359, 360, 361, 363, 364, 365, 366, 367, 370, 372, 373, 374, 375, 376, 378, 380, 381, 382, 383, 384, 387, 388, 390, 391, 392, 395, 397, 398, 400, 401, 402, 403, 404, 405, 406, 408, 410, 411, 412, 413, 414, 415, 417, 418, 419, 420, 421, 422, 424, 425, 426, 427, 428, 429, 430, 431, 432, 433, 434, 436, 437, 439, 440, 441, 442, 443, 444, 445, 446, 447, 448, 449, 450, 455, 456, 457, 458, 459, 460, 461, 463, 464, 465, 466, 470, 472, 474, 475, 476, 477, 478, 480, 482, 483, 485, 486, 489, 490, 491, 492, 493, 494, 495, 496, 497, 499, 501, 502, 504, 505, 506, 507, 509, 511, 512, 515, 516, 518, 519, 520, 522, 524, 525, 526, 528, 530, 531, 535, 536, 537, 538, 539, 540, 541, 543, 544, 547, 549, 553, 554, 555, 556, 558, 560, 561, 563, 564, 567, 569, 570, 571, 572, 573, 574, 575, 576, 577, 578, 579, 582, 584, 585, 587, 588, 590, 591, 592, 593, 594, 597, 599, 600, 601, 603, 604, 606, 607, 608, 610, 611, 612, 613, 614, 615, 616, 617, 618, 619, 620, 621, 622, 624, 625, 626, 627, 628, 629, 630, 632, 633, 634, 635, 636, 637, 638, 639, 640, 641, 642, 643, 645, 646, 647, 649, 650, 651, 652, 653, 654, 655, 656, 657, 658, 660, 662, 663, 664, 665, 667, 668, 670, 671, 673, 674, 675, 678, 680, 681, 682, 683, 684, 685, 690, 693, 694, 695, 698, 702, 703, 705, 706, 707, 709, 711, 713, 716, 717, 718, 719, 720, 722, 723, 726, 727, 729, 730, 731, 732, 734, 735, 736, 738, 739, 741, 742, 743, 744, 745, 746, 747, 748, 749, 753, 754, 755, 756, 757, 758, 759, 761, 762, 763, 765, 766, 767, 768, 772, 773, 775, 776, 777, 778, 780, 781, 782, 783, 784, 786, 788, 790, 792, 794, 795, 796, 797, 798, 799, 800, 801, 802, 803, 806, 808, 809, 810, 811, 812, 814, 816, 818, 819, 821, 822, 823, 824, 825, 826, 827, 828, 829, 832, 833, 834, 835, 836, 837, 838, 839, 843, 844, 845, 846, 847, 850, 852, 854, 855, 856, 857, 859, 860, 862, 863, 866, 867, 868, 873, 874, 875, 876, 877, 879, 880, 882, 884, 885, 886, 888, 889]
[16, 18, 25, 31, 36, 40, 54, 56, 58, 61, 62, 73, 86, 87, 88, 92, 100, 111, 112, 117, 122, 127, 161, 184, 186, 196, 221, 227, 228, 263, 265, 271, 272, 273, 277, 281, 292, 294, 300, 318, 319, 325, 328, 331, 346, 355, 357, 359, 361, 363, 372, 377, 380, 423, 434, 439, 446, 461, 472, 487, 489, 501, 502, 510, 513, 518, 519, 521, 525, 526, 532, 548, 562, 568, 570, 575, 582, 584, 591, 592, 593, 594, 602, 610, 614, 631, 640, 647, 661, 662, 664, 673, 690, 700, 707, 711, 719, 727, 729, 738, 739, 750, 753, 758, 760, 765, 785, 802, 804, 806, 807, 815, 822, 828, 831, 838, 851, 856, 860, 868, 883, 884]

[0, 2, 3, 4, 6, 7, 9, 10, 11, 12, 13, 14, 15, 16, 17, 18, 19, 20, 21, 23, 24, 25, 26, 27, 28, 29, 30, 31, 32, 33, 34, 35, 37, 38, 39, 40, 41, 42, 44, 47, 48, 49, 50, 51, 53, 54, 55, 56, 57, 59, 60, 61, 62, 63, 64, 65, 67, 69, 71, 72, 73, 74, 75, 76, 77, 79, 80, 81, 84, 86, 88, 89, 90, 92, 93, 94, 97, 99, 100, 101, 103, 104, 105, 106, 107, 108, 109, 110, 111, 112, 113, 114, 115, 116, 118, 119, 120, 123, 124, 126, 128, 129, 131, 132, 133, 134, 135, 137, 138, 139, 140, 141, 144, 145, 146, 148, 149, 151, 152, 153, 154, 155, 156, 158, 159, 160, 161, 163, 164, 165, 167, 168, 169, 170, 171, 173, 174, 176, 178, 179, 180, 181, 182, 183, 184, 185, 186, 188, 189, 190, 191, 192, 193, 194, 195, 196, 197, 198, 199, 202, 203, 204, 205, 207, 208, 209, 210, 211, 213, 214, 215, 216, 217, 218, 219, 220, 221, 222, 223, 225, 226, 229, 230, 231, 232, 233, 234, 236, 238, 242, 243, 244, 245, 246, 248, 249, 251, 252, 253, 254, 255, 256, 257, 258, 259, 260, 261, 262, 263, 264, 266, 267, 268, 269, 270, 272, 273, 274, 275, 276, 277, 282, 283, 284, 285, 286, 287, 289, 290, 292, 293, 294, 295, 296, 297, 298, 302, 304, 305, 306, 307, 308, 309, 311, 312, 313, 314, 315, 316, 318, 319, 320, 322, 323, 324, 325, 326, 328, 330, 331, 333, 335, 336, 337, 338, 339, 340, 341, 342, 343, 344, 345, 346, 347, 348, 349, 350, 351, 352, 353, 354, 355, 356, 358, 359, 360, 361, 362, 363, 364, 365, 366, 367, 368, 370, 372, 373, 374, 375, 376, 378, 380, 381, 382, 383, 384, 387, 388, 390, 391, 392, 393, 395, 397, 398, 400, 401, 402, 403, 404, 405, 406, 408, 409, 410, 411, 412, 413, 414, 415, 417, 418, 419, 420, 421, 422, 423, 424, 425, 426, 427, 428, 429, 430, 431, 432, 433, 434, 436, 437, 439, 440, 441, 442, 443, 444, 445, 446, 447, 448, 449, 450, 452, 455, 456, 457, 458, 459, 460, 461, 463, 464, 465, 466, 470, 471, 472, 473, 474, 475, 476, 477, 478, 480, 482, 483, 485, 486, 489, 490, 491, 492, 493, 494, 495, 496, 497, 499, 500, 501, 502, 504, 505, 506, 507, 509, 511, 512, 515, 516, 518, 519, 520, 521, 522, 523, 524, 525, 526, 527, 528, 530, 531, 533, 535, 536, 537, 538, 539, 540, 541, 542, 543, 544, 547, 549, 553, 554, 555, 556, 557, 558, 560, 561, 563, 564, 566, 567, 569, 570, 571, 572, 573, 574, 575, 576, 577, 578, 579, 582, 584, 585, 586, 587, 588, 590, 591, 592, 593, 594, 596, 597, 599, 600, 601, 603, 604, 606, 607, 608, 609, 610, 611, 612, 613, 614, 615, 616, 617, 618, 619, 620, 621, 622, 623, 624, 625, 626, 627, 628, 629, 630, 632, 633, 634, 635, 636, 637, 638, 639, 640, 641, 642, 643, 644, 645, 646, 647, 649, 650, 651, 652, 653, 654, 655, 656, 657, 658, 660, 661, 662, 663, 664, 665, 667, 668, 670, 671, 672, 673, 674, 675, 676, 677, 678, 680, 681, 682, 683, 684, 685, 690, 692, 693, 694, 695, 698, 699, 700, 702, 703, 705, 706, 707, 709, 711, 713, 714, 716, 717, 718, 719, 720, 722, 723, 725, 726, 727, 729, 730, 731, 732, 733, 734, 735, 736, 737, 738, 739, 741, 742, 743, 744, 745, 746, 747, 748, 749, 753, 754, 755, 756, 757, 758, 759, 761, 762, 763, 765, 766, 767, 768, 770, 772, 773, 774, 775, 776, 777, 778, 780, 781, 782, 783, 784, 786, 788, 790, 792, 794, 795, 796, 797, 798, 799, 800, 801, 802, 803, 804, 806, 808, 809, 810, 811, 812, 813, 814, 816, 818, 819, 820, 821, 822, 823, 824, 825, 826, 827, 828, 829, 832, 833, 834, 835, 836, 837, 838, 839, 842, 843, 844, 845, 846, 847, 850, 852, 854, 855, 856, 857, 859, 860, 862, 863, 865, 866, 867, 868, 870, 872, 873, 874, 875, 876, 877, 879, 880, 882, 883, 884, 885, 886, 888, 889]
[16, 18, 25, 31, 36, 40, 54, 56, 58, 61, 62, 73, 86, 87, 88, 92, 100, 111, 112, 117, 122, 127, 161, 184, 186, 196, 221, 227, 228, 263, 265, 271, 272, 273, 277, 281, 292, 294, 300, 318, 319, 325, 328, 331, 346, 355, 357, 359, 361, 363, 372, 377, 380, 423, 434, 439, 446, 461, 472, 487, 489, 501, 502, 510, 513, 518, 519, 521, 525, 526, 532, 548, 562, 568, 570, 575, 582, 584, 591, 592, 593, 594, 602, 610, 614, 631, 640, 647, 661, 662, 664, 673, 690, 700, 707, 711, 719, 727, 729, 738, 739, 750, 753, 758, 760, 765, 785, 802, 804, 806, 807, 815, 822, 828, 831, 838, 851, 856, 860, 868, 883, 884]

[0, 2, 3, 4, 5, 6, 7, 9, 10, 11, 12, 13, 14, 15, 16, 17, 18, 19, 20, 21, 22, 23, 24, 25, 26, 27, 28, 29, 30, 31, 32, 33, 34, 35, 37, 38, 39, 40, 41, 42, 43, 44, 47, 48, 49, 50, 51, 52, 53, 54, 55, 56, 57, 58, 59, 60, 61, 62, 63, 64, 65, 67, 69, 70, 71, 72, 73, 74, 75, 76, 77, 79, 80, 81, 84, 86, 88, 89, 90, 91, 92, 93, 94, 97, 99, 100, 101, 103, 104, 105, 106, 107, 108, 109, 110, 111, 112, 113, 114, 115, 116, 117, 118, 119, 120, 123, 124, 126, 127, 128, 129, 130, 131, 132, 133, 134, 135, 137, 138, 139, 140, 141, 142, 143, 144, 145, 146, 147, 148, 149, 151, 152, 153, 154, 155, 156, 157, 158, 159, 160, 161, 163, 164, 165, 166, 167, 168, 169, 170, 171, 173, 174, 176, 178, 179, 180, 181, 182, 183, 184, 185, 186, 187, 188, 189, 190, 191, 192, 193, 194, 195, 196, 197, 198, 199, 200, 201, 202, 203, 204, 205, 206, 207, 208, 209, 210, 211, 212, 213, 214, 215, 216, 217, 218, 219, 220, 221, 222, 223, 225, 226, 228, 229, 230, 231, 232, 233, 234, 236, 237, 238, 242, 243, 244, 245, 246, 248, 249, 250, 251, 252, 253, 254, 255, 256, 257, 258, 259, 260, 261, 262, 263, 264, 265, 266, 267, 268, 269, 270, 272, 273, 274, 275, 276, 277, 280, 282, 283, 284, 285, 286, 287, 289, 290, 291, 292, 293, 294, 295, 296, 297, 298, 300, 302, 304, 305, 306, 307, 308, 309, 310, 311, 312, 313, 314, 315, 316, 317, 318, 319, 320, 321, 322, 323, 324, 325, 326, 327, 328, 329, 330, 331, 332, 333, 335, 336, 337, 338, 339, 340, 341, 342, 343, 344, 345, 346, 347, 348, 349, 350, 351, 352, 353, 354, 355, 356, 357, 358, 359, 360, 361, 362, 363, 364, 365, 366, 367, 368, 370, 372, 373, 374, 375, 376, 377, 378, 380, 381, 382, 383, 384, 385, 387, 388, 390, 391, 392, 393, 395, 397, 398, 399, 400, 401, 402, 403, 404, 405, 406, 408, 409, 410, 411, 412, 413, 414, 415, 417, 418, 419, 420, 421, 422, 423, 424, 425, 426, 427, 428, 429, 430, 431, 432, 433, 434, 435, 436, 437, 438, 439, 440, 441, 442, 443, 444, 445, 446, 447, 448, 449, 450, 452, 454, 455, 456, 457, 458, 459, 460, 461, 463, 464, 465, 466, 467, 469, 470, 471, 472, 473, 474, 475, 476, 477, 478, 480, 482, 483, 485, 486, 488, 489, 490, 491, 492, 493, 494, 495, 496, 497, 499, 500, 501, 502, 504, 505, 506, 507, 509, 511, 512, 513, 515, 516, 518, 519, 520, 521, 522, 523, 524, 525, 526, 527, 528, 530, 531, 532, 533, 535, 536, 537, 538, 539, 540, 541, 542, 543, 544, 546, 547, 549, 550, 551, 552, 553, 554, 555, 556, 557, 558, 560, 561, 563, 564, 566, 567, 569, 570, 571, 572, 573, 574, 575, 576, 577, 578, 579, 580, 582, 584, 585, 586, 587, 588, 589, 590, 591, 592, 593, 594, 596, 597, 598, 599, 600, 601, 602, 603, 604, 605, 606, 607, 608, 609, 610, 611, 612, 613, 614, 615, 616, 617, 618, 619, 620, 621, 622, 623, 624, 625, 626, 627, 628, 629, 630, 632, 633, 634, 635, 636, 637, 638, 639, 640, 641, 642, 643, 644, 645, 646, 647, 648, 649, 650, 651, 652, 653, 654, 655, 656, 657, 658, 659, 660, 661, 662, 663, 664, 665, 666, 667, 668, 669, 670, 671, 672, 673, 674, 675, 676, 677, 678, 680, 681, 682, 683, 684, 685, 690, 692, 693, 694, 695, 696, 697, 698, 699, 700, 701, 702, 703, 705, 706, 707, 709, 710, 711, 712, 713, 714, 716, 717, 718, 719, 720, 721, 722, 723, 725, 726, 727, 729, 730, 731, 732, 733, 734, 735, 736, 737, 738, 739, 741, 742, 743, 744, 745, 746, 747, 748, 749, 753, 754, 755, 756, 757, 758, 759, 760, 761, 762, 763, 765, 766, 767, 768, 770, 771, 772, 773, 774, 775, 776, 777, 778, 779, 780, 781, 782, 783, 784, 786, 788, 789, 790, 791, 792, 793, 794, 795, 796, 797, 798, 799, 800, 801, 802, 803, 804, 805, 806, 808, 809, 810, 811, 812, 813, 814, 815, 816, 818, 819, 820, 821, 822, 823, 824, 825, 826, 827, 828, 829, 830, 832, 833, 834, 835, 836, 837, 838, 839, 842, 843, 844, 845, 846, 847, 849, 850, 852, 854, 855, 856, 857, 859, 860, 862, 863, 865, 866, 867, 868, 869, 870, 872, 873, 874, 875, 876, 877, 879, 880, 882, 883, 884, 885, 886, 888, 889]
[16, 18, 25, 31, 36, 40, 54, 56, 58, 61, 62, 73, 86, 87, 88, 92, 100, 111, 112, 117, 122, 127, 161, 184, 186, 196, 221, 227, 228, 263, 265, 271, 272, 273, 277, 281, 292, 294, 300, 318, 319, 325, 328, 331, 346, 355, 357, 359, 361, 363, 372, 377, 380, 423, 434, 439, 446, 461, 472, 487, 489, 501, 502, 510, 513, 518, 519, 521, 525, 526, 532, 548, 562, 568, 570, 575, 582, 584, 591, 592, 593, 594, 602, 610, 614, 631, 640, 647, 661, 662, 664, 673, 690, 700, 707, 711, 719, 727, 729, 738, 739, 750, 753, 758, 760, 765, 785, 802, 804, 806, 807, 815, 822, 828, 831, 838, 851, 856, 860, 868, 883, 884]

