[61, 89, 175, 192, 239, 302, 311, 454, 579, 618, 625, 646, 673, 726, 760, 767, 793, 857, 866, 883, 887, 889]
[59, 99, 137, 178, 232, 278, 309, 323, 375, 401, 426, 513, 550, 603, 658, 659, 701, 711, 713, 768, 788, 864]

[61, 89, 175, 192, 239, 302, 311, 454, 579, 618, 625, 646, 673, 726, 760, 767, 793, 857, 866, 883, 887, 889]
[17, 26, 28, 39, 44, 52, 56, 58, 59, 62, 67, 84, 99, 100, 102, 111, 113, 115, 126, 127, 135, 137, 152, 154, 157, 178, 180, 185, 191, 210, 216, 217, 222, 232, 248, 258, 263, 275, 278, 282, 296, 303, 309, 316, 323, 324, 343, 354, 355, 363, 366, 368, 375, 377, 388, 394, 396, 401, 403, 404, 413, 426, 432, 442, 445, 446, 462, 494, 503, 508, 509, 513, 517, 522, 523, 528, 545, 550, 568, 585, 588, 598, 603, 611, 638, 658, 659, 666, 676, 686, 694, 701, 706, 711, 713, 717, 718, 728, 730, 733, 736, 737, 749, 759, 768, 776, 777, 786, 788, 790, 791, 809, 813, 818, 821, 837, 840, 843, 855, 859, 863, 864]

[5, 6, 28, 29, 43, 59, 61, 71, 74, 83, 87, 89, 121, 138, 172, 175, 178, 189, 192, 201, 206, 210, 224, 239, 244, 245, 256, 274, 284, 302, 306, 307, 310, 311, 339, 366, 368, 371, 374, 379, 389, 416, 427, 433, 439, 442, 446, 454, 481, 488, 489, 490, 495, 504, 506, 512, 514, 516, 522, 523, 544, 554, 557, 577, 579, 601, 618, 625, 631, 636, 645, 646, 657, 672, 673, 723, 726, 728, 737, 740, 760, 764, 767, 776, 783, 793, 803, 827, 836, 838, 842, 857, 858, 863, 866, 877, 883, 887, 889]
[17, 26, 28, 39, 44, 52, 56, 58, 59, 62, 67, 84, 99, 100, 102, 111, 113, 115, 126, 127, 135, 137, 152, 154, 157, 178, 180, 185, 191, 210, 216, 217, 222, 232, 248, 258, 263, 275, 278, 282, 296, 303, 309, 316, 323, 324, 343, 354, 355, 363, 366, 368, 375, 377, 388, 394, 396, 401, 403, 404, 413, 426, 432, 442, 445, 446, 462, 494, 503, 508, 509, 513, 517, 522, 523, 528, 545, 550, 568, 585, 588, 598, 603, 611, 638, 658, 659, 666, 676, 686, 694, 701, 706, 711, 713, 717, 718, 728, 730, 733, 736, 737, 749, 759, 768, 776, 777, 786, 788, 790, 791, 809, 813, 818, 821, 837, 840, 843, 855, 859, 863, 864]

[5, 6, 7, 14, 28, 29, 35, 39, 43, 54, 55, 59, 61, 71, 74, 81, 83, 87, 89, 95, 97, 105, 112, 121, 129, 130, 135, 138, 172, 173, 175, 178, 179, 189, 192, 201, 206, 207, 208, 210, 224, 226, 235, 239, 244, 245, 256, 262, 267, 274, 277, 278, 284, 293, 302, 306, 307, 310, 311, 316, 322, 326, 328, 339, 355, 356, 366, 368, 370, 371, 374, 379, 381, 384, 386, 389, 392, 404, 408, 410, 416, 419, 427, 431, 433, 437, 439, 442, 446, 454, 461, 462, 481, 488, 489, 490, 495, 504, 506, 512, 514, 516, 517, 519, 522, 523, 532, 539, 540, 544, 554, 557, 573, 577, 578, 579, 580, 591, 601, 617, 618, 624, 625, 628, 631, 636, 645, 646, 648, 651, 657, 659, 660, 665, 672, 673, 714, 723, 725, 726, 728, 737, 740, 750, 754, 756, 760, 764, 767, 769, 774, 776, 777, 783, 793, 803, 813, 817, 820, 827, 836, 838, 841, 842, 857, 858, 863, 866, 871, 877, 883, 887, 888, 889]
[17, 26, 28, 39, 44, 52, 56, 58, 59, 62, 67, 84, 99, 100, 102, 111, 113, 115, 126, 127, 135, 137, 152, 154, 157, 178, 180, 185, 191, 210, 216, 217, 222, 232, 248, 258, 263, 275, 278, 282, 296, 303, 309, 316, 323, 324, 343, 354, 355, 363, 366, 368, 375, 377, 388, 394, 396, 401, 403, 404, 413, 426, 432, 442, 445, 446, 462, 494, 503, 508, 509, 513, 517, 522, 523, 528, 545, 550, 568, 585, 588, 598, 603, 611, 638, 658, 659, 666, 676, 686, 694, 701, 706, 711, 713, 717, 718, 728, 730, 733, 736, 737, 749, 759, 768, 776, 777, 786, 788, 790, 791, 809, 813, 818, 821, 837, 840, 843, 855, 859, 863, 864]

[0, 5, 6, 7, 9, 10, 14, 23, 28, 29, 35, 36, 39, 40, 43, 54, 55, 59, 61, 71, 73, 74, 75, 81, 83, 87, 89, 95, 97, 105, 107, 110, 112, 121, 129, 130, 133, 135, 138, 151, 158, 159, 171, 172, 173, 175, 178, 179, 189, 192, 196, 201, 202, 206, 207, 208, 210, 222, 224, 226, 229, 234, 235, 239, 244, 245, 256, 262, 266, 267, 274, 277, 278, 282, 284, 293, 297, 298, 302, 306, 307, 310, 311, 314, 316, 322, 326, 328, 335, 339, 349, 355, 356, 366, 367, 368, 369, 370, 371, 374, 379, 380, 381, 384, 386, 389, 392, 395, 404, 405, 408, 410, 416, 419, 421, 426, 427, 431, 432, 433, 437, 439, 442, 446, 447, 448, 454, 455, 461, 462, 463, 466, 471, 481, 488, 489, 490, 495, 500, 502, 504, 506, 512, 513, 514, 516, 517, 519, 522, 523, 532, 535, 539, 540, 544, 545, 547, 548, 554, 556, 557, 558, 565, 573, 577, 578, 579, 580, 584, 588, 591, 601, 602, 603, 611, 617, 618, 624, 625, 628, 630, 631, 636, 644, 645, 646, 648, 651, 657, 658, 659, 660, 662, 665, 672, 673, 680, 705, 706, 710, 714, 723, 725, 726, 728, 737, 738, 740, 747, 749, 750, 754, 756, 760, 764, 767, 769, 774, 776, 777, 782, 783, 785, 793, 794, 795, 803, 807, 813, 817, 820, 827, 836, 837, 838, 841, 842, 850, 857, 858, 863, 866, 868, 871, 877, 883, 887, 888, 889]
[17, 26, 28, 39, 44, 52, 56, 58, 59, 62, 67, 84, 99, 100, 102, 111, 113, 115, 126, 127, 135, 137, 152, 154, 157, 178, 180, 185, 191, 210, 216, 217, 222, 232, 248, 258, 263, 275, 278, 282, 296, 303, 309, 316, 323, 324, 343, 354, 355, 363, 366, 368, 375, 377, 388, 394, 396, 401, 403, 404, 413, 426, 432, 442, 445, 446, 462, 494, 503, 508, 509, 513, 517, 522, 523, 528, 545, 550, 568, 585, 588, 598, 603, 611, 638, 658, 659, 666, 676, 686, 694, 701, 706, 711, 713, 717, 718, 728, 730, 733, 736, 737, 749, 759, 768, 776, 777, 786, 788, 790, 791, 809, 813, 818, 821, 837, 840, 843, 855, 859, 863, 864]

[0, 1, 5, 6, 7, 9, 10, 14, 23, 28, 29, 32, 35, 36, 39, 40, 43, 54, 55, 59, 61, 66, 71, 73, 74, 75, 81, 83, 85, 87, 89, 92, 95, 97, 100, 101, 105, 107, 110, 112, 113, 121, 129, 130, 133, 135, 137, 138, 146, 151, 154, 158, 159, 171, 172, 173, 175, 178, 179, 189, 192, 196, 201, 202, 206, 207, 208, 210, 215, 222, 224, 226, 229, 232, 234, 235, 238, 239, 241, 244, 245, 250, 256, 260, 262, 265, 266, 267, 268, 269, 274, 277, 278, 279, 282, 284, 293, 294, 297, 298, 300, 301, 302, 306, 307, 310, 311, 312, 314, 316, 320, 322, 326, 328, 333, 335, 339, 340, 342, 347, 349, 352, 355, 356, 366, 367, 368, 369, 370, 371, 373, 374, 379, 380, 381, 382, 384, 386, 389, 392, 395, 404, 405, 406, 407, 408, 410, 413, 414, 416, 417, 419, 421, 426, 427, 431, 432, 433, 435, 437, 439, 442, 446, 447, 448, 453, 454, 455, 461, 462, 463, 466, 471, 481, 482, 488, 489, 490, 491, 495, 500, 502, 504, 506, 512, 513, 514, 516, 517, 519, 522, 523, 530, 531, 532, 535, 539, 540, 544, 545, 547, 548, 550, 552, 554, 555, 556, 557, 558, 562, 563, 565, 570, 573, 577, 578, 579, 580, 584, 587, 588, 590, 591, 598, 601, 602, 603, 611, 612, 616, 617, 618, 624, 625, 627, 628, 630, 631, 632, 636, 644, 645, 646, 648, 651, 652, 653, 654, 657, 658, 659, 660, 662, 665, 672, 673, 680, 686, 692, 694, 699, 705, 706, 710, 714, 720, 721, 723, 725, 726, 728, 736, 737, 738, 740, 747, 749, 750, 751, 754, 756, 759, 760, 762, 764, 767, 769, 774, 776, 777, 782, 783, 785, 791, 793, 794, 795, 803, 806, 807, 813, 817, 820, 823, 827, 836, 837, 838, 841, 842, 850, 855, 857, 858, 863, 864, 866, 868, 871, 877, 883, 887, 888, 889]
[17, 26, 28, 39, 44, 52, 56, 58, 59, 62, 67, 84, 99, 100, 102, 111, 113, 115, 126, 127, 135, 137, 152, 154, 157, 178, 180, 185, 191, 210, 216, 217, 222, 232, 248, 258, 263, 275, 278, 282, 296, 303, 309, 316, 323, 324, 343, 354, 355, 363, 366, 368, 375, 377, 388, 394, 396, 401, 403, 404, 413, 426, 432, 442, 445, 446, 462, 494, 503, 508, 509, 513, 517, 522, 523, 528, 545, 550, 568, 585, 588, 598, 603, 611, 638, 658, 659, 666, 676, 686, 694, 701, 706, 711, 713, 717, 718, 728, 730, 733, 736, 737, 749, 759, 768, 776, 777, 786, 788, 790, 791, 809, 813, 818, 821, 837, 840, 843, 855, 859, 863, 864]

[0, 1, 5, 6, 7, 8, 9, 10, 14, 15, 21, 23, 27, 28, 29, 32, 34, 35, 36, 39, 40, 43, 48, 54, 55, 57, 58, 59, 61, 65, 66, 71, 73, 74, 75, 81, 82, 83, 84, 85, 87, 89, 92, 95, 97, 100, 101, 105, 107, 110, 112, 113, 121, 129, 130, 132, 133, 135, 137, 138, 146, 151, 152, 154, 157, 158, 159, 160, 171, 172, 173, 175, 178, 179, 189, 192, 195, 196, 201, 202, 205, 206, 207, 208, 210, 215, 222, 224, 226, 229, 232, 234, 235, 238, 239, 241, 244, 245, 250, 254, 256, 260, 262, 265, 266, 267, 268, 269, 274, 277, 278, 279, 280, 282, 284, 288, 289, 291, 293, 294, 296, 297, 298, 300, 301, 302, 306, 307, 310, 311, 312, 314, 316, 320, 321, 322, 324, 326, 328, 333, 334, 335, 338, 339, 340, 342, 344, 347, 349, 352, 355, 356, 358, 366, 367, 368, 369, 370, 371, 373, 374, 379, 380, 381, 382, 384, 386, 389, 392, 395, 399, 400, 402, 404, 405, 406, 407, 408, 410, 411, 413, 414, 416, 417, 419, 421, 425, 426, 427, 431, 432, 433, 435, 437, 439, 442, 446, 447, 448, 453, 454, 455, 456, 459, 460, 461, 462, 463, 466, 471, 474, 481, 482, 485, 488, 489, 490, 491, 495, 496, 499, 500, 502, 504, 506, 512, 513, 514, 516, 517, 519, 522, 523, 527, 530, 531, 532, 534, 535, 539, 540, 544, 545, 546, 547, 548, 550, 552, 554, 555, 556, 557, 558, 560, 562, 563, 565, 570, 573, 576, 577, 578, 579, 580, 584, 587, 588, 590, 591, 594, 598, 601, 602, 603, 605, 609, 610, 611, 612, 616, 617, 618, 620, 624, 625, 627, 628, 630, 631, 632, 633, 636, 644, 645, 646, 648, 651, 652, 653, 654, 657, 658, 659, 660, 662, 665, 668, 670, 672, 673, 677, 678, 680, 686, 692, 694, 696, 699, 705, 706, 710, 711, 712, 714, 720, 721, 723, 725, 726, 728, 735, 736, 737, 738, 740, 742, 747, 749, 750, 751, 753, 754, 756, 759, 760, 762, 764, 767, 769, 774, 776, 777, 780, 781, 782, 783, 785, 786, 791, 793, 794, 795, 799, 803, 806, 807, 808, 813, 817, 818, 820, 822, 823, 825, 827, 831, 836, 837, 838, 841, 842, 850, 852, 855, 857, 858, 863, 864, 866, 868, 871, 874, 877, 882, 883, 885, 887, 888, 889]
[17, 26, 28, 39, 44, 52, 56, 58, 59, 62, 67, 84, 99, 100, 102, 111, 113, 115, 126, 127, 135, 137, 152, 154, 157, 178, 180, 185, 191, 210, 216, 217, 222, 232, 248, 258, 263, 275, 278, 282, 296, 303, 309, 316, 323, 324, 343, 354, 355, 363, 366, 368, 375, 377, 388, 394, 396, 401, 403, 404, 413, 426, 432, 442, 445, 446, 462, 494, 503, 508, 509, 513, 517, 522, 523, 528, 545, 550, 568, 585, 588, 598, 603, 611, 638, 658, 659, 666, 676, 686, 694, 701, 706, 711, 713, 717, 718, 728, 730, 733, 736, 737, 749, 759, 768, 776, 777, 786, 788, 790, 791, 809, 813, 818, 821, 837, 840, 843, 855, 859, 863, 864]

[0, 1, 3, 5, 6, 7, 8, 9, 10, 11, 14, 15, 21, 23, 26, 27, 28, 29, 31, 32, 34, 35, 36, 39, 40, 41, 43, 44, 47, 48, 52, 54, 55, 56, 57, 58, 59, 61, 65, 66, 70, 71, 73, 74, 75, 78, 81, 82, 83, 84, 85, 86, 87, 89, 92, 93, 95, 97, 100, 101, 105, 107, 110, 111, 112, 113, 116, 117, 121, 129, 130, 132, 133, 135, 137, 138, 140, 144, 146, 151, 152, 154, 156, 157, 158, 159, 160, 161, 171, 172, 173, 175, 178, 179, 189, 192, 195, 196, 201, 202, 205, 206, 207, 208, 210, 211, 212, 215, 216, 222, 224, 226, 229, 230, 232, 234, 235, 238, 239, 241, 243, 244, 245, 250, 251, 254, 256, 260, 262, 263, 265, 266, 267, 268, 269, 271, 274, 275, 277, 278, 279, 280, 282, 284, 288, 289, 290, 291, 293, 294, 296, 297, 298, 299, 300, 301, 302, 304, 306, 307, 310, 311, 312, 313, 314, 316, 320, 321, 322, 324, 326, 327, 328, 333, 334, 335, 338, 339, 340, 342, 344, 345, 347, 348, 349, 351, 352, 355, 356, 358, 361, 362, 366, 367, 368, 369, 370, 371, 373, 374, 376, 379, 380, 381, 382, 384, 386, 387, 389, 392, 395, 399, 400, 402, 404, 405, 406, 407, 408, 410, 411, 413, 414, 416, 417, 419, 421, 425, 426, 427, 431, 432, 433, 435, 437, 439, 442, 446, 447, 448, 453, 454, 455, 456, 459, 460, 461, 462, 463, 465, 466, 471, 474, 475, 477, 479, 481, 482, 485, 488, 489, 490, 491, 495, 496, 499, 500, 502, 504, 506, 512, 513, 514, 516, 517, 518, 519, 521, 522, 523, 525, 527, 529, 530, 531, 532, 534, 535, 539, 540, 541, 544, 545, 546, 547, 548, 550, 552, 554, 555, 556, 557, 558, 560, 561, 562, 563, 565, 568, 570, 573, 576, 577, 578, 579, 580, 584, 587, 588, 590, 591, 594, 595, 598, 601, 602, 603, 605, 609, 610, 611, 612, 616, 617, 618, 620, 624, 625, 627, 628, 630, 631, 632, 633, 636, 641, 642, 644, 645, 646, 648, 649, 651, 652, 653, 654, 657, 658, 659, 660, 662, 665, 668, 670, 672, 673, 677, 678, 680, 681, 682, 686, 689, 692, 694, 696, 699, 700, 705, 706, 710, 711, 712, 714, 716, 720, 721, 723, 725, 726, 728, 729, 732, 735, 736, 737, 738, 740, 742, 743, 744, 745, 747, 749, 750, 751, 753, 754, 756, 759, 760, 762, 764, 766, 767, 768, 769, 770, 774, 776, 777, 780, 781, 782, 783, 784, 785, 786, 791, 793, 794, 795, 799, 803, 806, 807, 808, 811, 812, 813, 817, 818, 820, 822, 823, 825, 827, 831, 833, 836, 837, 838, 841, 842, 843, 850, 852, 855, 857, 858, 863, 864, 866, 868, 870, 871, 874, 877, 882, 883, 885, 887, 888, 889]
[17, 26, 28, 39, 44, 52, 56, 58, 59, 62, 67, 84, 99, 100, 102, 111, 113, 115, 126, 127, 135, 137, 152, 154, 157, 178, 180, 185, 191, 210, 216, 217, 222, 232, 248, 258, 263, 275, 278, 282, 296, 303, 309, 316, 323, 324, 343, 354, 355, 363, 366, 368, 375, 377, 388, 394, 396, 401, 403, 404, 413, 426, 432, 442, 445, 446, 462, 494, 503, 508, 509, 513, 517, 522, 523, 528, 545, 550, 568, 585, 588, 598, 603, 611, 638, 658, 659, 666, 676, 686, 694, 701, 706, 711, 713, 717, 718, 728, 730, 733, 736, 737, 749, 759, 768, 776, 777, 786, 788, 790, 791, 809, 813, 818, 821, 837, 840, 843, 855, 859, 863, 864]

[0, 1, 3, 5, 6, 7, 8, 9, 10, 11, 13, 14, 15, 21, 23, 25, 26, 27, 28, 29, 30, 31, 32, 34, 35, 36, 39, 40, 41, 43, 44, 47, 48, 52, 53, 54, 55, 56, 57, 58, 59, 61, 64, 65, 66, 70, 71, 72, 73, 74, 75, 77, 78, 81, 82, 83, 84, 85, 86, 87, 89, 91, 92, 93, 95, 97, 99, 100, 101, 104, 105, 107, 110, 111, 112, 113, 115, 116, 117, 121, 124, 128, 129, 130, 132, 133, 135, 136, 137, 138, 140, 143, 144, 145, 146, 151, 152, 153, 154, 156, 157, 158, 159, 160, 161, 164, 166, 170, 171, 172, 173, 175, 178, 179, 189, 192, 195, 196, 199, 201, 202, 205, 206, 207, 208, 209, 210, 211, 212, 213, 214, 215, 216, 220, 222, 224, 226, 228, 229, 230, 232, 234, 235, 238, 239, 241, 243, 244, 245, 249, 250, 251, 254, 256, 257, 260, 261, 262, 263, 265, 266, 267, 268, 269, 270, 271, 274, 275, 276, 277, 278, 279, 280, 281, 282, 284, 287, 288, 289, 290, 291, 293, 294, 296, 297, 298, 299, 300, 301, 302, 304, 306, 307, 310, 311, 312, 313, 314, 315, 316, 317, 320, 321, 322, 324, 326, 327, 328, 333, 334, 335, 336, 337, 338, 339, 340, 342, 344, 345, 347, 348, 349, 351, 352, 355, 356, 358, 361, 362, 364, 366, 367, 368, 369, 370, 371, 373, 374, 376, 379, 380, 381, 382, 384, 386, 387, 389, 392, 393, 394, 395, 397, 399, 400, 402, 404, 405, 406, 407, 408, 410, 411, 413, 414, 416, 417, 419, 421, 424, 425, 426, 427, 431, 432, 433, 435, 437, 439, 442, 444, 446, 447, 448, 453, 454, 455, 456, 458, 459, 460, 461, 462, 463, 465, 466, 467, 470, 471, 472, 474, 475, 477, 479, 481, 482, 485, 488, 489, 490, 491, 495, 496, 499, 500, 502, 504, 506, 507, 511, 512, 513, 514, 516, 517, 518, 519, 521, 522, 523, 525, 527, 529, 530, 531, 532, 534, 535, 539, 540, 541, 544, 545, 546, 547, 548, 550, 552, 554, 555, 556, 557, 558, 559, 560, 561, 562, 563, 565, 568, 570, 573, 576, 577, 578, 579, 580, 582, 584, 587, 588, 589, 590, 591, 593, 594, 595, 596, 597, 598, 599, 601, 602, 603, 604, 605, 606, 609, 610, 611, 612, 614, 616, 617, 618, 619, 620, 624, 625, 627, 628, 630, 631, 632, 633, 636, 640, 641, 642, 644, 645, 646, 648, 649, 651, 652, 653, 654, 657, 658, 659, 660, 661, 662, 665, 666, 668, 670, 672, 673, 677, 678, 680, 681, 682, 686, 689, 692, 693, 694, 696, 699, 700, 704, 705, 706, 710, 711, 712, 714, 716, 717, 718, 720, 721, 723, 725, 726, 728, 729, 732, 735, 736, 737, 738, 740, 742, 743, 744, 745, 747, 749, 750, 751, 753, 754, 756, 759, 760, 761, 762, 764, 766, 767, 768, 769, 770, 774, 776, 777, 778, 780, 781, 782, 783, 784, 785, 786, 791, 792, 793, 794, 795, 796, 799, 803, 806, 807, 808, 811, 812, 813, 815, 817, 818, 820, 822, 823, 825, 827, 829, 830, 831, 832, 833, 835, 836, 837, 838, 841, 842, 843, 845, 850, 852, 855, 857, 858, 863, 864, 866, 867, 868, 870, 871, 874, 877, 879, 881, 882, 883, 884, 885, 887, 888, 889]
[17, 26, 28, 39, 44, 52, 56, 58, 59, 62, 67, 84, 99, 100, 102, 111, 113, 115, 126, 127, 135, 137, 152, 154, 157, 178, 180, 185, 191, 210, 216, 217, 222, 232, 248, 258, 263, 275, 278, 282, 296, 303, 309, 316, 323, 324, 343, 354, 355, 363, 366, 368, 375, 377, 388, 394, 396, 401, 403, 404, 413, 426, 432, 442, 445, 446, 462, 494, 503, 508, 509, 513, 517, 522, 523, 528, 545, 550, 568, 585, 588, 598, 603, 611, 638, 658, 659, 666, 676, 686, 694, 701, 706, 711, 713, 717, 718, 728, 730, 733, 736, 737, 749, 759, 768, 776, 777, 786, 788, 790, 791, 809, 813, 818, 821, 837, 840, 843, 855, 859, 863, 864]

[0, 1, 2, 3, 5, 6, 7, 8, 9, 10, 11, 13, 14, 15, 21, 22, 23, 25, 26, 27, 28, 29, 30, 31, 32, 34, 35, 36, 37, 39, 40, 41, 43, 44, 46, 47, 48, 52, 53, 54, 55, 56, 57, 58, 59, 61, 62, 64, 65, 66, 67, 70, 71, 72, 73, 74, 75, 77, 78, 81, 82, 83, 84, 85, 86, 87, 89, 91, 92, 93, 95, 97, 99, 100, 101, 103, 104, 105, 107, 110, 111, 112, 113, 115, 116, 117, 118, 121, 124, 128, 129, 130, 132, 133, 135, 136, 137, 138, 140, 143, 144, 145, 146, 150, 151, 152, 153, 154, 156, 157, 158, 159, 160, 161, 164, 166, 167, 170, 171, 172, 173, 175, 176, 177, 178, 179, 181, 184, 186, 189, 192, 194, 195, 196, 198, 199, 200, 201, 202, 205, 206, 207, 208, 209, 210, 211, 212, 213, 214, 215, 216, 220, 222, 224, 225, 226, 227, 228, 229, 230, 232, 233, 234, 235, 238, 239, 241, 243, 244, 245, 249, 250, 251, 252, 254, 256, 257, 258, 259, 260, 261, 262, 263, 265, 266, 267, 268, 269, 270, 271, 274, 275, 276, 277, 278, 279, 280, 281, 282, 284, 285, 287, 288, 289, 290, 291, 293, 294, 296, 297, 298, 299, 300, 301, 302, 304, 306, 307, 308, 309, 310, 311, 312, 313, 314, 315, 316, 317, 319, 320, 321, 322, 324, 325, 326, 327, 328, 329, 330, 331, 333, 334, 335, 336, 337, 338, 339, 340, 341, 342, 344, 345, 346, 347, 348, 349, 351, 352, 355, 356, 358, 361, 362, 364, 366, 367, 368, 369, 370, 371, 373, 374, 376, 379, 380, 381, 382, 384, 386, 387, 388, 389, 392, 393, 394, 395, 397, 398, 399, 400, 402, 404, 405, 406, 407, 408, 410, 411, 413, 414, 416, 417, 418, 419, 421, 423, 424, 425, 426, 427, 431, 432, 433, 435, 436, 437, 439, 442, 444, 446, 447, 448, 451, 453, 454, 455, 456, 458, 459, 460, 461, 462, 463, 465, 466, 467, 468, 470, 471, 472, 474, 475, 477, 478, 479, 481, 482, 484, 485, 486, 487, 488, 489, 490, 491, 492, 495, 496, 498, 499, 500, 502, 504, 506, 507, 511, 512, 513, 514, 516, 517, 518, 519, 521, 522, 523, 525, 527, 528, 529, 530, 531, 532, 533, 534, 535, 539, 540, 541, 544, 545, 546, 547, 548, 549, 550, 552, 554, 555, 556, 557, 558, 559, 560, 561, 562, 563, 565, 568, 570, 573, 574, 575, 576, 577, 578, 579, 580, 581, 582, 584, 587, 588, 589, 590, 591, 593, 594, 595, 596, 597, 598, 599, 600, 601, 602, 603, 604, 605, 606, 607, 609, 610, 611, 612, 614, 616, 617, 618, 619, 620, 621, 624, 625, 627, 628, 630, 631, 632, 633, 636, 640, 641, 642, 644, 645, 646, 647, 648, 649, 651, 652, 653, 654, 657, 658, 659, 660, 661, 662, 664, 665, 666, 668, 670, 672, 673, 676, 677, 678, 680, 681, 682, 683, 684, 686, 689, 692, 693, 694, 696, 699, 700, 702, 703, 704, 705, 706, 709, 710, 711, 712, 714, 716, 717, 718, 719, 720, 721, 723, 725, 726, 728, 729, 732, 734, 735, 736, 737, 738, 739, 740, 742, 743, 744, 745, 747, 749, 750, 751, 753, 754, 755, 756, 759, 760, 761, 762, 764, 766, 767, 768, 769, 770, 774, 775, 776, 777, 778, 780, 781, 782, 783, 784, 785, 786, 791, 792, 793, 794, 795, 796, 799, 803, 806, 807, 808, 811, 812, 813, 815, 817, 818, 819, 820, 822, 823, 825, 827, 829, 830, 831, 832, 833, 834, 835, 836, 837, 838, 841, 842, 843, 845, 850, 852, 854, 855, 857, 858, 860, 863, 864, 866, 867, 868, 870, 871, 874, 875, 876, 877, 879, 881, 882, 883, 884, 885, 887, 888, 889]
[17, 26, 28, 39, 44, 52, 56, 58, 59, 62, 67, 84, 99, 100, 102, 111, 113, 115, 126, 127, 135, 137, 152, 154, 157, 178, 180, 185, 191, 210, 216, 217, 222, 232, 248, 258, 263, 275, 278, 282, 296, 303, 309, 316, 323, 324, 343, 354, 355, 363, 366, 368, 375, 377, 388, 394, 396, 401, 403, 404, 413, 426, 432, 442, 445, 446, 462, 494, 503, 508, 509, 513, 517, 522, 523, 528, 545, 550, 568, 585, 588, 598, 603, 611, 638, 658, 659, 666, 676, 686, 694, 701, 706, 711, 713, 717, 718, 728, 730, 733, 736, 737, 749, 759, 768, 776, 777, 786, 788, 790, 791, 809, 813, 818, 821, 837, 840, 843, 855, 859, 863, 864]

[0, 1, 2, 3, 4, 5, 6, 7, 8, 9, 10, 11, 13, 14, 15, 18, 21, 22, 23, 25, 26, 27, 28, 29, 30, 31, 32, 33, 34, 35, 36, 37, 39, 40, 41, 43, 44, 46, 47, 48, 52, 53, 54, 55, 56, 57, 58, 59, 60, 61, 62, 64, 65, 66, 67, 70, 71, 72, 73, 74, 75, 77, 78, 79, 81, 82, 83, 84, 85, 86, 87, 88, 89, 90, 91, 92, 93, 95, 97, 99, 100, 101, 103, 104, 105, 107, 108, 110, 111, 112, 113, 115, 116, 117, 118, 121, 124, 128, 129, 130, 132, 133, 135, 136, 137, 138, 140, 142, 143, 144, 145, 146, 148, 150, 151, 152, 153, 154, 155, 156, 157, 158, 159, 160, 161, 163, 164, 166, 167, 170, 171, 172, 173, 175, 176, 177, 178, 179, 181, 182, 183, 184, 186, 189, 190, 192, 194, 195, 196, 198, 199, 200, 201, 202, 205, 206, 207, 208, 209, 210, 211, 212, 213, 214, 215, 216, 219, 220, 222, 224, 225, 226, 227, 228, 229, 230, 232, 233, 234, 235, 236, 238, 239, 240, 241, 243, 244, 245, 246, 249, 250, 251, 252, 254, 255, 256, 257, 258, 259, 260, 261, 262, 263, 264, 265, 266, 267, 268, 269, 270, 271, 274, 275, 276, 277, 278, 279, 280, 281, 282, 284, 285, 287, 288, 289, 290, 291, 293, 294, 295, 296, 297, 298, 299, 300, 301, 302, 303, 304, 306, 307, 308, 309, 310, 311, 312, 313, 314, 315, 316, 317, 318, 319, 320, 321, 322, 324, 325, 326, 327, 328, 329, 330, 331, 333, 334, 335, 336, 337, 338, 339, 340, 341, 342, 344, 345, 346, 347, 348, 349, 351, 352, 355, 356, 357, 358, 361, 362, 363, 364, 365, 366, 367, 368, 369, 370, 371, 373, 374, 375, 376, 377, 379, 380, 381, 382, 384, 386, 387, 388, 389, 390, 391, 392, 393, 394, 395, 397, 398, 399, 400, 401, 402, 403, 404, 405, 406, 407, 408, 409, 410, 411, 413, 414, 416, 417, 418, 419, 420, 421, 422, 423, 424, 425, 426, 427, 429, 430, 431, 432, 433, 435, 436, 437, 438, 439, 441, 442, 443, 444, 446, 447, 448, 449, 451, 453, 454, 455, 456, 458, 459, 460, 461, 462, 463, 464, 465, 466, 467, 468, 469, 470, 471, 472, 474, 475, 477, 478, 479, 480, 481, 482, 484, 485, 486, 487, 488, 489, 490, 491, 492, 495, 496, 498, 499, 500, 501, 502, 503, 504, 505, 506, 507, 510, 511, 512, 513, 514, 516, 517, 518, 519, 521, 522, 523, 525, 526, 527, 528, 529, 530, 531, 532, 533, 534, 535, 539, 540, 541, 544, 545, 546, 547, 548, 549, 550, 552, 553, 554, 555, 556, 557, 558, 559, 560, 561, 562, 563, 564, 565, 568, 570, 573, 574, 575, 576, 577, 578, 579, 580, 581, 582, 584, 587, 588, 589, 590, 591, 593, 594, 595, 596, 597, 598, 599, 600, 601, 602, 603, 604, 605, 606, 607, 609, 610, 611, 612, 614, 616, 617, 618, 619, 620, 621, 624, 625, 627, 628, 630, 631, 632, 633, 636, 640, 641, 642, 644, 645, 646, 647, 648, 649, 651, 652, 653, 654, 657, 658, 659, 660, 661, 662, 663, 664, 665, 666, 668, 670, 672, 673, 675, 676, 677, 678, 679, 680, 681, 682, 683, 684, 685, 686, 688, 689, 690, 692, 693, 694, 696, 699, 700, 702, 703, 704, 705, 706, 709, 710, 711, 712, 714, 716, 717, 718, 719, 720, 721, 723, 725, 726, 727, 728, 729, 732, 734, 735, 736, 737, 738, 739, 740, 742, 743, 744, 745, 747, 749, 750, 751, 753, 754, 755, 756, 759, 760, 761, 762, 764, 766, 767, 768, 769, 770, 771, 772, 773, 774, 775, 776, 777, 778, 780, 781, 782, 783, 784, 785, 786, 791, 792, 793, 794, 795, 796, 798, 799, 801, 803, 806, 807, 808, 810, 811, 812, 813, 814, 815, 816, 817, 818, 819, 820, 821, 822, 823, 825, 827, 828, 829, 830, 831, 832, 833, 834, 835, 836, 837, 838, 840, 841, 842, 843, 844, 845, 847, 850, 852, 854, 855, 857, 858, 860, 861, 863, 864, 866, 867, 868, 870, 871, 873, 874, 875, 876, 877, 878, 879, 881, 882, 883, 884, 885, 887, 888, 889]
[17, 26, 28, 39, 44, 52, 56, 58, 59, 62, 67, 84, 99, 100, 102, 111, 113, 115, 126, 127, 135, 137, 152, 154, 157, 178, 180, 185, 191, 210, 216, 217, 222, 232, 248, 258, 263, 275, 278, 282, 296, 303, 309, 316, 323, 324, 343, 354, 355, 363, 366, 368, 375, 377, 388, 394, 396, 401, 403, 404, 413, 426, 432, 442, 445, 446, 462, 494, 503, 508, 509, 513, 517, 522, 523, 528, 545, 550, 568, 585, 588, 598, 603, 611, 638, 658, 659, 666, 676, 686, 694, 701, 706, 711, 713, 717, 718, 728, 730, 733, 736, 737, 749, 759, 768, 776, 777, 786, 788, 790, 791, 809, 813, 818, 821, 837, 840, 843, 855, 859, 863, 864]

[0, 1, 2, 3, 4, 5, 6, 7, 8, 9, 10, 11, 12, 13, 14, 15, 16, 18, 21, 22, 23, 25, 26, 27, 28, 29, 30, 31, 32, 33, 34, 35, 36, 37, 38, 39, 40, 41, 42, 43, 44, 46, 47, 48, 52, 53, 54, 55, 56, 57, 58, 59, 60, 61, 62, 64, 65, 66, 67, 69, 70, 71, 72, 73, 74, 75, 77, 78, 79, 80, 81, 82, 83, 84, 85, 86, 87, 88, 89, 90, 91, 92, 93, 95, 96, 97, 99, 100, 101, 102, 103, 104, 105, 106, 107, 108, 110, 111, 112, 113, 114, 115, 116, 117, 118, 121, 124, 125, 126, 128, 129, 130, 132, 133, 134, 135, 136, 137, 138, 139, 140, 141, 142, 143, 144, 145, 146, 148, 150, 151, 152, 153, 154, 155, 156, 157, 158, 159, 160, 161, 162, 163, 164, 166, 167, 168, 170, 171, 172, 173, 175, 176, 177, 178, 179, 181, 182, 183, 184, 186, 187, 189, 190, 192, 194, 195, 196, 198, 199, 200, 201, 202, 203, 204, 205, 206, 207, 208, 209, 210, 211, 212, 213, 214, 215, 216, 217, 218, 219, 220, 221, 222, 224, 225, 226, 227, 228, 229, 230, 231, 232, 233, 234, 235, 236, 238, 239, 240, 241, 242, 243, 244, 245, 246, 247, 249, 250, 251, 252, 253, 254, 255, 256, 257, 258, 259, 260, 261, 262, 263, 264, 265, 266, 267, 268, 269, 270, 271, 273, 274, 275, 276, 277, 278, 279, 280, 281, 282, 284, 285, 287, 288, 289, 290, 291, 292, 293, 294, 295, 296, 297, 298, 299, 300, 301, 302, 303, 304, 305, 306, 307, 308, 309, 310, 311, 312, 313, 314, 315, 316, 317, 318, 319, 320, 321, 322, 323, 324, 325, 326, 327, 328, 329, 330, 331, 332, 333, 334, 335, 336, 337, 338, 339, 340, 341, 342, 344, 345, 346, 347, 348, 349, 351, 352, 353, 355, 356, 357, 358, 360, 361, 362, 363, 364, 365, 366, 367, 368, 369, 370, 371, 373, 374, 375, 376, 377, 379, 380, 381, 382, 383, 384, 386, 387, 388, 389, 390, 391, 392, 393, 394, 395, 396, 397, 398, 399, 400, 401, 402, 403, 404, 405, 406, 407, 408, 409, 410, 411, 412, 413, 414, 415, 416, 417, 418, 419, 420, 421, 422, 423, 424, 425, 426, 427, 428, 429, 430, 431, 432, 433, 435, 436, 437, 438, 439, 441, 442, 443, 444, 446, 447, 448, 449, 451, 453, 454, 455, 456, 458, 459, 460, 461, 462, 463, 464, 465, 466, 467, 468, 469, 470, 471, 472, 474, 475, 477, 478, 479, 480, 481, 482, 484, 485, 486, 487, 488, 489, 490, 491, 492, 493, 495, 496, 498, 499, 500, 501, 502, 503, 504, 505, 506, 507, 508, 509, 510, 511, 512, 513, 514, 515, 516, 517, 518, 519, 520, 521, 522, 523, 525, 526, 527, 528, 529, 530, 531, 532, 533, 534, 535, 537, 538, 539, 540, 541, 543, 544, 545, 546, 547, 548, 549, 550, 552, 553, 554, 555, 556, 557, 558, 559, 560, 561, 562, 563, 564, 565, 567, 568, 569, 570, 571, 573, 574, 575, 576, 577, 578, 579, 580, 581, 582, 584, 587, 588, 589, 590, 591, 593, 594, 595, 596, 597, 598, 599, 600, 601, 602, 603, 604, 605, 606, 607, 608, 609, 610, 611, 612, 613, 614, 616, 617, 618, 619, 620, 621, 622, 624, 625, 627, 628, 630, 631, 632, 633, 634, 636, 637, 638, 639, 640, 641, 642, 644, 645, 646, 647, 648, 649, 651, 652, 653, 654, 657, 658, 659, 660, 661, 662, 663, 664, 665, 666, 668, 670, 672, 673, 675, 676, 677, 678, 679, 680, 681, 682, 683, 684, 685, 686, 688, 689, 690, 692, 693, 694, 696, 699, 700, 701, 702, 703, 704, 705, 706, 707, 709, 710, 711, 712, 713, 714, 715, 716, 717, 718, 719, 720, 721, 723, 724, 725, 726, 727, 728, 729, 731, 732, 734, 735, 736, 737, 738, 739, 740, 742, 743, 744, 745, 747, 749, 750, 751, 753, 754, 755, 756, 757, 759, 760, 761, 762, 764, 765, 766, 767, 768, 769, 770, 771, 772, 773, 774, 775, 776, 777, 778, 780, 781, 782, 783, 784, 785, 786, 789, 790, 791, 792, 793, 794, 795, 796, 797, 798, 799, 801, 803, 804, 805, 806, 807, 808, 809, 810, 811, 812, 813, 814, 815, 816, 817, 818, 819, 820, 821, 822, 823, 825, 827, 828, 829, 830, 831, 832, 833, 834, 835, 836, 837, 838, 839, 840, 841, 842, 843, 844, 845, 846, 847, 849, 850, 851, 852, 853, 854, 855, 856, 857, 858, 860, 861, 863, 864, 865, 866, 867, 868, 869, 870, 871, 873, 874, 875, 876, 877, 878, 879, 880, 881, 882, 883, 884, 885, 887, 888, 889]
[17, 26, 28, 39, 44, 52, 56, 58, 59, 62, 67, 84, 99, 100, 102, 111, 113, 115, 126, 127, 135, 137, 152, 154, 157, 178, 180, 185, 191, 210, 216, 217, 222, 232, 248, 258, 263, 275, 278, 282, 296, 303, 309, 316, 323, 324, 343, 354, 355, 363, 366, 368, 375, 377, 388, 394, 396, 401, 403, 404, 413, 426, 432, 442, 445, 446, 462, 494, 503, 508, 509, 513, 517, 522, 523, 528, 545, 550, 568, 585, 588, 598, 603, 611, 638, 658, 659, 666, 676, 686, 694, 701, 706, 711, 713, 717, 718, 728, 730, 733, 736, 737, 749, 759, 768, 776, 777, 786, 788, 790, 791, 809, 813, 818, 821, 837, 840, 843, 855, 859, 863, 864]

