[16, 80, 92, 111, 128, 147, 156, 224, 257, 410, 436, 457, 493, 494, 549, 620, 689, 728, 738, 772, 800, 859]
[86, 87, 117, 125, 129, 231, 246, 262, 334, 344, 352, 437, 458, 460, 476, 485, 577, 803, 836, 858, 876, 880]

[16, 80, 92, 111, 128, 147, 156, 224, 257, 410, 436, 457, 493, 494, 549, 620, 689, 728, 738, 772, 800, 859]
[14, 20, 55, 65, 68, 70, 86, 87, 94, 98, 101, 110, 115, 117, 125, 129, 134, 149, 153, 158, 169, 212, 222, 231, 243, 244, 246, 248, 252, 256, 262, 277, 281, 293, 306, 310, 324, 333, 334, 336, 344, 348, 352, 360, 363, 365, 378, 380, 396, 407, 411, 412, 421, 437, 449, 452, 453, 458, 460, 476, 480, 485, 490, 499, 501, 505, 523, 526, 535, 541, 552, 556, 559, 564, 572, 577, 584, 591, 599, 602, 619, 622, 625, 629, 631, 636, 640, 659, 661, 668, 672, 674, 688, 698, 704, 718, 729, 731, 735, 736, 745, 751, 754, 767, 771, 783, 791, 803, 812, 814, 822, 834, 835, 836, 845, 850, 851, 855, 858, 876, 880, 883]

[4, 15, 16, 21, 29, 51, 71, 80, 82, 92, 97, 104, 111, 121, 125, 128, 130, 133, 147, 156, 166, 170, 215, 224, 238, 252, 257, 265, 274, 277, 307, 319, 321, 322, 330, 332, 342, 369, 376, 384, 385, 389, 406, 410, 418, 425, 430, 436, 457, 470, 485, 491, 493, 494, 497, 505, 510, 512, 529, 534, 549, 553, 559, 570, 574, 575, 607, 616, 620, 633, 641, 659, 675, 684, 689, 692, 697, 710, 721, 728, 734, 738, 739, 745, 772, 783, 800, 806, 809, 822, 833, 844, 855, 859, 874, 876, 884]
[14, 20, 55, 65, 68, 70, 86, 87, 94, 98, 101, 110, 115, 117, 125, 129, 134, 149, 153, 158, 169, 212, 222, 231, 243, 244, 246, 248, 252, 256, 262, 277, 281, 293, 306, 310, 324, 333, 334, 336, 344, 348, 352, 360, 363, 365, 378, 380, 396, 407, 411, 412, 421, 437, 449, 452, 453, 458, 460, 476, 480, 485, 490, 499, 501, 505, 523, 526, 535, 541, 552, 556, 559, 564, 572, 577, 584, 591, 599, 602, 619, 622, 625, 629, 631, 636, 640, 659, 661, 668, 672, 674, 688, 698, 704, 718, 729, 731, 735, 736, 745, 751, 754, 767, 771, 783, 791, 803, 812, 814, 822, 834, 835, 836, 845, 850, 851, 855, 858, 876, 880, 883]

[4, 8, 14, 15, 16, 21, 25, 26, 28, 29, 30, 36, 51, 60, 71, 74, 79, 80, 82, 86, 92, 97, 104, 111, 119, 121, 125, 128, 130, 133, 135, 145, 147, 151, 156, 166, 170, 188, 198, 215, 221, 224, 238, 241, 252, 255, 257, 263, 265, 274, 277, 307, 310, 315, 319, 320, 321, 322, 330, 332, 336, 342, 369, 374, 376, 384, 385, 386, 388, 389, 396, 398, 401, 406, 410, 418, 421, 425, 429, 430, 434, 436, 450, 457, 470, 472, 475, 485, 486, 491, 492, 493, 494, 497, 498, 503, 505, 510, 512, 516, 521, 522, 529, 533, 534, 549, 553, 557, 559, 563, 570, 574, 575, 576, 584, 607, 615, 616, 620, 633, 634, 635, 641, 659, 663, 675, 676, 684, 686, 689, 690, 692, 697, 702, 709, 710, 714, 718, 721, 724, 728, 731, 734, 736, 738, 739, 745, 772, 778, 783, 785, 796, 798, 800, 802, 806, 809, 822, 828, 833, 836, 841, 844, 853, 855, 859, 860, 874, 875, 876, 884, 889]
[14, 20, 55, 65, 68, 70, 86, 87, 94, 98, 101, 110, 115, 117, 125, 129, 134, 149, 153, 158, 169, 212, 222, 231, 243, 244, 246, 248, 252, 256, 262, 277, 281, 293, 306, 310, 324, 333, 334, 336, 344, 348, 352, 360, 363, 365, 378, 380, 396, 407, 411, 412, 421, 437, 449, 452, 453, 458, 460, 476, 480, 485, 490, 499, 501, 505, 523, 526, 535, 541, 552, 556, 559, 564, 572, 577, 584, 591, 599, 602, 619, 622, 625, 629, 631, 636, 640, 659, 661, 668, 672, 674, 688, 698, 704, 718, 729, 731, 735, 736, 745, 751, 754, 767, 771, 783, 791, 803, 812, 814, 822, 834, 835, 836, 845, 850, 851, 855, 858, 876, 880, 883]

[3, 4, 8, 11, 14, 15, 16, 18, 21, 25, 26, 28, 29, 30, 31, 36, 39, 49, 51, 60, 70, 71, 74, 79, 80, 82, 86, 87, 92, 94, 97, 101, 104, 111, 113, 116, 119, 121, 125, 128, 130, 133, 135, 138, 141, 145, 147, 151, 155, 156, 166, 170, 175, 176, 179, 188, 192, 194, 198, 208, 215, 221, 223, 224, 225, 238, 241, 252, 255, 257, 263, 264, 265, 274, 275, 277, 289, 290, 297, 307, 310, 315, 319, 320, 321, 322, 330, 332, 335, 336, 342, 347, 355, 359, 368, 369, 374, 376, 384, 385, 386, 388, 389, 396, 398, 399, 401, 406, 410, 418, 421, 425, 429, 430, 433, 434, 436, 450, 457, 470, 472, 474, 475, 476, 478, 484, 485, 486, 487, 491, 492, 493, 494, 496, 497, 498, 503, 505, 510, 512, 516, 519, 521, 522, 526, 529, 532, 533, 534, 536, 538, 549, 553, 557, 559, 563, 570, 574, 575, 576, 584, 591, 593, 595, 597, 604, 606, 607, 612, 615, 616, 620, 626, 631, 633, 634, 635, 639, 641, 654, 659, 663, 668, 675, 676, 677, 679, 684, 686, 689, 690, 692, 697, 702, 709, 710, 714, 718, 721, 722, 724, 728, 731, 734, 736, 738, 739, 745, 748, 754, 772, 775, 778, 783, 785, 787, 789, 796, 797, 798, 800, 802, 806, 809, 817, 820, 822, 828, 831, 833, 835, 836, 838, 841, 843, 844, 853, 855, 859, 860, 864, 871, 874, 875, 876, 884, 889]
[14, 20, 55, 65, 68, 70, 86, 87, 94, 98, 101, 110, 115, 117, 125, 129, 134, 149, 153, 158, 169, 212, 222, 231, 243, 244, 246, 248, 252, 256, 262, 277, 281, 293, 306, 310, 324, 333, 334, 336, 344, 348, 352, 360, 363, 365, 378, 380, 396, 407, 411, 412, 421, 437, 449, 452, 453, 458, 460, 476, 480, 485, 490, 499, 501, 505, 523, 526, 535, 541, 552, 556, 559, 564, 572, 577, 584, 591, 599, 602, 619, 622, 625, 629, 631, 636, 640, 659, 661, 668, 672, 674, 688, 698, 704, 718, 729, 731, 735, 736, 745, 751, 754, 767, 771, 783, 791, 803, 812, 814, 822, 834, 835, 836, 845, 850, 851, 855, 858, 876, 880, 883]

[2, 3, 4, 8, 11, 14, 15, 16, 18, 21, 25, 26, 27, 28, 29, 30, 31, 36, 39, 40, 49, 51, 54, 60, 70, 71, 74, 79, 80, 81, 82, 86, 87, 91, 92, 94, 95, 96, 97, 100, 101, 104, 111, 113, 116, 117, 119, 120, 121, 124, 125, 128, 130, 133, 135, 138, 141, 145, 147, 148, 150, 151, 155, 156, 166, 169, 170, 175, 176, 177, 179, 188, 192, 194, 198, 202, 208, 212, 215, 221, 223, 224, 225, 234, 238, 241, 249, 252, 255, 257, 263, 264, 265, 268, 274, 275, 277, 279, 282, 285, 286, 289, 290, 297, 307, 310, 311, 313, 315, 319, 320, 321, 322, 330, 332, 335, 336, 342, 343, 347, 355, 356, 359, 366, 367, 368, 369, 370, 371, 374, 376, 378, 384, 385, 386, 388, 389, 396, 398, 399, 401, 406, 410, 412, 413, 418, 421, 425, 429, 430, 433, 434, 436, 440, 441, 445, 450, 457, 460, 465, 470, 471, 472, 474, 475, 476, 478, 484, 485, 486, 487, 491, 492, 493, 494, 496, 497, 498, 503, 505, 507, 510, 512, 515, 516, 519, 521, 522, 524, 526, 529, 532, 533, 534, 536, 538, 549, 552, 553, 557, 559, 563, 565, 570, 574, 575, 576, 579, 584, 591, 592, 593, 594, 595, 597, 600, 601, 602, 604, 606, 607, 608, 611, 612, 615, 616, 620, 626, 631, 633, 634, 635, 639, 641, 643, 654, 656, 659, 663, 668, 672, 675, 676, 677, 679, 684, 686, 689, 690, 692, 697, 702, 703, 709, 710, 712, 714, 718, 721, 722, 724, 728, 731, 734, 736, 738, 739, 742, 745, 748, 754, 756, 758, 772, 775, 778, 783, 785, 786, 787, 788, 789, 790, 796, 797, 798, 800, 801, 802, 806, 807, 809, 811, 816, 817, 818, 820, 822, 828, 831, 833, 835, 836, 838, 840, 841, 843, 844, 848, 851, 853, 855, 859, 860, 863, 864, 871, 874, 875, 876, 884, 889]
[14, 20, 55, 65, 68, 70, 86, 87, 94, 98, 101, 110, 115, 117, 125, 129, 134, 149, 153, 158, 169, 212, 222, 231, 243, 244, 246, 248, 252, 256, 262, 277, 281, 293, 306, 310, 324, 333, 334, 336, 344, 348, 352, 360, 363, 365, 378, 380, 396, 407, 411, 412, 421, 437, 449, 452, 453, 458, 460, 476, 480, 485, 490, 499, 501, 505, 523, 526, 535, 541, 552, 556, 559, 564, 572, 577, 584, 591, 599, 602, 619, 622, 625, 629, 631, 636, 640, 659, 661, 668, 672, 674, 688, 698, 704, 718, 729, 731, 735, 736, 745, 751, 754, 767, 771, 783, 791, 803, 812, 814, 822, 834, 835, 836, 845, 850, 851, 855, 858, 876, 880, 883]

[0, 2, 3, 4, 7, 8, 11, 14, 15, 16, 18, 21, 24, 25, 26, 27, 28, 29, 30, 31, 32, 36, 39, 40, 42, 49, 51, 54, 60, 65, 68, 70, 71, 74, 79, 80, 81, 82, 86, 87, 91, 92, 94, 95, 96, 97, 100, 101, 104, 111, 113, 116, 117, 118, 119, 120, 121, 124, 125, 128, 130, 133, 135, 138, 141, 144, 145, 147, 148, 150, 151, 155, 156, 166, 168, 169, 170, 175, 176, 177, 179, 188, 192, 193, 194, 197, 198, 199, 200, 202, 204, 208, 211, 212, 215, 219, 220, 221, 223, 224, 225, 227, 231, 234, 236, 238, 241, 249, 250, 252, 255, 256, 257, 259, 263, 264, 265, 268, 269, 273, 274, 275, 277, 279, 281, 282, 285, 286, 288, 289, 290, 297, 298, 302, 307, 310, 311, 313, 315, 319, 320, 321, 322, 329, 330, 332, 335, 336, 342, 343, 344, 347, 354, 355, 356, 359, 364, 366, 367, 368, 369, 370, 371, 374, 376, 378, 380, 383, 384, 385, 386, 388, 389, 390, 396, 397, 398, 399, 401, 406, 408, 410, 412, 413, 418, 421, 425, 426, 428, 429, 430, 433, 434, 436, 440, 441, 445, 450, 457, 460, 463, 465, 467, 470, 471, 472, 473, 474, 475, 476, 478, 483, 484, 485, 486, 487, 490, 491, 492, 493, 494, 496, 497, 498, 500, 501, 503, 505, 507, 510, 511, 512, 515, 516, 519, 521, 522, 524, 526, 528, 529, 532, 533, 534, 536, 538, 540, 543, 547, 548, 549, 550, 552, 553, 555, 556, 557, 559, 563, 565, 567, 570, 573, 574, 575, 576, 578, 579, 584, 591, 592, 593, 594, 595, 597, 600, 601, 602, 604, 606, 607, 608, 611, 612, 615, 616, 620, 622, 626, 631, 632, 633, 634, 635, 639, 641, 643, 648, 654, 656, 659, 663, 668, 672, 673, 675, 676, 677, 679, 684, 686, 689, 690, 692, 697, 702, 703, 706, 709, 710, 711, 712, 714, 718, 721, 722, 724, 728, 729, 731, 734, 736, 738, 739, 742, 745, 748, 750, 754, 755, 756, 758, 767, 770, 772, 775, 778, 783, 785, 786, 787, 788, 789, 790, 796, 797, 798, 800, 801, 802, 806, 807, 809, 811, 812, 816, 817, 818, 820, 822, 826, 828, 831, 833, 835, 836, 838, 840, 841, 843, 844, 848, 851, 853, 855, 859, 860, 862, 863, 864, 871, 874, 875, 876, 884, 887, 889]
[14, 20, 55, 65, 68, 70, 86, 87, 94, 98, 101, 110, 115, 117, 125, 129, 134, 149, 153, 158, 169, 212, 222, 231, 243, 244, 246, 248, 252, 256, 262, 277, 281, 293, 306, 310, 324, 333, 334, 336, 344, 348, 352, 360, 363, 365, 378, 380, 396, 407, 411, 412, 421, 437, 449, 452, 453, 458, 460, 476, 480, 485, 490, 499, 501, 505, 523, 526, 535, 541, 552, 556, 559, 564, 572, 577, 584, 591, 599, 602, 619, 622, 625, 629, 631, 636, 640, 659, 661, 668, 672, 674, 688, 698, 704, 718, 729, 731, 735, 736, 745, 751, 754, 767, 771, 783, 791, 803, 812, 814, 822, 834, 835, 836, 845, 850, 851, 855, 858, 876, 880, 883]

[0, 2, 3, 4, 6, 7, 8, 11, 14, 15, 16, 18, 21, 24, 25, 26, 27, 28, 29, 30, 31, 32, 36, 39, 40, 42, 43, 45, 49, 51, 52, 53, 54, 59, 60, 61, 65, 68, 70, 71, 73, 74, 75, 79, 80, 81, 82, 86, 87, 91, 92, 93, 94, 95, 96, 97, 100, 101, 104, 111, 113, 116, 117, 118, 119, 120, 121, 124, 125, 126, 128, 130, 133, 135, 138, 141, 142, 144, 145, 147, 148, 149, 150, 151, 155, 156, 164, 165, 166, 167, 168, 169, 170, 175, 176, 177, 179, 183, 188, 192, 193, 194, 195, 196, 197, 198, 199, 200, 202, 204, 208, 211, 212, 215, 219, 220, 221, 223, 224, 225, 226, 227, 231, 234, 236, 238, 241, 247, 248, 249, 250, 252, 255, 256, 257, 259, 261, 263, 264, 265, 268, 269, 273, 274, 275, 277, 279, 281, 282, 285, 286, 288, 289, 290, 293, 297, 298, 299, 302, 307, 310, 311, 312, 313, 315, 317, 319, 320, 321, 322, 324, 325, 329, 330, 332, 333, 334, 335, 336, 340, 342, 343, 344, 347, 354, 355, 356, 359, 364, 365, 366, 367, 368, 369, 370, 371, 374, 376, 377, 378, 380, 383, 384, 385, 386, 388, 389, 390, 393, 394, 396, 397, 398, 399, 401, 404, 406, 408, 410, 411, 412, 413, 418, 421, 425, 426, 428, 429, 430, 433, 434, 436, 440, 441, 444, 445, 450, 454, 455, 457, 458, 460, 461, 463, 465, 467, 468, 470, 471, 472, 473, 474, 475, 476, 478, 483, 484, 485, 486, 487, 490, 491, 492, 493, 494, 496, 497, 498, 500, 501, 503, 504, 505, 507, 510, 511, 512, 515, 516, 519, 521, 522, 524, 526, 528, 529, 532, 533, 534, 536, 538, 539, 540, 543, 547, 548, 549, 550, 552, 553, 555, 556, 557, 559, 563, 565, 566, 567, 570, 571, 573, 574, 575, 576, 578, 579, 582, 584, 591, 592, 593, 594, 595, 597, 600, 601, 602, 604, 606, 607, 608, 609, 611, 612, 613, 615, 616, 620, 622, 624, 626, 631, 632, 633, 634, 635, 637, 639, 641, 643, 648, 651, 652, 654, 656, 659, 663, 668, 670, 672, 673, 674, 675, 676, 677, 678, 679, 680, 684, 686, 688, 689, 690, 692, 696, 697, 702, 703, 704, 705, 706, 707, 708, 709, 710, 711, 712, 714, 717, 718, 721, 722, 724, 728, 729, 731, 734, 736, 738, 739, 742, 745, 748, 750, 752, 754, 755, 756, 758, 764, 767, 770, 772, 774, 775, 778, 781, 783, 785, 786, 787, 788, 789, 790, 791, 796, 797, 798, 800, 801, 802, 803, 806, 807, 809, 810, 811, 812, 816, 817, 818, 820, 821, 822, 826, 828, 831, 833, 835, 836, 838, 840, 841, 843, 844, 848, 851, 853, 855, 859, 860, 862, 863, 864, 865, 871, 874, 875, 876, 884, 887, 889]
[14, 20, 55, 65, 68, 70, 86, 87, 94, 98, 101, 110, 115, 117, 125, 129, 134, 149, 153, 158, 169, 212, 222, 231, 243, 244, 246, 248, 252, 256, 262, 277, 281, 293, 306, 310, 324, 333, 334, 336, 344, 348, 352, 360, 363, 365, 378, 380, 396, 407, 411, 412, 421, 437, 449, 452, 453, 458, 460, 476, 480, 485, 490, 499, 501, 505, 523, 526, 535, 541, 552, 556, 559, 564, 572, 577, 584, 591, 599, 602, 619, 622, 625, 629, 631, 636, 640, 659, 661, 668, 672, 674, 688, 698, 704, 718, 729, 731, 735, 736, 745, 751, 754, 767, 771, 783, 791, 803, 812, 814, 822, 834, 835, 836, 845, 850, 851, 855, 858, 876, 880, 883]

[0, 2, 3, 4, 5, 6, 7, 8, 10, 11, 14, 15, 16, 18, 21, 22, 23, 24, 25, 26, 27, 28, 29, 30, 31, 32, 35, 36, 38, 39, 40, 42, 43, 45, 48, 49, 51, 52, 53, 54, 58, 59, 60, 61, 63, 65, 68, 69, 70, 71, 72, 73, 74, 75, 78, 79, 80, 81, 82, 86, 87, 89, 90, 91, 92, 93, 94, 95, 96, 97, 100, 101, 103, 104, 111, 112, 113, 116, 117, 118, 119, 120, 121, 122, 124, 125, 126, 127, 128, 130, 133, 135, 138, 141, 142, 144, 145, 147, 148, 149, 150, 151, 155, 156, 161, 164, 165, 166, 167, 168, 169, 170, 171, 173, 174, 175, 176, 177, 179, 183, 184, 188, 192, 193, 194, 195, 196, 197, 198, 199, 200, 202, 204, 206, 208, 211, 212, 215, 219, 220, 221, 223, 224, 225, 226, 227, 231, 234, 236, 238, 241, 247, 248, 249, 250, 252, 255, 256, 257, 259, 261, 263, 264, 265, 266, 268, 269, 273, 274, 275, 277, 279, 281, 282, 284, 285, 286, 287, 288, 289, 290, 292, 293, 297, 298, 299, 302, 304, 306, 307, 308, 310, 311, 312, 313, 315, 317, 319, 320, 321, 322, 323, 324, 325, 329, 330, 332, 333, 334, 335, 336, 340, 341, 342, 343, 344, 346, 347, 354, 355, 356, 359, 360, 364, 365, 366, 367, 368, 369, 370, 371, 373, 374, 376, 377, 378, 380, 383, 384, 385, 386, 388, 389, 390, 393, 394, 396, 397, 398, 399, 401, 404, 406, 408, 409, 410, 411, 412, 413, 418, 419, 421, 425, 426, 428, 429, 430, 433, 434, 435, 436, 440, 441, 444, 445, 450, 454, 455, 457, 458, 460, 461, 463, 465, 467, 468, 470, 471, 472, 473, 474, 475, 476, 478, 483, 484, 485, 486, 487, 490, 491, 492, 493, 494, 496, 497, 498, 499, 500, 501, 503, 504, 505, 507, 510, 511, 512, 515, 516, 519, 521, 522, 524, 526, 528, 529, 532, 533, 534, 536, 538, 539, 540, 543, 547, 548, 549, 550, 551, 552, 553, 554, 555, 556, 557, 559, 563, 565, 566, 567, 568, 569, 570, 571, 573, 574, 575, 576, 578, 579, 582, 584, 591, 592, 593, 594, 595, 596, 597, 600, 601, 602, 603, 604, 605, 606, 607, 608, 609, 611, 612, 613, 614, 615, 616, 617, 620, 622, 623, 624, 626, 631, 632, 633, 634, 635, 637, 639, 641, 643, 648, 651, 652, 653, 654, 655, 656, 657, 659, 660, 663, 665, 668, 670, 672, 673, 674, 675, 676, 677, 678, 679, 680, 681, 684, 686, 688, 689, 690, 692, 696, 697, 698, 702, 703, 704, 705, 706, 707, 708, 709, 710, 711, 712, 714, 717, 718, 719, 721, 722, 724, 726, 728, 729, 731, 732, 734, 736, 738, 739, 742, 743, 745, 748, 750, 752, 754, 755, 756, 758, 764, 767, 768, 770, 772, 774, 775, 778, 781, 782, 783, 785, 786, 787, 788, 789, 790, 791, 793, 796, 797, 798, 800, 801, 802, 803, 806, 807, 808, 809, 810, 811, 812, 815, 816, 817, 818, 820, 821, 822, 823, 824, 826, 828, 831, 832, 833, 835, 836, 838, 840, 841, 843, 844, 846, 847, 848, 850, 851, 853, 855, 856, 859, 860, 861, 862, 863, 864, 865, 867, 871, 874, 875, 876, 884, 887, 889]
[14, 20, 55, 65, 68, 70, 86, 87, 94, 98, 101, 110, 115, 117, 125, 129, 134, 149, 153, 158, 169, 212, 222, 231, 243, 244, 246, 248, 252, 256, 262, 277, 281, 293, 306, 310, 324, 333, 334, 336, 344, 348, 352, 360, 363, 365, 378, 380, 396, 407, 411, 412, 421, 437, 449, 452, 453, 458, 460, 476, 480, 485, 490, 499, 501, 505, 523, 526, 535, 541, 552, 556, 559, 564, 572, 577, 584, 591, 599, 602, 619, 622, 625, 629, 631, 636, 640, 659, 661, 668, 672, 674, 688, 698, 704, 718, 729, 731, 735, 736, 745, 751, 754, 767, 771, 783, 791, 803, 812, 814, 822, 834, 835, 836, 845, 850, 851, 855, 858, 876, 880, 883]

[0, 2, 3, 4, 5, 6, 7, 8, 10, 11, 13, 14, 15, 16, 18, 19, 21, 22, 23, 24, 25, 26, 27, 28, 29, 30, 31, 32, 35, 36, 38, 39, 40, 42, 43, 44, 45, 48, 49, 51, 52, 53, 54, 57, 58, 59, 60, 61, 63, 64, 65, 67, 68, 69, 70, 71, 72, 73, 74, 75, 78, 79, 80, 81, 82, 83, 86, 87, 89, 90, 91, 92, 93, 94, 95, 96, 97, 99, 100, 101, 103, 104, 108, 109, 111, 112, 113, 115, 116, 117, 118, 119, 120, 121, 122, 124, 125, 126, 127, 128, 130, 133, 134, 135, 138, 141, 142, 144, 145, 147, 148, 149, 150, 151, 153, 155, 156, 157, 161, 164, 165, 166, 167, 168, 169, 170, 171, 173, 174, 175, 176, 177, 179, 180, 183, 184, 186, 188, 192, 193, 194, 195, 196, 197, 198, 199, 200, 201, 202, 204, 205, 206, 208, 211, 212, 215, 219, 220, 221, 223, 224, 225, 226, 227, 231, 233, 234, 236, 238, 239, 241, 242, 243, 244, 245, 247, 248, 249, 250, 252, 253, 254, 255, 256, 257, 259, 261, 263, 264, 265, 266, 267, 268, 269, 273, 274, 275, 277, 279, 280, 281, 282, 284, 285, 286, 287, 288, 289, 290, 291, 292, 293, 294, 295, 296, 297, 298, 299, 302, 304, 306, 307, 308, 310, 311, 312, 313, 315, 317, 318, 319, 320, 321, 322, 323, 324, 325, 329, 330, 332, 333, 334, 335, 336, 340, 341, 342, 343, 344, 346, 347, 350, 354, 355, 356, 359, 360, 362, 364, 365, 366, 367, 368, 369, 370, 371, 373, 374, 376, 377, 378, 380, 381, 383, 384, 385, 386, 388, 389, 390, 391, 392, 393, 394, 396, 397, 398, 399, 401, 404, 406, 408, 409, 410, 411, 412, 413, 418, 419, 420, 421, 423, 424, 425, 426, 428, 429, 430, 433, 434, 435, 436, 440, 441, 444, 445, 450, 451, 452, 454, 455, 457, 458, 460, 461, 463, 465, 467, 468, 470, 471, 472, 473, 474, 475, 476, 478, 483, 484, 485, 486, 487, 488, 489, 490, 491, 492, 493, 494, 496, 497, 498, 499, 500, 501, 503, 504, 505, 506, 507, 510, 511, 512, 515, 516, 519, 521, 522, 523, 524, 525, 526, 528, 529, 532, 533, 534, 536, 538, 539, 540, 543, 546, 547, 548, 549, 550, 551, 552, 553, 554, 555, 556, 557, 559, 561, 563, 564, 565, 566, 567, 568, 569, 570, 571, 572, 573, 574, 575, 576, 578, 579, 581, 582, 584, 585, 587, 589, 591, 592, 593, 594, 595, 596, 597, 600, 601, 602, 603, 604, 605, 606, 607, 608, 609, 610, 611, 612, 613, 614, 615, 616, 617, 618, 619, 620, 622, 623, 624, 626, 628, 630, 631, 632, 633, 634, 635, 637, 639, 640, 641, 643, 645, 648, 649, 651, 652, 653, 654, 655, 656, 657, 659, 660, 663, 664, 665, 667, 668, 670, 672, 673, 674, 675, 676, 677, 678, 679, 680, 681, 683, 684, 686, 688, 689, 690, 691, 692, 696, 697, 698, 701, 702, 703, 704, 705, 706, 707, 708, 709, 710, 711, 712, 714, 717, 718, 719, 721, 722, 724, 725, 726, 728, 729, 731, 732, 734, 736, 738, 739, 742, 743, 745, 746, 747, 748, 750, 752, 754, 755, 756, 758, 764, 767, 768, 770, 772, 773, 774, 775, 778, 779, 780, 781, 782, 783, 785, 786, 787, 788, 789, 790, 791, 793, 796, 797, 798, 800, 801, 802, 803, 805, 806, 807, 808, 809, 810, 811, 812, 814, 815, 816, 817, 818, 819, 820, 821, 822, 823, 824, 826, 828, 829, 830, 831, 832, 833, 834, 835, 836, 838, 840, 841, 843, 844, 845, 846, 847, 848, 849, 850, 851, 853, 855, 856, 857, 859, 860, 861, 862, 863, 864, 865, 867, 871, 872, 874, 875, 876, 884, 887, 889]
[14, 20, 55, 65, 68, 70, 86, 87, 94, 98, 101, 110, 115, 117, 125, 129, 134, 149, 153, 158, 169, 212, 222, 231, 243, 244, 246, 248, 252, 256, 262, 277, 281, 293, 306, 310, 324, 333, 334, 336, 344, 348, 352, 360, 363, 365, 378, 380, 396, 407, 411, 412, 421, 437, 449, 452, 453, 458, 460, 476, 480, 485, 490, 499, 501, 505, 523, 526, 535, 541, 552, 556, 559, 564, 572, 577, 584, 591, 599, 602, 619, 622, 625, 629, 631, 636, 640, 659, 661, 668, 672, 674, 688, 698, 704, 718, 729, 731, 735, 736, 745, 751, 754, 767, 771, 783, 791, 803, 812, 814, 822, 834, 835, 836, 845, 850, 851, 855, 858, 876, 880, 883]

[0, 2, 3, 4, 5, 6, 7, 8, 9, 10, 11, 13, 14, 15, 16, 18, 19, 21, 22, 23, 24, 25, 26, 27, 28, 29, 30, 31, 32, 35, 36, 38, 39, 40, 42, 43, 44, 45, 46, 48, 49, 51, 52, 53, 54, 57, 58, 59, 60, 61, 62, 63, 64, 65, 67, 68, 69, 70, 71, 72, 73, 74, 75, 77, 78, 79, 80, 81, 82, 83, 86, 87, 88, 89, 90, 91, 92, 93, 94, 95, 96, 97, 98, 99, 100, 101, 102, 103, 104, 105, 108, 109, 111, 112, 113, 114, 115, 116, 117, 118, 119, 120, 121, 122, 123, 124, 125, 126, 127, 128, 130, 133, 134, 135, 137, 138, 141, 142, 144, 145, 147, 148, 149, 150, 151, 153, 155, 156, 157, 159, 161, 163, 164, 165, 166, 167, 168, 169, 170, 171, 173, 174, 175, 176, 177, 179, 180, 182, 183, 184, 185, 186, 188, 189, 191, 192, 193, 194, 195, 196, 197, 198, 199, 200, 201, 202, 204, 205, 206, 207, 208, 210, 211, 212, 213, 214, 215, 217, 218, 219, 220, 221, 223, 224, 225, 226, 227, 231, 233, 234, 236, 238, 239, 241, 242, 243, 244, 245, 246, 247, 248, 249, 250, 252, 253, 254, 255, 256, 257, 259, 261, 263, 264, 265, 266, 267, 268, 269, 270, 273, 274, 275, 276, 277, 279, 280, 281, 282, 284, 285, 286, 287, 288, 289, 290, 291, 292, 293, 294, 295, 296, 297, 298, 299, 301, 302, 304, 306, 307, 308, 310, 311, 312, 313, 314, 315, 317, 318, 319, 320, 321, 322, 323, 324, 325, 326, 328, 329, 330, 331, 332, 333, 334, 335, 336, 337, 338, 340, 341, 342, 343, 344, 346, 347, 348, 349, 350, 351, 353, 354, 355, 356, 359, 360, 361, 362, 364, 365, 366, 367, 368, 369, 370, 371, 373, 374, 376, 377, 378, 380, 381, 383, 384, 385, 386, 388, 389, 390, 391, 392, 393, 394, 395, 396, 397, 398, 399, 401, 402, 404, 406, 407, 408, 409, 410, 411, 412, 413, 414, 415, 418, 419, 420, 421, 423, 424, 425, 426, 428, 429, 430, 433, 434, 435, 436, 438, 440, 441, 444, 445, 446, 447, 448, 450, 451, 452, 454, 455, 457, 458, 460, 461, 463, 465, 467, 468, 469, 470, 471, 472, 473, 474, 475, 476, 477, 478, 481, 483, 484, 485, 486, 487, 488, 489, 490, 491, 492, 493, 494, 496, 497, 498, 499, 500, 501, 503, 504, 505, 506, 507, 508, 510, 511, 512, 515, 516, 518, 519, 520, 521, 522, 523, 524, 525, 526, 528, 529, 530, 532, 533, 534, 536, 538, 539, 540, 541, 543, 545, 546, 547, 548, 549, 550, 551, 552, 553, 554, 555, 556, 557, 558, 559, 561, 563, 564, 565, 566, 567, 568, 569, 570, 571, 572, 573, 574, 575, 576, 578, 579, 581, 582, 584, 585, 586, 587, 589, 591, 592, 593, 594, 595, 596, 597, 598, 600, 601, 602, 603, 604, 605, 606, 607, 608, 609, 610, 611, 612, 613, 614, 615, 616, 617, 618, 619, 620, 622, 623, 624, 626, 628, 630, 631, 632, 633, 634, 635, 636, 637, 639, 640, 641, 643, 644, 645, 648, 649, 651, 652, 653, 654, 655, 656, 657, 659, 660, 662, 663, 664, 665, 666, 667, 668, 670, 672, 673, 674, 675, 676, 677, 678, 679, 680, 681, 683, 684, 686, 688, 689, 690, 691, 692, 695, 696, 697, 698, 701, 702, 703, 704, 705, 706, 707, 708, 709, 710, 711, 712, 713, 714, 717, 718, 719, 721, 722, 724, 725, 726, 728, 729, 730, 731, 732, 734, 736, 738, 739, 742, 743, 745, 746, 747, 748, 750, 752, 754, 755, 756, 757, 758, 760, 764, 767, 768, 770, 772, 773, 774, 775, 778, 779, 780, 781, 782, 783, 784, 785, 786, 787, 788, 789, 790, 791, 793, 796, 797, 798, 800, 801, 802, 803, 805, 806, 807, 808, 809, 810, 811, 812, 814, 815, 816, 817, 818, 819, 820, 821, 822, 823, 824, 825, 826, 828, 829, 830, 831, 832, 833, 834, 835, 836, 838, 840, 841, 843, 844, 845, 846, 847, 848, 849, 850, 851, 852, 853, 855, 856, 857, 859, 860, 861, 862, 863, 864, 865, 867, 868, 869, 870, 871, 872, 873, 874, 875, 876, 884, 887, 889]
[14, 20, 55, 65, 68, 70, 86, 87, 94, 98, 101, 110, 115, 117, 125, 129, 134, 149, 153, 158, 169, 212, 222, 231, 243, 244, 246, 248, 252, 256, 262, 277, 281, 293, 306, 310, 324, 333, 334, 336, 344, 348, 352, 360, 363, 365, 378, 380, 396, 407, 411, 412, 421, 437, 449, 452, 453, 458, 460, 476, 480, 485, 490, 499, 501, 505, 523, 526, 535, 541, 552, 556, 559, 564, 572, 577, 584, 591, 599, 602, 619, 622, 625, 629, 631, 636, 640, 659, 661, 668, 672, 674, 688, 698, 704, 718, 729, 731, 735, 736, 745, 751, 754, 767, 771, 783, 791, 803, 812, 814, 822, 834, 835, 836, 845, 850, 851, 855, 858, 876, 880, 883]

[0, 2, 3, 4, 5, 6, 7, 8, 9, 10, 11, 13, 14, 15, 16, 18, 19, 21, 22, 23, 24, 25, 26, 27, 28, 29, 30, 31, 32, 33, 34, 35, 36, 37, 38, 39, 40, 41, 42, 43, 44, 45, 46, 47, 48, 49, 51, 52, 53, 54, 57, 58, 59, 60, 61, 62, 63, 64, 65, 67, 68, 69, 70, 71, 72, 73, 74, 75, 77, 78, 79, 80, 81, 82, 83, 84, 85, 86, 87, 88, 89, 90, 91, 92, 93, 94, 95, 96, 97, 98, 99, 100, 101, 102, 103, 104, 105, 108, 109, 111, 112, 113, 114, 115, 116, 117, 118, 119, 120, 121, 122, 123, 124, 125, 126, 127, 128, 130, 133, 134, 135, 136, 137, 138, 139, 141, 142, 144, 145, 147, 148, 149, 150, 151, 152, 153, 155, 156, 157, 159, 161, 163, 164, 165, 166, 167, 168, 169, 170, 171, 172, 173, 174, 175, 176, 177, 178, 179, 180, 182, 183, 184, 185, 186, 188, 189, 190, 191, 192, 193, 194, 195, 196, 197, 198, 199, 200, 201, 202, 203, 204, 205, 206, 207, 208, 210, 211, 212, 213, 214, 215, 217, 218, 219, 220, 221, 223, 224, 225, 226, 227, 228, 231, 233, 234, 236, 238, 239, 241, 242, 243, 244, 245, 246, 247, 248, 249, 250, 252, 253, 254, 255, 256, 257, 259, 261, 262, 263, 264, 265, 266, 267, 268, 269, 270, 271, 272, 273, 274, 275, 276, 277, 279, 280, 281, 282, 283, 284, 285, 286, 287, 288, 289, 290, 291, 292, 293, 294, 295, 296, 297, 298, 299, 300, 301, 302, 303, 304, 305, 306, 307, 308, 309, 310, 311, 312, 313, 314, 315, 316, 317, 318, 319, 320, 321, 322, 323, 324, 325, 326, 327, 328, 329, 330, 331, 332, 333, 334, 335, 336, 337, 338, 340, 341, 342, 343, 344, 346, 347, 348, 349, 350, 351, 352, 353, 354, 355, 356, 359, 360, 361, 362, 363, 364, 365, 366, 367, 368, 369, 370, 371, 372, 373, 374, 376, 377, 378, 380, 381, 382, 383, 384, 385, 386, 388, 389, 390, 391, 392, 393, 394, 395, 396, 397, 398, 399, 400, 401, 402, 403, 404, 406, 407, 408, 409, 410, 411, 412, 413, 414, 415, 416, 418, 419, 420, 421, 423, 424, 425, 426, 427, 428, 429, 430, 431, 432, 433, 434, 435, 436, 437, 438, 439, 440, 441, 444, 445, 446, 447, 448, 450, 451, 452, 453, 454, 455, 457, 458, 460, 461, 462, 463, 464, 465, 467, 468, 469, 470, 471, 472, 473, 474, 475, 476, 477, 478, 481, 483, 484, 485, 486, 487, 488, 489, 490, 491, 492, 493, 494, 495, 496, 497, 498, 499, 500, 501, 503, 504, 505, 506, 507, 508, 510, 511, 512, 515, 516, 517, 518, 519, 520, 521, 522, 523, 524, 525, 526, 528, 529, 530, 532, 533, 534, 535, 536, 538, 539, 540, 541, 542, 543, 545, 546, 547, 548, 549, 550, 551, 552, 553, 554, 555, 556, 557, 558, 559, 560, 561, 562, 563, 564, 565, 566, 567, 568, 569, 570, 571, 572, 573, 574, 575, 576, 578, 579, 580, 581, 582, 584, 585, 586, 587, 589, 590, 591, 592, 593, 594, 595, 596, 597, 598, 600, 601, 602, 603, 604, 605, 606, 607, 608, 609, 610, 611, 612, 613, 614, 615, 616, 617, 618, 619, 620, 621, 622, 623, 624, 626, 627, 628, 629, 630, 631, 632, 633, 634, 635, 636, 637, 639, 640, 641, 643, 644, 645, 646, 648, 649, 650, 651, 652, 653, 654, 655, 656, 657, 659, 660, 661, 662, 663, 664, 665, 666, 667, 668, 670, 672, 673, 674, 675, 676, 677, 678, 679, 680, 681, 683, 684, 685, 686, 688, 689, 690, 691, 692, 693, 695, 696, 697, 698, 699, 700, 701, 702, 703, 704, 705, 706, 707, 708, 709, 710, 711, 712, 713, 714, 716, 717, 718, 719, 721, 722, 724, 725, 726, 728, 729, 730, 731, 732, 733, 734, 736, 738, 739, 742, 743, 744, 745, 746, 747, 748, 750, 751, 752, 754, 755, 756, 757, 758, 759, 760, 764, 766, 767, 768, 770, 772, 773, 774, 775, 776, 777, 778, 779, 780, 781, 782, 783, 784, 785, 786, 787, 788, 789, 790, 791, 793, 794, 796, 797, 798, 799, 800, 801, 802, 803, 804, 805, 806, 807, 808, 809, 810, 811, 812, 814, 815, 816, 817, 818, 819, 820, 821, 822, 823, 824, 825, 826, 828, 829, 830, 831, 832, 833, 834, 835, 836, 838, 839, 840, 841, 843, 844, 845, 846, 847, 848, 849, 850, 851, 852, 853, 855, 856, 857, 858, 859, 860, 861, 862, 863, 864, 865, 866, 867, 868, 869, 870, 871, 872, 873, 874, 875, 876, 877, 878, 879, 884, 887, 889]
[14, 20, 55, 65, 68, 70, 86, 87, 94, 98, 101, 110, 115, 117, 125, 129, 134, 149, 153, 158, 169, 212, 222, 231, 243, 244, 246, 248, 252, 256, 262, 277, 281, 293, 306, 310, 324, 333, 334, 336, 344, 348, 352, 360, 363, 365, 378, 380, 396, 407, 411, 412, 421, 437, 449, 452, 453, 458, 460, 476, 480, 485, 490, 499, 501, 505, 523, 526, 535, 541, 552, 556, 559, 564, 572, 577, 584, 591, 599, 602, 619, 622, 625, 629, 631, 636, 640, 659, 661, 668, 672, 674, 688, 698, 704, 718, 729, 731, 735, 736, 745, 751, 754, 767, 771, 783, 791, 803, 812, 814, 822, 834, 835, 836, 845, 850, 851, 855, 858, 876, 880, 883]

