[46, 52, 69, 146, 288, 304, 384, 422, 446, 485, 511, 512, 517, 683, 690, 700, 737, 755, 796, 799, 803, 824]
[94, 102, 111, 163, 183, 188, 194, 209, 215, 330, 386, 387, 451, 518, 531, 540, 568, 581, 599, 602, 632, 637, 658, 670, 691, 795, 863, 871, 878, 883]

[46, 52, 69, 146, 288, 304, 384, 422, 446, 485, 511, 512, 517, 683, 690, 700, 737, 755, 796, 799, 803, 824]
[6, 9, 15, 18, 23, 29, 31, 57, 87, 94, 98, 100, 102, 109, 111, 114, 117, 126, 136, 138, 140, 141, 157, 158, 163, 168, 173, 182, 183, 188, 189, 192, 193, 194, 209, 215, 217, 230, 233, 274, 281, 300, 314, 319, 320, 330, 332, 349, 352, 354, 367, 382, 386, 387, 388, 407, 410, 426, 430, 439, 442, 451, 457, 458, 468, 480, 481, 491, 513, 518, 523, 528, 530, 531, 532, 540, 547, 562, 568, 580, 581, 585, 591, 592, 599, 602, 613, 622, 629, 632, 633, 637, 640, 646, 647, 651, 657, 658, 661, 662, 670, 684, 686, 691, 696, 711, 721, 741, 744, 751, 752, 757, 758, 771, 772, 790, 792, 795, 801, 810, 846, 851, 856, 860, 863, 870, 871, 878, 883, 887]

[8, 12, 29, 35, 37, 46, 52, 67, 69, 78, 84, 86, 129, 146, 171, 200, 201, 231, 235, 246, 250, 260, 262, 270, 279, 283, 288, 304, 305, 307, 318, 330, 342, 348, 351, 370, 380, 384, 400, 422, 431, 436, 437, 443, 446, 447, 460, 462, 469, 472, 475, 485, 500, 505, 511, 512, 515, 517, 522, 523, 535, 546, 558, 577, 590, 595, 601, 602, 630, 631, 640, 646, 657, 663, 683, 687, 690, 694, 700, 721, 732, 737, 738, 747, 755, 756, 765, 782, 783, 796, 799, 803, 815, 824, 829, 874, 880]
[6, 9, 15, 18, 23, 29, 31, 57, 87, 94, 98, 100, 102, 109, 111, 114, 117, 126, 136, 138, 140, 141, 157, 158, 163, 168, 173, 182, 183, 188, 189, 192, 193, 194, 209, 215, 217, 230, 233, 274, 281, 300, 314, 319, 320, 330, 332, 349, 352, 354, 367, 382, 386, 387, 388, 407, 410, 426, 430, 439, 442, 451, 457, 458, 468, 480, 481, 491, 513, 518, 523, 528, 530, 531, 532, 540, 547, 562, 568, 580, 581, 585, 591, 592, 599, 602, 613, 622, 629, 632, 633, 637, 640, 646, 647, 651, 657, 658, 661, 662, 670, 684, 686, 691, 696, 711, 721, 741, 744, 751, 752, 757, 758, 771, 772, 790, 792, 795, 801, 810, 846, 851, 856, 860, 863, 870, 871, 878, 883, 887]

[8, 12, 29, 35, 37, 39, 46, 52, 56, 57, 62, 67, 69, 78, 80, 84, 86, 91, 93, 94, 95, 118, 129, 130, 131, 146, 154, 156, 160, 171, 178, 181, 188, 190, 200, 201, 208, 229, 231, 234, 235, 236, 241, 242, 244, 246, 250, 260, 262, 270, 278, 279, 283, 284, 288, 304, 305, 307, 312, 313, 318, 330, 333, 342, 348, 351, 368, 370, 380, 384, 400, 406, 414, 422, 426, 431, 436, 437, 443, 446, 447, 449, 460, 462, 469, 472, 475, 485, 500, 505, 510, 511, 512, 515, 517, 522, 523, 528, 530, 535, 542, 546, 558, 564, 568, 577, 580, 590, 595, 601, 602, 611, 630, 631, 632, 633, 640, 641, 642, 646, 657, 663, 682, 683, 687, 690, 692, 693, 694, 700, 706, 710, 712, 713, 721, 723, 727, 732, 735, 737, 738, 747, 755, 756, 763, 765, 775, 782, 783, 786, 792, 796, 797, 799, 802, 803, 814, 815, 824, 825, 828, 829, 842, 852, 856, 864, 866, 872, 874, 880, 881, 888]
[6, 9, 15, 18, 23, 29, 31, 57, 87, 94, 98, 100, 102, 109, 111, 114, 117, 126, 136, 138, 140, 141, 157, 158, 163, 168, 173, 182, 183, 188, 189, 192, 193, 194, 209, 215, 217, 230, 233, 274, 281, 300, 314, 319, 320, 330, 332, 349, 352, 354, 367, 382, 386, 387, 388, 407, 410, 426, 430, 439, 442, 451, 457, 458, 468, 480, 481, 491, 513, 518, 523, 528, 530, 531, 532, 540, 547, 562, 568, 580, 581, 585, 591, 592, 599, 602, 613, 622, 629, 632, 633, 637, 640, 646, 647, 651, 657, 658, 661, 662, 670, 684, 686, 691, 696, 711, 721, 741, 744, 751, 752, 757, 758, 771, 772, 790, 792, 795, 801, 810, 846, 851, 856, 860, 863, 870, 871, 878, 883, 887]

[0, 8, 12, 16, 29, 31, 35, 37, 39, 46, 52, 56, 57, 62, 67, 69, 72, 77, 78, 80, 82, 84, 86, 91, 93, 94, 95, 103, 108, 118, 129, 130, 131, 132, 146, 154, 156, 158, 160, 166, 171, 176, 178, 181, 186, 188, 190, 193, 200, 201, 208, 229, 231, 234, 235, 236, 241, 242, 244, 246, 250, 253, 260, 262, 270, 278, 279, 283, 284, 285, 288, 291, 300, 304, 305, 307, 312, 313, 314, 316, 318, 330, 331, 333, 342, 348, 351, 352, 368, 369, 370, 372, 373, 376, 380, 384, 386, 388, 394, 397, 400, 406, 413, 414, 415, 422, 423, 426, 431, 436, 437, 440, 443, 446, 447, 449, 460, 461, 462, 469, 472, 475, 485, 486, 500, 505, 510, 511, 512, 515, 517, 522, 523, 528, 529, 530, 532, 534, 535, 540, 542, 543, 545, 546, 551, 558, 564, 565, 568, 577, 580, 582, 586, 590, 591, 595, 601, 602, 611, 618, 623, 630, 631, 632, 633, 640, 641, 642, 646, 651, 654, 657, 660, 663, 665, 666, 673, 682, 683, 687, 690, 692, 693, 694, 700, 704, 706, 710, 712, 713, 718, 721, 723, 727, 728, 732, 735, 737, 738, 744, 747, 755, 756, 763, 765, 768, 769, 772, 775, 782, 783, 784, 786, 789, 792, 796, 797, 799, 802, 803, 814, 815, 818, 820, 821, 822, 824, 825, 828, 829, 842, 849, 850, 852, 856, 857, 863, 864, 866, 872, 874, 877, 880, 881, 885, 888, 889]
[6, 9, 15, 18, 23, 29, 31, 57, 87, 94, 98, 100, 102, 109, 111, 114, 117, 126, 136, 138, 140, 141, 157, 158, 163, 168, 173, 182, 183, 188, 189, 192, 193, 194, 209, 215, 217, 230, 233, 274, 281, 300, 314, 319, 320, 330, 332, 349, 352, 354, 367, 382, 386, 387, 388, 407, 410, 426, 430, 439, 442, 451, 457, 458, 468, 480, 481, 491, 513, 518, 523, 528, 530, 531, 532, 540, 547, 562, 568, 580, 581, 585, 591, 592, 599, 602, 613, 622, 629, 632, 633, 637, 640, 646, 647, 651, 657, 658, 661, 662, 670, 684, 686, 691, 696, 711, 721, 741, 744, 751, 752, 757, 758, 771, 772, 790, 792, 795, 801, 810, 846, 851, 856, 860, 863, 870, 871, 878, 883, 887]

[0, 6, 8, 12, 14, 15, 16, 22, 24, 29, 31, 35, 37, 39, 46, 48, 52, 56, 57, 62, 67, 69, 72, 76, 77, 78, 80, 82, 84, 86, 91, 93, 94, 95, 103, 108, 118, 123, 126, 129, 130, 131, 132, 138, 146, 151, 154, 156, 158, 160, 166, 171, 176, 178, 181, 186, 188, 190, 193, 200, 201, 208, 209, 217, 229, 231, 234, 235, 236, 241, 242, 244, 246, 250, 253, 256, 260, 262, 264, 266, 270, 274, 275, 277, 278, 279, 281, 282, 283, 284, 285, 287, 288, 291, 296, 300, 301, 304, 305, 307, 310, 311, 312, 313, 314, 316, 317, 318, 324, 327, 330, 331, 333, 340, 342, 348, 351, 352, 353, 358, 362, 368, 369, 370, 372, 373, 376, 380, 384, 386, 388, 389, 392, 394, 397, 400, 404, 406, 407, 413, 414, 415, 417, 419, 422, 423, 426, 431, 436, 437, 440, 443, 446, 447, 449, 460, 461, 462, 464, 469, 470, 472, 475, 480, 485, 486, 491, 496, 500, 505, 509, 510, 511, 512, 515, 517, 522, 523, 528, 529, 530, 532, 534, 535, 540, 541, 542, 543, 544, 545, 546, 551, 555, 558, 564, 565, 568, 574, 577, 580, 582, 586, 590, 591, 595, 596, 597, 600, 601, 602, 611, 613, 615, 616, 618, 623, 626, 630, 631, 632, 633, 640, 641, 642, 643, 646, 651, 654, 657, 660, 663, 664, 665, 666, 673, 681, 682, 683, 687, 690, 691, 692, 693, 694, 696, 700, 704, 706, 710, 711, 712, 713, 718, 721, 723, 727, 728, 732, 734, 735, 737, 738, 739, 743, 744, 747, 755, 756, 762, 763, 765, 768, 769, 772, 775, 779, 782, 783, 784, 786, 789, 792, 796, 797, 799, 800, 802, 803, 809, 814, 815, 817, 818, 819, 820, 821, 822, 824, 825, 827, 828, 829, 835, 842, 849, 850, 852, 856, 857, 863, 864, 866, 872, 874, 877, 880, 881, 882, 883, 885, 888, 889]
[6, 9, 15, 18, 23, 29, 31, 57, 87, 94, 98, 100, 102, 109, 111, 114, 117, 126, 136, 138, 140, 141, 157, 158, 163, 168, 173, 182, 183, 188, 189, 192, 193, 194, 209, 215, 217, 230, 233, 274, 281, 300, 314, 319, 320, 330, 332, 349, 352, 354, 367, 382, 386, 387, 388, 407, 410, 426, 430, 439, 442, 451, 457, 458, 468, 480, 481, 491, 513, 518, 523, 528, 530, 531, 532, 540, 547, 562, 568, 580, 581, 585, 591, 592, 599, 602, 613, 622, 629, 632, 633, 637, 640, 646, 647, 651, 657, 658, 661, 662, 670, 684, 686, 691, 696, 711, 721, 741, 744, 751, 752, 757, 758, 771, 772, 790, 792, 795, 801, 810, 846, 851, 856, 860, 863, 870, 871, 878, 883, 887]

[0, 1, 6, 7, 8, 12, 14, 15, 16, 22, 24, 29, 31, 35, 36, 37, 39, 46, 48, 52, 56, 57, 62, 67, 69, 72, 76, 77, 78, 80, 82, 84, 85, 86, 88, 91, 93, 94, 95, 103, 108, 111, 116, 118, 123, 126, 129, 130, 131, 132, 134, 137, 138, 146, 147, 151, 153, 154, 156, 158, 160, 166, 167, 171, 173, 175, 176, 178, 181, 183, 186, 188, 190, 193, 200, 201, 202, 208, 209, 214, 217, 229, 231, 234, 235, 236, 241, 242, 244, 245, 246, 250, 253, 256, 260, 261, 262, 264, 265, 266, 268, 270, 273, 274, 275, 276, 277, 278, 279, 281, 282, 283, 284, 285, 287, 288, 291, 296, 300, 301, 304, 305, 307, 310, 311, 312, 313, 314, 316, 317, 318, 324, 325, 327, 330, 331, 333, 336, 339, 340, 342, 344, 347, 348, 351, 352, 353, 358, 362, 363, 364, 368, 369, 370, 371, 372, 373, 374, 376, 380, 384, 386, 388, 389, 392, 394, 397, 399, 400, 404, 406, 407, 413, 414, 415, 417, 419, 422, 423, 426, 431, 436, 437, 440, 443, 446, 447, 449, 454, 455, 458, 459, 460, 461, 462, 464, 469, 470, 472, 475, 480, 485, 486, 491, 496, 499, 500, 501, 502, 504, 505, 509, 510, 511, 512, 515, 517, 518, 522, 523, 528, 529, 530, 532, 533, 534, 535, 540, 541, 542, 543, 544, 545, 546, 551, 554, 555, 557, 558, 560, 564, 565, 566, 568, 574, 577, 580, 582, 585, 586, 590, 591, 593, 595, 596, 597, 600, 601, 602, 603, 611, 613, 615, 616, 618, 623, 626, 630, 631, 632, 633, 634, 640, 641, 642, 643, 646, 649, 651, 652, 654, 657, 660, 663, 664, 665, 666, 668, 673, 678, 681, 682, 683, 685, 686, 687, 690, 691, 692, 693, 694, 696, 699, 700, 702, 704, 706, 709, 710, 711, 712, 713, 718, 721, 723, 727, 728, 732, 733, 734, 735, 737, 738, 739, 743, 744, 747, 755, 756, 758, 762, 763, 765, 767, 768, 769, 772, 775, 776, 778, 779, 780, 782, 783, 784, 786, 789, 790, 791, 792, 794, 796, 797, 799, 800, 802, 803, 808, 809, 813, 814, 815, 817, 818, 819, 820, 821, 822, 824, 825, 827, 828, 829, 835, 836, 837, 842, 849, 850, 852, 856, 857, 863, 864, 866, 872, 873, 874, 876, 877, 880, 881, 882, 883, 885, 888, 889]
[6, 9, 15, 18, 23, 29, 31, 57, 87, 94, 98, 100, 102, 109, 111, 114, 117, 126, 136, 138, 140, 141, 157, 158, 163, 168, 173, 182, 183, 188, 189, 192, 193, 194, 209, 215, 217, 230, 233, 274, 281, 300, 314, 319, 320, 330, 332, 349, 352, 354, 367, 382, 386, 387, 388, 407, 410, 426, 430, 439, 442, 451, 457, 458, 468, 480, 481, 491, 513, 518, 523, 528, 530, 531, 532, 540, 547, 562, 568, 580, 581, 585, 591, 592, 599, 602, 613, 622, 629, 632, 633, 637, 640, 646, 647, 651, 657, 658, 661, 662, 670, 684, 686, 691, 696, 711, 721, 741, 744, 751, 752, 757, 758, 771, 772, 790, 792, 795, 801, 810, 846, 851, 856, 860, 863, 870, 871, 878, 883, 887]

[0, 1, 5, 6, 7, 8, 12, 14, 15, 16, 17, 22, 24, 29, 30, 31, 32, 35, 36, 37, 39, 41, 46, 48, 50, 52, 56, 57, 60, 62, 65, 66, 67, 69, 72, 76, 77, 78, 80, 82, 84, 85, 86, 88, 91, 93, 94, 95, 96, 97, 101, 103, 108, 111, 116, 118, 119, 120, 123, 126, 127, 129, 130, 131, 132, 133, 134, 137, 138, 146, 147, 151, 153, 154, 156, 158, 160, 162, 166, 167, 168, 171, 173, 175, 176, 178, 181, 182, 183, 186, 188, 190, 193, 196, 197, 198, 200, 201, 202, 203, 206, 207, 208, 209, 214, 217, 229, 231, 234, 235, 236, 241, 242, 244, 245, 246, 247, 248, 250, 252, 253, 256, 257, 258, 260, 261, 262, 264, 265, 266, 267, 268, 270, 273, 274, 275, 276, 277, 278, 279, 281, 282, 283, 284, 285, 286, 287, 288, 291, 296, 298, 300, 301, 302, 304, 305, 307, 310, 311, 312, 313, 314, 316, 317, 318, 320, 322, 324, 325, 327, 328, 330, 331, 332, 333, 336, 339, 340, 342, 344, 347, 348, 349, 351, 352, 353, 356, 357, 358, 362, 363, 364, 368, 369, 370, 371, 372, 373, 374, 376, 379, 380, 384, 386, 388, 389, 392, 394, 397, 399, 400, 404, 406, 407, 413, 414, 415, 416, 417, 418, 419, 422, 423, 424, 426, 431, 436, 437, 438, 440, 443, 445, 446, 447, 449, 454, 455, 458, 459, 460, 461, 462, 464, 467, 469, 470, 472, 475, 480, 485, 486, 491, 496, 499, 500, 501, 502, 504, 505, 509, 510, 511, 512, 514, 515, 517, 518, 522, 523, 528, 529, 530, 531, 532, 533, 534, 535, 540, 541, 542, 543, 544, 545, 546, 551, 553, 554, 555, 557, 558, 560, 564, 565, 566, 567, 568, 574, 577, 580, 582, 585, 586, 588, 590, 591, 593, 595, 596, 597, 600, 601, 602, 603, 611, 613, 614, 615, 616, 617, 618, 620, 623, 625, 626, 630, 631, 632, 633, 634, 635, 640, 641, 642, 643, 646, 649, 650, 651, 652, 653, 654, 656, 657, 660, 661, 663, 664, 665, 666, 667, 668, 673, 677, 678, 681, 682, 683, 685, 686, 687, 690, 691, 692, 693, 694, 696, 699, 700, 702, 704, 706, 709, 710, 711, 712, 713, 718, 721, 723, 727, 728, 732, 733, 734, 735, 737, 738, 739, 743, 744, 747, 749, 755, 756, 758, 760, 762, 763, 765, 766, 767, 768, 769, 772, 775, 776, 778, 779, 780, 782, 783, 784, 785, 786, 787, 789, 790, 791, 792, 794, 796, 797, 799, 800, 802, 803, 807, 808, 809, 813, 814, 815, 817, 818, 819, 820, 821, 822, 824, 825, 827, 828, 829, 835, 836, 837, 841, 842, 845, 849, 850, 852, 856, 857, 862, 863, 864, 866, 868, 869, 872, 873, 874, 876, 877, 880, 881, 882, 883, 885, 888, 889]
[6, 9, 15, 18, 23, 29, 31, 57, 87, 94, 98, 100, 102, 109, 111, 114, 117, 126, 136, 138, 140, 141, 157, 158, 163, 168, 173, 182, 183, 188, 189, 192, 193, 194, 209, 215, 217, 230, 233, 274, 281, 300, 314, 319, 320, 330, 332, 349, 352, 354, 367, 382, 386, 387, 388, 407, 410, 426, 430, 439, 442, 451, 457, 458, 468, 480, 481, 491, 513, 518, 523, 528, 530, 531, 532, 540, 547, 562, 568, 580, 581, 585, 591, 592, 599, 602, 613, 622, 629, 632, 633, 637, 640, 646, 647, 651, 657, 658, 661, 662, 670, 684, 686, 691, 696, 711, 721, 741, 744, 751, 752, 757, 758, 771, 772, 790, 792, 795, 801, 810, 846, 851, 856, 860, 863, 870, 871, 878, 883, 887]

[0, 1, 2, 5, 6, 7, 8, 12, 14, 15, 16, 17, 18, 21, 22, 24, 25, 27, 29, 30, 31, 32, 35, 36, 37, 39, 41, 46, 48, 50, 52, 53, 54, 56, 57, 59, 60, 62, 65, 66, 67, 69, 70, 71, 72, 75, 76, 77, 78, 80, 82, 84, 85, 86, 88, 89, 91, 93, 94, 95, 96, 97, 98, 101, 103, 108, 111, 114, 116, 117, 118, 119, 120, 123, 125, 126, 127, 129, 130, 131, 132, 133, 134, 137, 138, 141, 143, 146, 147, 151, 152, 153, 154, 156, 158, 160, 162, 166, 167, 168, 171, 172, 173, 175, 176, 178, 179, 181, 182, 183, 186, 188, 190, 191, 193, 194, 196, 197, 198, 200, 201, 202, 203, 204, 206, 207, 208, 209, 212, 214, 216, 217, 220, 228, 229, 231, 232, 234, 235, 236, 240, 241, 242, 243, 244, 245, 246, 247, 248, 250, 252, 253, 256, 257, 258, 260, 261, 262, 263, 264, 265, 266, 267, 268, 270, 271, 273, 274, 275, 276, 277, 278, 279, 281, 282, 283, 284, 285, 286, 287, 288, 291, 294, 296, 298, 300, 301, 302, 304, 305, 307, 310, 311, 312, 313, 314, 316, 317, 318, 320, 322, 324, 325, 327, 328, 329, 330, 331, 332, 333, 334, 336, 337, 339, 340, 342, 344, 347, 348, 349, 351, 352, 353, 356, 357, 358, 361, 362, 363, 364, 367, 368, 369, 370, 371, 372, 373, 374, 375, 376, 378, 379, 380, 384, 385, 386, 387, 388, 389, 392, 394, 396, 397, 399, 400, 404, 406, 407, 412, 413, 414, 415, 416, 417, 418, 419, 422, 423, 424, 426, 429, 431, 436, 437, 438, 439, 440, 443, 445, 446, 447, 449, 452, 454, 455, 458, 459, 460, 461, 462, 464, 465, 467, 469, 470, 472, 475, 476, 479, 480, 482, 483, 485, 486, 490, 491, 496, 499, 500, 501, 502, 504, 505, 509, 510, 511, 512, 514, 515, 517, 518, 520, 522, 523, 528, 529, 530, 531, 532, 533, 534, 535, 540, 541, 542, 543, 544, 545, 546, 549, 550, 551, 553, 554, 555, 557, 558, 560, 561, 563, 564, 565, 566, 567, 568, 569, 574, 577, 580, 582, 585, 586, 588, 589, 590, 591, 593, 595, 596, 597, 600, 601, 602, 603, 606, 611, 613, 614, 615, 616, 617, 618, 619, 620, 623, 625, 626, 630, 631, 632, 633, 634, 635, 640, 641, 642, 643, 645, 646, 649, 650, 651, 652, 653, 654, 656, 657, 660, 661, 663, 664, 665, 666, 667, 668, 672, 673, 677, 678, 681, 682, 683, 684, 685, 686, 687, 690, 691, 692, 693, 694, 696, 699, 700, 701, 702, 704, 705, 706, 709, 710, 711, 712, 713, 718, 721, 723, 727, 728, 732, 733, 734, 735, 737, 738, 739, 742, 743, 744, 747, 749, 755, 756, 758, 760, 762, 763, 765, 766, 767, 768, 769, 772, 774, 775, 776, 778, 779, 780, 782, 783, 784, 785, 786, 787, 789, 790, 791, 792, 794, 796, 797, 799, 800, 802, 803, 807, 808, 809, 813, 814, 815, 817, 818, 819, 820, 821, 822, 823, 824, 825, 826, 827, 828, 829, 830, 832, 833, 835, 836, 837, 841, 842, 845, 849, 850, 852, 853, 854, 856, 857, 860, 862, 863, 864, 866, 868, 869, 872, 873, 874, 876, 877, 880, 881, 882, 883, 885, 887, 888, 889]
[6, 9, 15, 18, 23, 29, 31, 57, 87, 94, 98, 100, 102, 109, 111, 114, 117, 126, 136, 138, 140, 141, 157, 158, 163, 168, 173, 182, 183, 188, 189, 192, 193, 194, 209, 215, 217, 230, 233, 274, 281, 300, 314, 319, 320, 330, 332, 349, 352, 354, 367, 382, 386, 387, 388, 407, 410, 426, 430, 439, 442, 451, 457, 458, 468, 480, 481, 491, 513, 518, 523, 528, 530, 531, 532, 540, 547, 562, 568, 580, 581, 585, 591, 592, 599, 602, 613, 622, 629, 632, 633, 637, 640, 646, 647, 651, 657, 658, 661, 662, 670, 684, 686, 691, 696, 711, 721, 741, 744, 751, 752, 757, 758, 771, 772, 790, 792, 795, 801, 810, 846, 851, 856, 860, 863, 870, 871, 878, 883, 887]

[0, 1, 2, 5, 6, 7, 8, 9, 10, 12, 14, 15, 16, 17, 18, 21, 22, 23, 24, 25, 27, 29, 30, 31, 32, 34, 35, 36, 37, 39, 41, 45, 46, 48, 50, 52, 53, 54, 56, 57, 59, 60, 62, 65, 66, 67, 69, 70, 71, 72, 73, 75, 76, 77, 78, 80, 82, 84, 85, 86, 88, 89, 91, 92, 93, 94, 95, 96, 97, 98, 100, 101, 103, 108, 111, 114, 115, 116, 117, 118, 119, 120, 123, 125, 126, 127, 129, 130, 131, 132, 133, 134, 137, 138, 141, 143, 146, 147, 151, 152, 153, 154, 156, 158, 160, 162, 166, 167, 168, 170, 171, 172, 173, 175, 176, 178, 179, 181, 182, 183, 186, 187, 188, 190, 191, 192, 193, 194, 196, 197, 198, 200, 201, 202, 203, 204, 206, 207, 208, 209, 212, 214, 215, 216, 217, 219, 220, 221, 222, 228, 229, 231, 232, 234, 235, 236, 238, 240, 241, 242, 243, 244, 245, 246, 247, 248, 249, 250, 252, 253, 256, 257, 258, 259, 260, 261, 262, 263, 264, 265, 266, 267, 268, 270, 271, 272, 273, 274, 275, 276, 277, 278, 279, 281, 282, 283, 284, 285, 286, 287, 288, 291, 293, 294, 296, 298, 300, 301, 302, 303, 304, 305, 306, 307, 310, 311, 312, 313, 314, 316, 317, 318, 320, 322, 324, 325, 327, 328, 329, 330, 331, 332, 333, 334, 336, 337, 338, 339, 340, 342, 344, 347, 348, 349, 351, 352, 353, 356, 357, 358, 360, 361, 362, 363, 364, 366, 367, 368, 369, 370, 371, 372, 373, 374, 375, 376, 377, 378, 379, 380, 383, 384, 385, 386, 387, 388, 389, 392, 394, 396, 397, 398, 399, 400, 403, 404, 406, 407, 410, 411, 412, 413, 414, 415, 416, 417, 418, 419, 422, 423, 424, 426, 429, 430, 431, 436, 437, 438, 439, 440, 443, 445, 446, 447, 449, 452, 454, 455, 456, 458, 459, 460, 461, 462, 464, 465, 467, 469, 470, 472, 473, 475, 476, 479, 480, 482, 483, 485, 486, 490, 491, 492, 496, 498, 499, 500, 501, 502, 504, 505, 506, 509, 510, 511, 512, 514, 515, 517, 518, 520, 521, 522, 523, 526, 528, 529, 530, 531, 532, 533, 534, 535, 537, 540, 541, 542, 543, 544, 545, 546, 549, 550, 551, 553, 554, 555, 557, 558, 560, 561, 562, 563, 564, 565, 566, 567, 568, 569, 573, 574, 575, 576, 577, 580, 582, 585, 586, 588, 589, 590, 591, 593, 595, 596, 597, 600, 601, 602, 603, 604, 606, 607, 608, 609, 611, 612, 613, 614, 615, 616, 617, 618, 619, 620, 622, 623, 625, 626, 627, 630, 631, 632, 633, 634, 635, 638, 640, 641, 642, 643, 644, 645, 646, 647, 649, 650, 651, 652, 653, 654, 655, 656, 657, 658, 660, 661, 663, 664, 665, 666, 667, 668, 672, 673, 677, 678, 680, 681, 682, 683, 684, 685, 686, 687, 690, 691, 692, 693, 694, 695, 696, 699, 700, 701, 702, 704, 705, 706, 709, 710, 711, 712, 713, 718, 721, 722, 723, 727, 728, 732, 733, 734, 735, 737, 738, 739, 742, 743, 744, 747, 749, 750, 751, 755, 756, 758, 759, 760, 762, 763, 764, 765, 766, 767, 768, 769, 770, 772, 774, 775, 776, 778, 779, 780, 781, 782, 783, 784, 785, 786, 787, 789, 790, 791, 792, 794, 795, 796, 797, 799, 800, 802, 803, 804, 806, 807, 808, 809, 813, 814, 815, 817, 818, 819, 820, 821, 822, 823, 824, 825, 826, 827, 828, 829, 830, 831, 832, 833, 835, 836, 837, 838, 841, 842, 845, 849, 850, 852, 853, 854, 856, 857, 858, 860, 861, 862, 863, 864, 866, 868, 869, 871, 872, 873, 874, 876, 877, 880, 881, 882, 883, 884, 885, 887, 888, 889]
[6, 9, 15, 18, 23, 29, 31, 57, 87, 94, 98, 100, 102, 109, 111, 114, 117, 126, 136, 138, 140, 141, 157, 158, 163, 168, 173, 182, 183, 188, 189, 192, 193, 194, 209, 215, 217, 230, 233, 274, 281, 300, 314, 319, 320, 330, 332, 349, 352, 354, 367, 382, 386, 387, 388, 407, 410, 426, 430, 439, 442, 451, 457, 458, 468, 480, 481, 491, 513, 518, 523, 528, 530, 531, 532, 540, 547, 562, 568, 580, 581, 585, 591, 592, 599, 602, 613, 622, 629, 632, 633, 637, 640, 646, 647, 651, 657, 658, 661, 662, 670, 684, 686, 691, 696, 711, 721, 741, 744, 751, 752, 757, 758, 771, 772, 790, 792, 795, 801, 810, 846, 851, 856, 860, 863, 870, 871, 878, 883, 887]

[0, 1, 2, 3, 5, 6, 7, 8, 9, 10, 12, 13, 14, 15, 16, 17, 18, 20, 21, 22, 23, 24, 25, 27, 29, 30, 31, 32, 34, 35, 36, 37, 39, 41, 45, 46, 48, 50, 52, 53, 54, 55, 56, 57, 59, 60, 61, 62, 63, 65, 66, 67, 69, 70, 71, 72, 73, 75, 76, 77, 78, 80, 82, 84, 85, 86, 87, 88, 89, 90, 91, 92, 93, 94, 95, 96, 97, 98, 100, 101, 103, 108, 109, 110, 111, 112, 113, 114, 115, 116, 117, 118, 119, 120, 122, 123, 125, 126, 127, 129, 130, 131, 132, 133, 134, 137, 138, 141, 143, 144, 146, 147, 151, 152, 153, 154, 156, 158, 160, 162, 166, 167, 168, 169, 170, 171, 172, 173, 174, 175, 176, 178, 179, 181, 182, 183, 185, 186, 187, 188, 190, 191, 192, 193, 194, 196, 197, 198, 199, 200, 201, 202, 203, 204, 206, 207, 208, 209, 211, 212, 213, 214, 215, 216, 217, 219, 220, 221, 222, 225, 226, 228, 229, 231, 232, 234, 235, 236, 237, 238, 240, 241, 242, 243, 244, 245, 246, 247, 248, 249, 250, 252, 253, 256, 257, 258, 259, 260, 261, 262, 263, 264, 265, 266, 267, 268, 269, 270, 271, 272, 273, 274, 275, 276, 277, 278, 279, 281, 282, 283, 284, 285, 286, 287, 288, 289, 291, 293, 294, 296, 297, 298, 299, 300, 301, 302, 303, 304, 305, 306, 307, 310, 311, 312, 313, 314, 316, 317, 318, 319, 320, 322, 323, 324, 325, 327, 328, 329, 330, 331, 332, 333, 334, 336, 337, 338, 339, 340, 342, 344, 345, 346, 347, 348, 349, 350, 351, 352, 353, 356, 357, 358, 360, 361, 362, 363, 364, 366, 367, 368, 369, 370, 371, 372, 373, 374, 375, 376, 377, 378, 379, 380, 383, 384, 385, 386, 387, 388, 389, 390, 391, 392, 394, 396, 397, 398, 399, 400, 403, 404, 406, 407, 409, 410, 411, 412, 413, 414, 415, 416, 417, 418, 419, 422, 423, 424, 426, 427, 429, 430, 431, 436, 437, 438, 439, 440, 441, 443, 445, 446, 447, 449, 452, 454, 455, 456, 457, 458, 459, 460, 461, 462, 464, 465, 466, 467, 468, 469, 470, 472, 473, 475, 476, 479, 480, 482, 483, 485, 486, 488, 490, 491, 492, 493, 496, 498, 499, 500, 501, 502, 504, 505, 506, 509, 510, 511, 512, 513, 514, 515, 517, 518, 520, 521, 522, 523, 526, 528, 529, 530, 531, 532, 533, 534, 535, 537, 538, 540, 541, 542, 543, 544, 545, 546, 549, 550, 551, 553, 554, 555, 556, 557, 558, 559, 560, 561, 562, 563, 564, 565, 566, 567, 568, 569, 573, 574, 575, 576, 577, 579, 580, 582, 583, 584, 585, 586, 588, 589, 590, 591, 593, 595, 596, 597, 600, 601, 602, 603, 604, 605, 606, 607, 608, 609, 611, 612, 613, 614, 615, 616, 617, 618, 619, 620, 622, 623, 625, 626, 627, 630, 631, 632, 633, 634, 635, 637, 638, 640, 641, 642, 643, 644, 645, 646, 647, 648, 649, 650, 651, 652, 653, 654, 655, 656, 657, 658, 659, 660, 661, 662, 663, 664, 665, 666, 667, 668, 669, 670, 672, 673, 677, 678, 680, 681, 682, 683, 684, 685, 686, 687, 689, 690, 691, 692, 693, 694, 695, 696, 697, 699, 700, 701, 702, 704, 705, 706, 707, 708, 709, 710, 711, 712, 713, 716, 718, 721, 722, 723, 726, 727, 728, 732, 733, 734, 735, 737, 738, 739, 741, 742, 743, 744, 747, 748, 749, 750, 751, 753, 755, 756, 757, 758, 759, 760, 762, 763, 764, 765, 766, 767, 768, 769, 770, 772, 774, 775, 776, 778, 779, 780, 781, 782, 783, 784, 785, 786, 787, 788, 789, 790, 791, 792, 793, 794, 795, 796, 797, 798, 799, 800, 801, 802, 803, 804, 806, 807, 808, 809, 812, 813, 814, 815, 817, 818, 819, 820, 821, 822, 823, 824, 825, 826, 827, 828, 829, 830, 831, 832, 833, 834, 835, 836, 837, 838, 841, 842, 843, 845, 847, 848, 849, 850, 852, 853, 854, 856, 857, 858, 860, 861, 862, 863, 864, 866, 868, 869, 871, 872, 873, 874, 876, 877, 880, 881, 882, 883, 884, 885, 887, 888, 889]
[6, 9, 15, 18, 23, 29, 31, 57, 87, 94, 98, 100, 102, 109, 111, 114, 117, 126, 136, 138, 140, 141, 157, 158, 163, 168, 173, 182, 183, 188, 189, 192, 193, 194, 209, 215, 217, 230, 233, 274, 281, 300, 314, 319, 320, 330, 332, 349, 352, 354, 367, 382, 386, 387, 388, 407, 410, 426, 430, 439, 442, 451, 457, 458, 468, 480, 481, 491, 513, 518, 523, 528, 530, 531, 532, 540, 547, 562, 568, 580, 581, 585, 591, 592, 599, 602, 613, 622, 629, 632, 633, 637, 640, 646, 647, 651, 657, 658, 661, 662, 670, 684, 686, 691, 696, 711, 721, 741, 744, 751, 752, 757, 758, 771, 772, 790, 792, 795, 801, 810, 846, 851, 856, 860, 863, 870, 871, 878, 883, 887]

[0, 1, 2, 3, 4, 5, 6, 7, 8, 9, 10, 11, 12, 13, 14, 15, 16, 17, 18, 19, 20, 21, 22, 23, 24, 25, 27, 28, 29, 30, 31, 32, 34, 35, 36, 37, 39, 41, 42, 44, 45, 46, 48, 49, 50, 51, 52, 53, 54, 55, 56, 57, 58, 59, 60, 61, 62, 63, 64, 65, 66, 67, 68, 69, 70, 71, 72, 73, 74, 75, 76, 77, 78, 80, 81, 82, 83, 84, 85, 86, 87, 88, 89, 90, 91, 92, 93, 94, 95, 96, 97, 98, 99, 100, 101, 103, 104, 107, 108, 109, 110, 111, 112, 113, 114, 115, 116, 117, 118, 119, 120, 122, 123, 124, 125, 126, 127, 129, 130, 131, 132, 133, 134, 136, 137, 138, 139, 141, 142, 143, 144, 145, 146, 147, 148, 151, 152, 153, 154, 155, 156, 157, 158, 159, 160, 162, 164, 165, 166, 167, 168, 169, 170, 171, 172, 173, 174, 175, 176, 177, 178, 179, 181, 182, 183, 185, 186, 187, 188, 190, 191, 192, 193, 194, 196, 197, 198, 199, 200, 201, 202, 203, 204, 205, 206, 207, 208, 209, 210, 211, 212, 213, 214, 215, 216, 217, 219, 220, 221, 222, 223, 224, 225, 226, 228, 229, 230, 231, 232, 234, 235, 236, 237, 238, 240, 241, 242, 243, 244, 245, 246, 247, 248, 249, 250, 252, 253, 256, 257, 258, 259, 260, 261, 262, 263, 264, 265, 266, 267, 268, 269, 270, 271, 272, 273, 274, 275, 276, 277, 278, 279, 281, 282, 283, 284, 285, 286, 287, 288, 289, 290, 291, 292, 293, 294, 296, 297, 298, 299, 300, 301, 302, 303, 304, 305, 306, 307, 308, 310, 311, 312, 313, 314, 316, 317, 318, 319, 320, 322, 323, 324, 325, 326, 327, 328, 329, 330, 331, 332, 333, 334, 336, 337, 338, 339, 340, 342, 343, 344, 345, 346, 347, 348, 349, 350, 351, 352, 353, 354, 356, 357, 358, 360, 361, 362, 363, 364, 366, 367, 368, 369, 370, 371, 372, 373, 374, 375, 376, 377, 378, 379, 380, 382, 383, 384, 385, 386, 387, 388, 389, 390, 391, 392, 394, 395, 396, 397, 398, 399, 400, 403, 404, 406, 407, 408, 409, 410, 411, 412, 413, 414, 415, 416, 417, 418, 419, 420, 422, 423, 424, 425, 426, 427, 428, 429, 430, 431, 433, 436, 437, 438, 439, 440, 441, 443, 445, 446, 447, 448, 449, 450, 452, 454, 455, 456, 457, 458, 459, 460, 461, 462, 464, 465, 466, 467, 468, 469, 470, 472, 473, 475, 476, 477, 479, 480, 482, 483, 485, 486, 487, 488, 490, 491, 492, 493, 495, 496, 497, 498, 499, 500, 501, 502, 504, 505, 506, 509, 510, 511, 512, 513, 514, 515, 517, 518, 519, 520, 521, 522, 523, 524, 526, 528, 529, 530, 531, 532, 533, 534, 535, 537, 538, 539, 540, 541, 542, 543, 544, 545, 546, 549, 550, 551, 553, 554, 555, 556, 557, 558, 559, 560, 561, 562, 563, 564, 565, 566, 567, 568, 569, 573, 574, 575, 576, 577, 579, 580, 581, 582, 583, 584, 585, 586, 587, 588, 589, 590, 591, 593, 594, 595, 596, 597, 598, 599, 600, 601, 602, 603, 604, 605, 606, 607, 608, 609, 610, 611, 612, 613, 614, 615, 616, 617, 618, 619, 620, 621, 622, 623, 625, 626, 627, 629, 630, 631, 632, 633, 634, 635, 636, 637, 638, 640, 641, 642, 643, 644, 645, 646, 647, 648, 649, 650, 651, 652, 653, 654, 655, 656, 657, 658, 659, 660, 661, 662, 663, 664, 665, 666, 667, 668, 669, 670, 672, 673, 675, 676, 677, 678, 680, 681, 682, 683, 684, 685, 686, 687, 689, 690, 691, 692, 693, 694, 695, 696, 697, 699, 700, 701, 702, 704, 705, 706, 707, 708, 709, 710, 711, 712, 713, 716, 717, 718, 720, 721, 722, 723, 726, 727, 728, 732, 733, 734, 735, 737, 738, 739, 741, 742, 743, 744, 745, 747, 748, 749, 750, 751, 753, 754, 755, 756, 757, 758, 759, 760, 762, 763, 764, 765, 766, 767, 768, 769, 770, 771, 772, 773, 774, 775, 776, 777, 778, 779, 780, 781, 782, 783, 784, 785, 786, 787, 788, 789, 790, 791, 792, 793, 794, 795, 796, 797, 798, 799, 800, 801, 802, 803, 804, 806, 807, 808, 809, 812, 813, 814, 815, 817, 818, 819, 820, 821, 822, 823, 824, 825, 826, 827, 828, 829, 830, 831, 832, 833, 834, 835, 836, 837, 838, 839, 841, 842, 843, 845, 846, 847, 848, 849, 850, 852, 853, 854, 856, 857, 858, 859, 860, 861, 862, 863, 864, 866, 868, 869, 871, 872, 873, 874, 876, 877, 879, 880, 881, 882, 883, 884, 885, 886, 887, 888, 889]
[6, 9, 15, 18, 23, 29, 31, 57, 87, 94, 98, 100, 102, 109, 111, 114, 117, 126, 136, 138, 140, 141, 157, 158, 163, 168, 173, 182, 183, 188, 189, 192, 193, 194, 209, 215, 217, 230, 233, 274, 281, 300, 314, 319, 320, 330, 332, 349, 352, 354, 367, 382, 386, 387, 388, 407, 410, 426, 430, 439, 442, 451, 457, 458, 468, 480, 481, 491, 513, 518, 523, 528, 530, 531, 532, 540, 547, 562, 568, 580, 581, 585, 591, 592, 599, 602, 613, 622, 629, 632, 633, 637, 640, 646, 647, 651, 657, 658, 661, 662, 670, 684, 686, 691, 696, 711, 721, 741, 744, 751, 752, 757, 758, 771, 772, 790, 792, 795, 801, 810, 846, 851, 856, 860, 863, 870, 871, 878, 883, 887]

