[26, 41, 46, 59, 95, 211, 307, 359, 397, 415, 468, 515, 545, 554, 582, 598, 672, 675, 773, 803, 841, 883]
[66, 92, 113, 116, 152, 172, 202, 229, 267, 321, 327, 384, 390, 391, 458, 492, 558, 685, 704, 706, 786, 827]

[26, 41, 46, 59, 95, 211, 307, 359, 397, 415, 468, 515, 545, 554, 582, 598, 672, 675, 773, 803, 841, 883]
[3, 16, 27, 32, 37, 47, 51, 56, 66, 73, 75, 77, 80, 92, 104, 105, 109, 113, 116, 118, 123, 152, 172, 183, 185, 188, 190, 202, 205, 209, 214, 227, 229, 238, 240, 246, 250, 258, 267, 269, 280, 285, 289, 301, 306, 316, 321, 327, 332, 347, 352, 373, 382, 384, 385, 388, 390, 391, 394, 403, 412, 424, 444, 455, 458, 463, 480, 485, 487, 489, 492, 511, 519, 524, 528, 540, 548, 558, 560, 564, 579, 580, 599, 606, 608, 624, 625, 626, 634, 645, 649, 655, 658, 678, 685, 688, 692, 704, 706, 714, 716, 726, 736, 740, 752, 766, 786, 791, 796, 799, 802, 807, 819, 823, 825, 826, 827, 832, 847, 852, 865, 867]

[25, 26, 41, 46, 47, 59, 63, 81, 93, 95, 102, 108, 115, 120, 141, 147, 151, 181, 190, 191, 194, 202, 211, 220, 235, 239, 246, 254, 255, 277, 285, 307, 312, 313, 335, 338, 348, 354, 359, 366, 377, 379, 397, 400, 415, 452, 468, 483, 493, 513, 515, 529, 544, 545, 554, 568, 570, 579, 582, 598, 614, 616, 618, 619, 626, 635, 643, 662, 672, 673, 675, 676, 685, 693, 698, 704, 721, 733, 756, 773, 776, 778, 787, 788, 793, 801, 803, 812, 822, 840, 841, 848, 863, 879, 883, 884, 887]
[3, 16, 27, 32, 37, 47, 51, 56, 66, 73, 75, 77, 80, 92, 104, 105, 109, 113, 116, 118, 123, 152, 172, 183, 185, 188, 190, 202, 205, 209, 214, 227, 229, 238, 240, 246, 250, 258, 267, 269, 280, 285, 289, 301, 306, 316, 321, 327, 332, 347, 352, 373, 382, 384, 385, 388, 390, 391, 394, 403, 412, 424, 444, 455, 458, 463, 480, 485, 487, 489, 492, 511, 519, 524, 528, 540, 548, 558, 560, 564, 579, 580, 599, 606, 608, 624, 625, 626, 634, 645, 649, 655, 658, 678, 685, 688, 692, 704, 706, 714, 716, 726, 736, 740, 752, 766, 786, 791, 796, 799, 802, 807, 819, 823, 825, 826, 827, 832, 847, 852, 865, 867]

[24, 25, 26, 41, 45, 46, 47, 55, 56, 59, 62, 63, 73, 81, 92, 93, 95, 99, 102, 107, 108, 112, 115, 120, 127, 132, 141, 147, 151, 164, 170, 181, 190, 191, 194, 202, 211, 218, 220, 235, 239, 246, 247, 250, 254, 255, 259, 261, 262, 277, 279, 282, 284, 285, 286, 289, 307, 308, 311, 312, 313, 314, 316, 318, 322, 335, 338, 348, 354, 359, 360, 366, 372, 377, 379, 397, 400, 402, 407, 409, 415, 428, 432, 452, 465, 468, 474, 483, 493, 508, 509, 513, 514, 515, 526, 528, 529, 544, 545, 554, 559, 568, 570, 573, 579, 582, 590, 598, 607, 611, 614, 616, 618, 619, 626, 635, 643, 650, 658, 662, 663, 672, 673, 675, 676, 685, 690, 693, 698, 701, 704, 708, 713, 714, 715, 721, 726, 730, 733, 743, 756, 767, 771, 773, 776, 778, 787, 788, 793, 797, 801, 803, 812, 814, 818, 822, 823, 833, 840, 841, 847, 848, 860, 863, 866, 870, 876, 879, 881, 883, 884, 887]
[3, 16, 27, 32, 37, 47, 51, 56, 66, 73, 75, 77, 80, 92, 104, 105, 109, 113, 116, 118, 123, 152, 172, 183, 185, 188, 190, 202, 205, 209, 214, 227, 229, 238, 240, 246, 250, 258, 267, 269, 280, 285, 289, 301, 306, 316, 321, 327, 332, 347, 352, 373, 382, 384, 385, 388, 390, 391, 394, 403, 412, 424, 444, 455, 458, 463, 480, 485, 487, 489, 492, 511, 519, 524, 528, 540, 548, 558, 560, 564, 579, 580, 599, 606, 608, 624, 625, 626, 634, 645, 649, 655, 658, 678, 685, 688, 692, 704, 706, 714, 716, 726, 736, 740, 752, 766, 786, 791, 796, 799, 802, 807, 819, 823, 825, 826, 827, 832, 847, 852, 865, 867]

[8, 15, 24, 25, 26, 41, 43, 45, 46, 47, 48, 52, 54, 55, 56, 59, 61, 62, 63, 65, 66, 73, 81, 92, 93, 95, 99, 102, 107, 108, 112, 115, 120, 127, 132, 133, 138, 141, 144, 145, 147, 151, 161, 163, 164, 169, 170, 176, 181, 190, 191, 193, 194, 202, 211, 218, 220, 231, 233, 235, 239, 243, 246, 247, 250, 254, 255, 258, 259, 261, 262, 277, 279, 282, 283, 284, 285, 286, 289, 305, 307, 308, 311, 312, 313, 314, 316, 318, 322, 335, 338, 339, 344, 345, 348, 354, 359, 360, 366, 372, 376, 377, 379, 381, 383, 385, 391, 397, 400, 402, 407, 408, 409, 415, 428, 430, 432, 443, 452, 459, 465, 468, 474, 483, 484, 488, 493, 500, 508, 509, 510, 513, 514, 515, 516, 526, 528, 529, 535, 538, 540, 543, 544, 545, 554, 555, 559, 565, 568, 570, 573, 579, 582, 588, 590, 593, 596, 598, 599, 607, 611, 614, 615, 616, 618, 619, 620, 626, 635, 643, 644, 650, 658, 660, 662, 663, 668, 672, 673, 675, 676, 685, 690, 693, 698, 701, 704, 708, 713, 714, 715, 716, 719, 721, 726, 729, 730, 732, 733, 743, 750, 753, 755, 756, 757, 759, 765, 767, 771, 773, 775, 776, 778, 787, 788, 793, 797, 801, 803, 812, 814, 816, 818, 821, 822, 823, 825, 833, 840, 841, 844, 846, 847, 848, 860, 861, 862, 863, 866, 870, 874, 876, 879, 881, 883, 884, 887]
[3, 16, 27, 32, 37, 47, 51, 56, 66, 73, 75, 77, 80, 92, 104, 105, 109, 113, 116, 118, 123, 152, 172, 183, 185, 188, 190, 202, 205, 209, 214, 227, 229, 238, 240, 246, 250, 258, 267, 269, 280, 285, 289, 301, 306, 316, 321, 327, 332, 347, 352, 373, 382, 384, 385, 388, 390, 391, 394, 403, 412, 424, 444, 455, 458, 463, 480, 485, 487, 489, 492, 511, 519, 524, 528, 540, 548, 558, 560, 564, 579, 580, 599, 606, 608, 624, 625, 626, 634, 645, 649, 655, 658, 678, 685, 688, 692, 704, 706, 714, 716, 726, 736, 740, 752, 766, 786, 791, 796, 799, 802, 807, 819, 823, 825, 826, 827, 832, 847, 852, 865, 867]

[5, 8, 11, 14, 15, 24, 25, 26, 32, 39, 40, 41, 43, 45, 46, 47, 48, 52, 54, 55, 56, 58, 59, 61, 62, 63, 65, 66, 70, 73, 81, 92, 93, 95, 99, 102, 104, 107, 108, 112, 115, 120, 126, 127, 129, 131, 132, 133, 138, 141, 142, 144, 145, 147, 151, 161, 163, 164, 169, 170, 176, 178, 181, 190, 191, 193, 194, 196, 202, 211, 218, 219, 220, 230, 231, 233, 235, 237, 238, 239, 243, 246, 247, 250, 254, 255, 257, 258, 259, 261, 262, 265, 267, 275, 276, 277, 279, 281, 282, 283, 284, 285, 286, 289, 291, 302, 305, 307, 308, 311, 312, 313, 314, 315, 316, 318, 322, 333, 335, 338, 339, 344, 345, 348, 352, 353, 354, 358, 359, 360, 363, 366, 370, 372, 376, 377, 379, 381, 383, 385, 391, 397, 400, 402, 403, 407, 408, 409, 415, 423, 425, 428, 430, 432, 438, 439, 443, 444, 445, 452, 459, 464, 465, 467, 468, 474, 475, 477, 479, 483, 484, 485, 488, 491, 493, 500, 508, 509, 510, 513, 514, 515, 516, 523, 526, 528, 529, 533, 535, 538, 540, 543, 544, 545, 554, 555, 559, 562, 565, 568, 570, 573, 579, 582, 588, 590, 593, 596, 598, 599, 600, 607, 611, 614, 615, 616, 618, 619, 620, 626, 635, 638, 643, 644, 650, 655, 658, 660, 662, 663, 664, 668, 672, 673, 674, 675, 676, 685, 690, 692, 693, 698, 701, 704, 708, 709, 713, 714, 715, 716, 719, 721, 726, 729, 730, 732, 733, 736, 743, 747, 750, 752, 753, 755, 756, 757, 759, 763, 764, 765, 767, 771, 772, 773, 775, 776, 778, 787, 788, 790, 793, 797, 801, 803, 812, 813, 814, 816, 818, 821, 822, 823, 825, 826, 833, 840, 841, 842, 843, 844, 846, 847, 848, 849, 860, 861, 862, 863, 866, 867, 870, 872, 873, 874, 876, 879, 881, 883, 884, 887, 888, 889]
[3, 16, 27, 32, 37, 47, 51, 56, 66, 73, 75, 77, 80, 92, 104, 105, 109, 113, 116, 118, 123, 152, 172, 183, 185, 188, 190, 202, 205, 209, 214, 227, 229, 238, 240, 246, 250, 258, 267, 269, 280, 285, 289, 301, 306, 316, 321, 327, 332, 347, 352, 373, 382, 384, 385, 388, 390, 391, 394, 403, 412, 424, 444, 455, 458, 463, 480, 485, 487, 489, 492, 511, 519, 524, 528, 540, 548, 558, 560, 564, 579, 580, 599, 606, 608, 624, 625, 626, 634, 645, 649, 655, 658, 678, 685, 688, 692, 704, 706, 714, 716, 726, 736, 740, 752, 766, 786, 791, 796, 799, 802, 807, 819, 823, 825, 826, 827, 832, 847, 852, 865, 867]

[5, 8, 11, 14, 15, 24, 25, 26, 28, 29, 32, 33, 36, 39, 40, 41, 42, 43, 45, 46, 47, 48, 52, 54, 55, 56, 58, 59, 60, 61, 62, 63, 65, 66, 67, 69, 70, 73, 80, 81, 90, 92, 93, 95, 99, 102, 104, 107, 108, 112, 114, 115, 117, 119, 120, 126, 127, 128, 129, 131, 132, 133, 137, 138, 140, 141, 142, 144, 145, 147, 149, 151, 161, 163, 164, 165, 169, 170, 176, 178, 181, 190, 191, 193, 194, 196, 200, 201, 202, 205, 211, 218, 219, 220, 230, 231, 233, 235, 237, 238, 239, 242, 243, 246, 247, 250, 254, 255, 257, 258, 259, 261, 262, 265, 267, 275, 276, 277, 279, 281, 282, 283, 284, 285, 286, 289, 291, 302, 305, 307, 308, 311, 312, 313, 314, 315, 316, 318, 322, 331, 333, 335, 338, 339, 344, 345, 348, 352, 353, 354, 358, 359, 360, 361, 363, 366, 370, 372, 376, 377, 379, 381, 383, 385, 386, 391, 397, 400, 402, 403, 407, 408, 409, 414, 415, 418, 423, 425, 428, 430, 432, 436, 438, 439, 443, 444, 445, 452, 454, 456, 459, 464, 465, 467, 468, 472, 474, 475, 477, 479, 483, 484, 485, 487, 488, 491, 493, 495, 500, 503, 507, 508, 509, 510, 513, 514, 515, 516, 523, 526, 528, 529, 533, 534, 535, 536, 538, 540, 543, 544, 545, 551, 554, 555, 559, 562, 564, 565, 568, 570, 573, 575, 579, 582, 588, 590, 593, 595, 596, 597, 598, 599, 600, 603, 607, 611, 612, 614, 615, 616, 618, 619, 620, 626, 629, 632, 634, 635, 636, 638, 639, 641, 643, 644, 645, 646, 650, 655, 658, 660, 662, 663, 664, 665, 668, 672, 673, 674, 675, 676, 685, 689, 690, 691, 692, 693, 698, 699, 701, 704, 708, 709, 710, 713, 714, 715, 716, 719, 720, 721, 726, 729, 730, 731, 732, 733, 734, 736, 742, 743, 744, 745, 747, 750, 751, 752, 753, 754, 755, 756, 757, 759, 760, 763, 764, 765, 767, 771, 772, 773, 775, 776, 778, 785, 786, 787, 788, 790, 793, 797, 801, 803, 812, 813, 814, 816, 818, 819, 821, 822, 823, 825, 826, 831, 833, 840, 841, 842, 843, 844, 846, 847, 848, 849, 852, 855, 860, 861, 862, 863, 864, 866, 867, 870, 872, 873, 874, 876, 879, 881, 882, 883, 884, 885, 887, 888, 889]
[3, 16, 27, 32, 37, 47, 51, 56, 66, 73, 75, 77, 80, 92, 104, 105, 109, 113, 116, 118, 123, 152, 172, 183, 185, 188, 190, 202, 205, 209, 214, 227, 229, 238, 240, 246, 250, 258, 267, 269, 280, 285, 289, 301, 306, 316, 321, 327, 332, 347, 352, 373, 382, 384, 385, 388, 390, 391, 394, 403, 412, 424, 444, 455, 458, 463, 480, 485, 487, 489, 492, 511, 519, 524, 528, 540, 548, 558, 560, 564, 579, 580, 599, 606, 608, 624, 625, 626, 634, 645, 649, 655, 658, 678, 685, 688, 692, 704, 706, 714, 716, 726, 736, 740, 752, 766, 786, 791, 796, 799, 802, 807, 819, 823, 825, 826, 827, 832, 847, 852, 865, 867]

[5, 8, 11, 14, 15, 22, 24, 25, 26, 28, 29, 32, 33, 35, 36, 39, 40, 41, 42, 43, 45, 46, 47, 48, 51, 52, 53, 54, 55, 56, 58, 59, 60, 61, 62, 63, 65, 66, 67, 69, 70, 73, 74, 80, 81, 88, 90, 92, 93, 95, 99, 102, 104, 107, 108, 111, 112, 114, 115, 117, 118, 119, 120, 122, 123, 124, 125, 126, 127, 128, 129, 131, 132, 133, 137, 138, 140, 141, 142, 144, 145, 147, 149, 151, 152, 161, 163, 164, 165, 169, 170, 176, 178, 181, 189, 190, 191, 193, 194, 196, 197, 200, 201, 202, 205, 206, 211, 218, 219, 220, 228, 230, 231, 233, 235, 237, 238, 239, 240, 242, 243, 246, 247, 250, 254, 255, 256, 257, 258, 259, 261, 262, 265, 267, 275, 276, 277, 279, 281, 282, 283, 284, 285, 286, 289, 291, 297, 302, 305, 307, 308, 311, 312, 313, 314, 315, 316, 318, 319, 320, 322, 331, 333, 335, 338, 339, 342, 343, 344, 345, 346, 347, 348, 349, 352, 353, 354, 358, 359, 360, 361, 363, 364, 366, 370, 372, 376, 377, 378, 379, 381, 383, 385, 386, 391, 394, 397, 400, 402, 403, 407, 408, 409, 410, 411, 414, 415, 418, 419, 423, 425, 428, 430, 432, 436, 438, 439, 443, 444, 445, 452, 454, 456, 457, 459, 461, 464, 465, 466, 467, 468, 472, 474, 475, 477, 479, 480, 483, 484, 485, 487, 488, 491, 493, 495, 500, 503, 507, 508, 509, 510, 512, 513, 514, 515, 516, 520, 523, 524, 526, 528, 529, 533, 534, 535, 536, 538, 540, 543, 544, 545, 551, 554, 555, 556, 559, 562, 564, 565, 567, 568, 570, 573, 575, 579, 582, 587, 588, 590, 593, 595, 596, 597, 598, 599, 600, 603, 604, 606, 607, 611, 612, 614, 615, 616, 617, 618, 619, 620, 625, 626, 629, 632, 634, 635, 636, 638, 639, 641, 643, 644, 645, 646, 650, 653, 655, 656, 657, 658, 660, 661, 662, 663, 664, 665, 668, 670, 672, 673, 674, 675, 676, 685, 687, 689, 690, 691, 692, 693, 694, 697, 698, 699, 700, 701, 704, 705, 708, 709, 710, 711, 713, 714, 715, 716, 718, 719, 720, 721, 724, 726, 729, 730, 731, 732, 733, 734, 736, 738, 742, 743, 744, 745, 747, 750, 751, 752, 753, 754, 755, 756, 757, 759, 760, 763, 764, 765, 767, 771, 772, 773, 775, 776, 778, 779, 781, 785, 786, 787, 788, 790, 791, 793, 794, 795, 797, 801, 803, 809, 812, 813, 814, 816, 818, 819, 821, 822, 823, 824, 825, 826, 828, 830, 831, 832, 833, 840, 841, 842, 843, 844, 846, 847, 848, 849, 852, 853, 855, 860, 861, 862, 863, 864, 865, 866, 867, 868, 870, 872, 873, 874, 876, 879, 881, 882, 883, 884, 885, 886, 887, 888, 889]
[3, 16, 27, 32, 37, 47, 51, 56, 66, 73, 75, 77, 80, 92, 104, 105, 109, 113, 116, 118, 123, 152, 172, 183, 185, 188, 190, 202, 205, 209, 214, 227, 229, 238, 240, 246, 250, 258, 267, 269, 280, 285, 289, 301, 306, 316, 321, 327, 332, 347, 352, 373, 382, 384, 385, 388, 390, 391, 394, 403, 412, 424, 444, 455, 458, 463, 480, 485, 487, 489, 492, 511, 519, 524, 528, 540, 548, 558, 560, 564, 579, 580, 599, 606, 608, 624, 625, 626, 634, 645, 649, 655, 658, 678, 685, 688, 692, 704, 706, 714, 716, 726, 736, 740, 752, 766, 786, 791, 796, 799, 802, 807, 819, 823, 825, 826, 827, 832, 847, 852, 865, 867]

[2, 3, 5, 6, 8, 11, 14, 15, 21, 22, 24, 25, 26, 28, 29, 32, 33, 35, 36, 38, 39, 40, 41, 42, 43, 45, 46, 47, 48, 51, 52, 53, 54, 55, 56, 58, 59, 60, 61, 62, 63, 65, 66, 67, 68, 69, 70, 73, 74, 80, 81, 85, 88, 90, 91, 92, 93, 94, 95, 96, 97, 98, 99, 102, 104, 107, 108, 111, 112, 113, 114, 115, 116, 117, 118, 119, 120, 122, 123, 124, 125, 126, 127, 128, 129, 130, 131, 132, 133, 137, 138, 140, 141, 142, 144, 145, 147, 149, 151, 152, 161, 163, 164, 165, 169, 170, 176, 178, 181, 183, 189, 190, 191, 193, 194, 196, 197, 198, 200, 201, 202, 205, 206, 211, 212, 218, 219, 220, 228, 230, 231, 233, 235, 236, 237, 238, 239, 240, 242, 243, 246, 247, 250, 252, 253, 254, 255, 256, 257, 258, 259, 261, 262, 265, 266, 267, 268, 269, 275, 276, 277, 279, 280, 281, 282, 283, 284, 285, 286, 289, 291, 297, 302, 305, 307, 308, 311, 312, 313, 314, 315, 316, 318, 319, 320, 322, 330, 331, 333, 334, 335, 336, 338, 339, 342, 343, 344, 345, 346, 347, 348, 349, 352, 353, 354, 355, 356, 358, 359, 360, 361, 363, 364, 366, 368, 370, 372, 373, 376, 377, 378, 379, 381, 383, 385, 386, 388, 391, 394, 397, 399, 400, 402, 403, 407, 408, 409, 410, 411, 412, 414, 415, 418, 419, 421, 423, 425, 426, 428, 430, 432, 434, 436, 438, 439, 443, 444, 445, 448, 449, 451, 452, 454, 455, 456, 457, 459, 461, 464, 465, 466, 467, 468, 471, 472, 474, 475, 476, 477, 479, 480, 481, 483, 484, 485, 487, 488, 489, 491, 493, 495, 496, 497, 500, 503, 507, 508, 509, 510, 512, 513, 514, 515, 516, 518, 520, 523, 524, 526, 528, 529, 533, 534, 535, 536, 538, 540, 542, 543, 544, 545, 551, 554, 555, 556, 559, 562, 564, 565, 567, 568, 570, 571, 573, 575, 579, 582, 584, 587, 588, 589, 590, 593, 594, 595, 596, 597, 598, 599, 600, 603, 604, 605, 606, 607, 610, 611, 612, 614, 615, 616, 617, 618, 619, 620, 625, 626, 627, 629, 632, 633, 634, 635, 636, 638, 639, 641, 643, 644, 645, 646, 650, 653, 655, 656, 657, 658, 659, 660, 661, 662, 663, 664, 665, 668, 670, 672, 673, 674, 675, 676, 679, 685, 687, 689, 690, 691, 692, 693, 694, 696, 697, 698, 699, 700, 701, 704, 705, 708, 709, 710, 711, 713, 714, 715, 716, 718, 719, 720, 721, 724, 726, 729, 730, 731, 732, 733, 734, 736, 738, 742, 743, 744, 745, 747, 750, 751, 752, 753, 754, 755, 756, 757, 759, 760, 762, 763, 764, 765, 767, 770, 771, 772, 773, 775, 776, 778, 779, 780, 781, 783, 785, 786, 787, 788, 790, 791, 792, 793, 794, 795, 797, 798, 801, 803, 809, 812, 813, 814, 816, 817, 818, 819, 820, 821, 822, 823, 824, 825, 826, 828, 830, 831, 832, 833, 836, 839, 840, 841, 842, 843, 844, 846, 847, 848, 849, 851, 852, 853, 855, 860, 861, 862, 863, 864, 865, 866, 867, 868, 869, 870, 872, 873, 874, 876, 877, 879, 880, 881, 882, 883, 884, 885, 886, 887, 888, 889]
[3, 16, 27, 32, 37, 47, 51, 56, 66, 73, 75, 77, 80, 92, 104, 105, 109, 113, 116, 118, 123, 152, 172, 183, 185, 188, 190, 202, 205, 209, 214, 227, 229, 238, 240, 246, 250, 258, 267, 269, 280, 285, 289, 301, 306, 316, 321, 327, 332, 347, 352, 373, 382, 384, 385, 388, 390, 391, 394, 403, 412, 424, 444, 455, 458, 463, 480, 485, 487, 489, 492, 511, 519, 524, 528, 540, 548, 558, 560, 564, 579, 580, 599, 606, 608, 624, 625, 626, 634, 645, 649, 655, 658, 678, 685, 688, 692, 704, 706, 714, 716, 726, 736, 740, 752, 766, 786, 791, 796, 799, 802, 807, 819, 823, 825, 826, 827, 832, 847, 852, 865, 867]

[2, 3, 5, 6, 8, 11, 14, 15, 17, 18, 21, 22, 23, 24, 25, 26, 28, 29, 30, 32, 33, 35, 36, 37, 38, 39, 40, 41, 42, 43, 45, 46, 47, 48, 51, 52, 53, 54, 55, 56, 57, 58, 59, 60, 61, 62, 63, 64, 65, 66, 67, 68, 69, 70, 73, 74, 78, 80, 81, 84, 85, 88, 90, 91, 92, 93, 94, 95, 96, 97, 98, 99, 102, 104, 107, 108, 111, 112, 113, 114, 115, 116, 117, 118, 119, 120, 121, 122, 123, 124, 125, 126, 127, 128, 129, 130, 131, 132, 133, 137, 138, 140, 141, 142, 144, 145, 147, 149, 151, 152, 154, 158, 161, 163, 164, 165, 169, 170, 172, 176, 177, 178, 181, 183, 189, 190, 191, 193, 194, 195, 196, 197, 198, 200, 201, 202, 204, 205, 206, 211, 212, 218, 219, 220, 223, 227, 228, 230, 231, 232, 233, 234, 235, 236, 237, 238, 239, 240, 242, 243, 246, 247, 250, 252, 253, 254, 255, 256, 257, 258, 259, 261, 262, 265, 266, 267, 268, 269, 271, 272, 273, 275, 276, 277, 279, 280, 281, 282, 283, 284, 285, 286, 287, 289, 291, 293, 294, 297, 302, 305, 306, 307, 308, 311, 312, 313, 314, 315, 316, 317, 318, 319, 320, 322, 326, 330, 331, 333, 334, 335, 336, 338, 339, 340, 342, 343, 344, 345, 346, 347, 348, 349, 351, 352, 353, 354, 355, 356, 358, 359, 360, 361, 363, 364, 366, 368, 369, 370, 372, 373, 374, 376, 377, 378, 379, 381, 383, 385, 386, 388, 389, 391, 394, 397, 398, 399, 400, 402, 403, 404, 407, 408, 409, 410, 411, 412, 413, 414, 415, 418, 419, 420, 421, 423, 425, 426, 427, 428, 430, 432, 434, 436, 437, 438, 439, 443, 444, 445, 448, 449, 451, 452, 454, 455, 456, 457, 458, 459, 461, 462, 463, 464, 465, 466, 467, 468, 471, 472, 473, 474, 475, 476, 477, 479, 480, 481, 483, 484, 485, 487, 488, 489, 491, 492, 493, 495, 496, 497, 499, 500, 501, 503, 507, 508, 509, 510, 511, 512, 513, 514, 515, 516, 518, 520, 523, 524, 526, 528, 529, 532, 533, 534, 535, 536, 538, 540, 541, 542, 543, 544, 545, 551, 552, 554, 555, 556, 559, 562, 563, 564, 565, 566, 567, 568, 570, 571, 572, 573, 575, 579, 581, 582, 583, 584, 587, 588, 589, 590, 592, 593, 594, 595, 596, 597, 598, 599, 600, 603, 604, 605, 606, 607, 610, 611, 612, 613, 614, 615, 616, 617, 618, 619, 620, 622, 624, 625, 626, 627, 629, 630, 631, 632, 633, 634, 635, 636, 638, 639, 641, 643, 644, 645, 646, 650, 651, 652, 653, 655, 656, 657, 658, 659, 660, 661, 662, 663, 664, 665, 668, 670, 672, 673, 674, 675, 676, 679, 685, 686, 687, 688, 689, 690, 691, 692, 693, 694, 696, 697, 698, 699, 700, 701, 702, 704, 705, 708, 709, 710, 711, 713, 714, 715, 716, 718, 719, 720, 721, 724, 726, 729, 730, 731, 732, 733, 734, 736, 738, 740, 742, 743, 744, 745, 747, 750, 751, 752, 753, 754, 755, 756, 757, 759, 760, 762, 763, 764, 765, 766, 767, 770, 771, 772, 773, 775, 776, 778, 779, 780, 781, 783, 784, 785, 786, 787, 788, 790, 791, 792, 793, 794, 795, 797, 798, 799, 800, 801, 802, 803, 805, 807, 808, 809, 811, 812, 813, 814, 815, 816, 817, 818, 819, 820, 821, 822, 823, 824, 825, 826, 827, 828, 830, 831, 832, 833, 836, 837, 839, 840, 841, 842, 843, 844, 846, 847, 848, 849, 850, 851, 852, 853, 855, 860, 861, 862, 863, 864, 865, 866, 867, 868, 869, 870, 872, 873, 874, 876, 877, 879, 880, 881, 882, 883, 884, 885, 886, 887, 888, 889]
[3, 16, 27, 32, 37, 47, 51, 56, 66, 73, 75, 77, 80, 92, 104, 105, 109, 113, 116, 118, 123, 152, 172, 183, 185, 188, 190, 202, 205, 209, 214, 227, 229, 238, 240, 246, 250, 258, 267, 269, 280, 285, 289, 301, 306, 316, 321, 327, 332, 347, 352, 373, 382, 384, 385, 388, 390, 391, 394, 403, 412, 424, 444, 455, 458, 463, 480, 485, 487, 489, 492, 511, 519, 524, 528, 540, 548, 558, 560, 564, 579, 580, 599, 606, 608, 624, 625, 626, 634, 645, 649, 655, 658, 678, 685, 688, 692, 704, 706, 714, 716, 726, 736, 740, 752, 766, 786, 791, 796, 799, 802, 807, 819, 823, 825, 826, 827, 832, 847, 852, 865, 867]

[2, 3, 5, 6, 7, 8, 9, 11, 14, 15, 17, 18, 21, 22, 23, 24, 25, 26, 27, 28, 29, 30, 32, 33, 35, 36, 37, 38, 39, 40, 41, 42, 43, 44, 45, 46, 47, 48, 51, 52, 53, 54, 55, 56, 57, 58, 59, 60, 61, 62, 63, 64, 65, 66, 67, 68, 69, 70, 71, 73, 74, 75, 78, 80, 81, 82, 83, 84, 85, 88, 90, 91, 92, 93, 94, 95, 96, 97, 98, 99, 102, 104, 106, 107, 108, 111, 112, 113, 114, 115, 116, 117, 118, 119, 120, 121, 122, 123, 124, 125, 126, 127, 128, 129, 130, 131, 132, 133, 135, 136, 137, 138, 139, 140, 141, 142, 143, 144, 145, 146, 147, 149, 150, 151, 152, 154, 155, 158, 161, 163, 164, 165, 167, 168, 169, 170, 171, 172, 175, 176, 177, 178, 181, 182, 183, 188, 189, 190, 191, 193, 194, 195, 196, 197, 198, 200, 201, 202, 203, 204, 205, 206, 211, 212, 213, 214, 216, 217, 218, 219, 220, 223, 227, 228, 230, 231, 232, 233, 234, 235, 236, 237, 238, 239, 240, 241, 242, 243, 246, 247, 248, 250, 252, 253, 254, 255, 256, 257, 258, 259, 261, 262, 265, 266, 267, 268, 269, 270, 271, 272, 273, 275, 276, 277, 279, 280, 281, 282, 283, 284, 285, 286, 287, 289, 291, 292, 293, 294, 295, 297, 302, 305, 306, 307, 308, 310, 311, 312, 313, 314, 315, 316, 317, 318, 319, 320, 321, 322, 323, 326, 330, 331, 332, 333, 334, 335, 336, 338, 339, 340, 341, 342, 343, 344, 345, 346, 347, 348, 349, 351, 352, 353, 354, 355, 356, 357, 358, 359, 360, 361, 363, 364, 365, 366, 368, 369, 370, 372, 373, 374, 376, 377, 378, 379, 381, 383, 385, 386, 387, 388, 389, 391, 394, 397, 398, 399, 400, 401, 402, 403, 404, 407, 408, 409, 410, 411, 412, 413, 414, 415, 418, 419, 420, 421, 423, 424, 425, 426, 427, 428, 429, 430, 432, 434, 435, 436, 437, 438, 439, 441, 442, 443, 444, 445, 446, 448, 449, 451, 452, 454, 455, 456, 457, 458, 459, 460, 461, 462, 463, 464, 465, 466, 467, 468, 471, 472, 473, 474, 475, 476, 477, 479, 480, 481, 483, 484, 485, 487, 488, 489, 490, 491, 492, 493, 495, 496, 497, 498, 499, 500, 501, 502, 503, 507, 508, 509, 510, 511, 512, 513, 514, 515, 516, 518, 520, 523, 524, 526, 527, 528, 529, 532, 533, 534, 535, 536, 537, 538, 539, 540, 541, 542, 543, 544, 545, 546, 551, 552, 553, 554, 555, 556, 557, 558, 559, 560, 562, 563, 564, 565, 566, 567, 568, 570, 571, 572, 573, 575, 576, 578, 579, 581, 582, 583, 584, 587, 588, 589, 590, 592, 593, 594, 595, 596, 597, 598, 599, 600, 603, 604, 605, 606, 607, 609, 610, 611, 612, 613, 614, 615, 616, 617, 618, 619, 620, 622, 624, 625, 626, 627, 629, 630, 631, 632, 633, 634, 635, 636, 638, 639, 641, 642, 643, 644, 645, 646, 650, 651, 652, 653, 655, 656, 657, 658, 659, 660, 661, 662, 663, 664, 665, 667, 668, 670, 672, 673, 674, 675, 676, 678, 679, 681, 683, 685, 686, 687, 688, 689, 690, 691, 692, 693, 694, 696, 697, 698, 699, 700, 701, 702, 704, 705, 708, 709, 710, 711, 713, 714, 715, 716, 717, 718, 719, 720, 721, 724, 726, 727, 728, 729, 730, 731, 732, 733, 734, 736, 738, 740, 742, 743, 744, 745, 747, 749, 750, 751, 752, 753, 754, 755, 756, 757, 758, 759, 760, 762, 763, 764, 765, 766, 767, 770, 771, 772, 773, 775, 776, 778, 779, 780, 781, 782, 783, 784, 785, 786, 787, 788, 790, 791, 792, 793, 794, 795, 797, 798, 799, 800, 801, 802, 803, 805, 806, 807, 808, 809, 810, 811, 812, 813, 814, 815, 816, 817, 818, 819, 820, 821, 822, 823, 824, 825, 826, 827, 828, 830, 831, 832, 833, 834, 836, 837, 838, 839, 840, 841, 842, 843, 844, 846, 847, 848, 849, 850, 851, 852, 853, 855, 860, 861, 862, 863, 864, 865, 866, 867, 868, 869, 870, 872, 873, 874, 876, 877, 879, 880, 881, 882, 883, 884, 885, 886, 887, 888, 889]
[3, 16, 27, 32, 37, 47, 51, 56, 66, 73, 75, 77, 80, 92, 104, 105, 109, 113, 116, 118, 123, 152, 172, 183, 185, 188, 190, 202, 205, 209, 214, 227, 229, 238, 240, 246, 250, 258, 267, 269, 280, 285, 289, 301, 306, 316, 321, 327, 332, 347, 352, 373, 382, 384, 385, 388, 390, 391, 394, 403, 412, 424, 444, 455, 458, 463, 480, 485, 487, 489, 492, 511, 519, 524, 528, 540, 548, 558, 560, 564, 579, 580, 599, 606, 608, 624, 625, 626, 634, 645, 649, 655, 658, 678, 685, 688, 692, 704, 706, 714, 716, 726, 736, 740, 752, 766, 786, 791, 796, 799, 802, 807, 819, 823, 825, 826, 827, 832, 847, 852, 865, 867]

[0, 1, 2, 3, 5, 6, 7, 8, 9, 11, 14, 15, 16, 17, 18, 19, 21, 22, 23, 24, 25, 26, 27, 28, 29, 30, 31, 32, 33, 34, 35, 36, 37, 38, 39, 40, 41, 42, 43, 44, 45, 46, 47, 48, 51, 52, 53, 54, 55, 56, 57, 58, 59, 60, 61, 62, 63, 64, 65, 66, 67, 68, 69, 70, 71, 72, 73, 74, 75, 76, 78, 80, 81, 82, 83, 84, 85, 86, 88, 90, 91, 92, 93, 94, 95, 96, 97, 98, 99, 101, 102, 103, 104, 105, 106, 107, 108, 111, 112, 113, 114, 115, 116, 117, 118, 119, 120, 121, 122, 123, 124, 125, 126, 127, 128, 129, 130, 131, 132, 133, 135, 136, 137, 138, 139, 140, 141, 142, 143, 144, 145, 146, 147, 149, 150, 151, 152, 153, 154, 155, 157, 158, 161, 163, 164, 165, 167, 168, 169, 170, 171, 172, 174, 175, 176, 177, 178, 181, 182, 183, 185, 186, 188, 189, 190, 191, 192, 193, 194, 195, 196, 197, 198, 200, 201, 202, 203, 204, 205, 206, 208, 210, 211, 212, 213, 214, 215, 216, 217, 218, 219, 220, 221, 222, 223, 225, 227, 228, 229, 230, 231, 232, 233, 234, 235, 236, 237, 238, 239, 240, 241, 242, 243, 244, 245, 246, 247, 248, 250, 252, 253, 254, 255, 256, 257, 258, 259, 260, 261, 262, 263, 264, 265, 266, 267, 268, 269, 270, 271, 272, 273, 275, 276, 277, 279, 280, 281, 282, 283, 284, 285, 286, 287, 289, 291, 292, 293, 294, 295, 297, 298, 302, 305, 306, 307, 308, 310, 311, 312, 313, 314, 315, 316, 317, 318, 319, 320, 321, 322, 323, 326, 327, 328, 330, 331, 332, 333, 334, 335, 336, 338, 339, 340, 341, 342, 343, 344, 345, 346, 347, 348, 349, 351, 352, 353, 354, 355, 356, 357, 358, 359, 360, 361, 362, 363, 364, 365, 366, 367, 368, 369, 370, 372, 373, 374, 376, 377, 378, 379, 381, 383, 384, 385, 386, 387, 388, 389, 391, 392, 394, 395, 396, 397, 398, 399, 400, 401, 402, 403, 404, 406, 407, 408, 409, 410, 411, 412, 413, 414, 415, 418, 419, 420, 421, 422, 423, 424, 425, 426, 427, 428, 429, 430, 432, 434, 435, 436, 437, 438, 439, 440, 441, 442, 443, 444, 445, 446, 447, 448, 449, 451, 452, 453, 454, 455, 456, 457, 458, 459, 460, 461, 462, 463, 464, 465, 466, 467, 468, 471, 472, 473, 474, 475, 476, 477, 478, 479, 480, 481, 482, 483, 484, 485, 486, 487, 488, 489, 490, 491, 492, 493, 494, 495, 496, 497, 498, 499, 500, 501, 502, 503, 504, 507, 508, 509, 510, 511, 512, 513, 514, 515, 516, 517, 518, 520, 523, 524, 526, 527, 528, 529, 530, 532, 533, 534, 535, 536, 537, 538, 539, 540, 541, 542, 543, 544, 545, 546, 550, 551, 552, 553, 554, 555, 556, 557, 558, 559, 560, 562, 563, 564, 565, 566, 567, 568, 569, 570, 571, 572, 573, 575, 576, 577, 578, 579, 580, 581, 582, 583, 584, 586, 587, 588, 589, 590, 592, 593, 594, 595, 596, 597, 598, 599, 600, 601, 602, 603, 604, 605, 606, 607, 608, 609, 610, 611, 612, 613, 614, 615, 616, 617, 618, 619, 620, 622, 624, 625, 626, 627, 629, 630, 631, 632, 633, 634, 635, 636, 637, 638, 639, 640, 641, 642, 643, 644, 645, 646, 650, 651, 652, 653, 655, 656, 657, 658, 659, 660, 661, 662, 663, 664, 665, 666, 667, 668, 669, 670, 671, 672, 673, 674, 675, 676, 677, 678, 679, 681, 682, 683, 685, 686, 687, 688, 689, 690, 691, 692, 693, 694, 695, 696, 697, 698, 699, 700, 701, 702, 704, 705, 707, 708, 709, 710, 711, 713, 714, 715, 716, 717, 718, 719, 720, 721, 722, 723, 724, 726, 727, 728, 729, 730, 731, 732, 733, 734, 736, 738, 740, 741, 742, 743, 744, 745, 746, 747, 749, 750, 751, 752, 753, 754, 755, 756, 757, 758, 759, 760, 762, 763, 764, 765, 766, 767, 768, 770, 771, 772, 773, 775, 776, 777, 778, 779, 780, 781, 782, 783, 784, 785, 786, 787, 788, 790, 791, 792, 793, 794, 795, 797, 798, 799, 800, 801, 802, 803, 804, 805, 806, 807, 808, 809, 810, 811, 812, 813, 814, 815, 816, 817, 818, 819, 820, 821, 822, 823, 824, 825, 826, 827, 828, 830, 831, 832, 833, 834, 836, 837, 838, 839, 840, 841, 842, 843, 844, 845, 846, 847, 848, 849, 850, 851, 852, 853, 854, 855, 857, 860, 861, 862, 863, 864, 865, 866, 867, 868, 869, 870, 872, 873, 874, 876, 877, 878, 879, 880, 881, 882, 883, 884, 885, 886, 887, 888, 889]
[3, 16, 27, 32, 37, 47, 51, 56, 66, 73, 75, 77, 80, 92, 104, 105, 109, 113, 116, 118, 123, 152, 172, 183, 185, 188, 190, 202, 205, 209, 214, 227, 229, 238, 240, 246, 250, 258, 267, 269, 280, 285, 289, 301, 306, 316, 321, 327, 332, 347, 352, 373, 382, 384, 385, 388, 390, 391, 394, 403, 412, 424, 444, 455, 458, 463, 480, 485, 487, 489, 492, 511, 519, 524, 528, 540, 548, 558, 560, 564, 579, 580, 599, 606, 608, 624, 625, 626, 634, 645, 649, 655, 658, 678, 685, 688, 692, 704, 706, 714, 716, 726, 736, 740, 752, 766, 786, 791, 796, 799, 802, 807, 819, 823, 825, 826, 827, 832, 847, 852, 865, 867]

