[65, 83, 127, 145, 162, 169, 199, 264, 406, 436, 477, 535, 541, 573, 680, 761, 770, 781, 803, 807, 865, 873]
[30, 50, 59, 60, 69, 173, 234, 250, 289, 315, 332, 335, 373, 479, 528, 531, 597, 632, 642, 663, 717, 858]

[65, 83, 127, 145, 162, 169, 199, 264, 406, 436, 477, 535, 541, 573, 680, 761, 770, 781, 803, 807, 865, 873]
[11, 25, 27, 30, 36, 43, 44, 48, 49, 50, 59, 60, 62, 69, 84, 95, 97, 102, 107, 110, 134, 143, 158, 173, 177, 179, 182, 193, 201, 232, 234, 250, 259, 262, 263, 269, 272, 278, 279, 282, 289, 292, 301, 303, 310, 315, 331, 332, 335, 339, 340, 363, 369, 370, 373, 395, 404, 407, 408, 409, 414, 416, 419, 431, 433, 435, 451, 459, 471, 478, 479, 491, 500, 502, 503, 504, 507, 508, 517, 519, 528, 531, 533, 552, 575, 583, 597, 601, 607, 610, 632, 633, 642, 648, 652, 663, 691, 698, 712, 717, 723, 724, 738, 743, 744, 746, 759, 763, 778, 789, 793, 798, 799, 804, 841, 846, 854, 858, 866, 872, 880, 886]

[1, 24, 31, 35, 39, 50, 64, 65, 71, 72, 83, 88, 94, 127, 131, 145, 155, 162, 169, 180, 199, 201, 203, 209, 215, 224, 232, 246, 259, 260, 263, 264, 279, 283, 284, 291, 301, 304, 316, 338, 349, 377, 384, 390, 393, 406, 407, 412, 425, 436, 451, 467, 469, 477, 488, 535, 541, 553, 558, 571, 573, 574, 593, 601, 604, 611, 612, 613, 616, 617, 620, 621, 628, 653, 680, 685, 710, 718, 727, 741, 744, 750, 758, 761, 770, 781, 783, 803, 807, 815, 823, 829, 840, 850, 856, 865, 873]
[11, 25, 27, 30, 36, 43, 44, 48, 49, 50, 59, 60, 62, 69, 84, 95, 97, 102, 107, 110, 134, 143, 158, 173, 177, 179, 182, 193, 201, 232, 234, 250, 259, 262, 263, 269, 272, 278, 279, 282, 289, 292, 301, 303, 310, 315, 331, 332, 335, 339, 340, 363, 369, 370, 373, 395, 404, 407, 408, 409, 414, 416, 419, 431, 433, 435, 451, 459, 471, 478, 479, 491, 500, 502, 503, 504, 507, 508, 517, 519, 528, 531, 533, 552, 575, 583, 597, 601, 607, 610, 632, 633, 642, 648, 652, 663, 691, 698, 712, 717, 723, 724, 738, 743, 744, 746, 759, 763, 778, 789, 793, 798, 799, 804, 841, 846, 854, 858, 866, 872, 880, 886]

[1, 3, 12, 24, 31, 35, 39, 48, 50, 54, 57, 62, 64, 65, 71, 72, 75, 83, 88, 92, 94, 102, 120, 127, 131, 132, 138, 142, 145, 151, 155, 162, 169, 177, 180, 197, 199, 201, 203, 209, 215, 216, 219, 224, 232, 246, 252, 259, 260, 263, 264, 277, 279, 283, 284, 291, 292, 301, 302, 304, 305, 312, 316, 323, 329, 334, 338, 349, 352, 362, 377, 382, 383, 384, 388, 389, 390, 393, 400, 406, 407, 410, 412, 414, 415, 419, 421, 425, 427, 436, 449, 451, 467, 469, 473, 477, 488, 489, 491, 495, 504, 511, 512, 530, 533, 535, 538, 540, 541, 550, 553, 554, 558, 561, 571, 572, 573, 574, 593, 601, 604, 605, 611, 612, 613, 616, 617, 620, 621, 628, 634, 639, 640, 642, 653, 663, 680, 681, 685, 709, 710, 712, 718, 727, 739, 741, 742, 744, 750, 758, 761, 763, 770, 781, 783, 784, 803, 807, 815, 819, 823, 825, 827, 829, 840, 850, 856, 865, 872, 873, 874, 877]
[11, 25, 27, 30, 36, 43, 44, 48, 49, 50, 59, 60, 62, 69, 84, 95, 97, 102, 107, 110, 134, 143, 158, 173, 177, 179, 182, 193, 201, 232, 234, 250, 259, 262, 263, 269, 272, 278, 279, 282, 289, 292, 301, 303, 310, 315, 331, 332, 335, 339, 340, 363, 369, 370, 373, 395, 404, 407, 408, 409, 414, 416, 419, 431, 433, 435, 451, 459, 471, 478, 479, 491, 500, 502, 503, 504, 507, 508, 517, 519, 528, 531, 533, 552, 575, 583, 597, 601, 607, 610, 632, 633, 642, 648, 652, 663, 691, 698, 712, 717, 723, 724, 738, 743, 744, 746, 759, 763, 778, 789, 793, 798, 799, 804, 841, 846, 854, 858, 866, 872, 880, 886]

[1, 3, 12, 24, 31, 35, 37, 39, 48, 50, 54, 57, 58, 62, 64, 65, 71, 72, 75, 83, 87, 88, 92, 94, 102, 120, 125, 127, 131, 132, 133, 134, 138, 142, 145, 147, 149, 151, 155, 158, 162, 169, 177, 180, 186, 197, 199, 201, 203, 204, 209, 215, 216, 219, 220, 221, 224, 229, 230, 232, 235, 246, 252, 259, 260, 262, 263, 264, 267, 277, 279, 280, 283, 284, 286, 291, 292, 301, 302, 303, 304, 305, 312, 316, 322, 323, 328, 329, 334, 338, 349, 352, 358, 362, 364, 366, 377, 382, 383, 384, 386, 388, 389, 390, 393, 397, 400, 401, 406, 407, 408, 410, 412, 414, 415, 419, 420, 421, 425, 426, 427, 436, 439, 449, 451, 452, 458, 464, 467, 469, 473, 476, 477, 484, 485, 488, 489, 491, 495, 504, 509, 510, 511, 512, 516, 522, 528, 530, 533, 535, 538, 540, 541, 544, 549, 550, 553, 554, 558, 561, 571, 572, 573, 574, 575, 580, 581, 585, 593, 598, 601, 604, 605, 611, 612, 613, 616, 617, 618, 620, 621, 628, 631, 632, 634, 637, 639, 640, 642, 653, 654, 659, 663, 668, 672, 680, 681, 685, 688, 699, 700, 709, 710, 712, 716, 718, 722, 727, 739, 741, 742, 744, 750, 758, 761, 762, 763, 765, 770, 781, 783, 784, 788, 803, 806, 807, 808, 810, 814, 815, 819, 823, 825, 826, 827, 829, 840, 842, 844, 850, 856, 865, 872, 873, 874, 877, 885]
[11, 25, 27, 30, 36, 43, 44, 48, 49, 50, 59, 60, 62, 69, 84, 95, 97, 102, 107, 110, 134, 143, 158, 173, 177, 179, 182, 193, 201, 232, 234, 250, 259, 262, 263, 269, 272, 278, 279, 282, 289, 292, 301, 303, 310, 315, 331, 332, 335, 339, 340, 363, 369, 370, 373, 395, 404, 407, 408, 409, 414, 416, 419, 431, 433, 435, 451, 459, 471, 478, 479, 491, 500, 502, 503, 504, 507, 508, 517, 519, 528, 531, 533, 552, 575, 583, 597, 601, 607, 610, 632, 633, 642, 648, 652, 663, 691, 698, 712, 717, 723, 724, 738, 743, 744, 746, 759, 763, 778, 789, 793, 798, 799, 804, 841, 846, 854, 858, 866, 872, 880, 886]

[1, 3, 9, 12, 19, 24, 31, 35, 37, 39, 41, 42, 45, 48, 50, 54, 57, 58, 59, 62, 64, 65, 69, 70, 71, 72, 75, 77, 83, 87, 88, 92, 94, 102, 105, 120, 125, 127, 129, 131, 132, 133, 134, 138, 142, 145, 147, 148, 149, 151, 155, 158, 162, 169, 171, 177, 180, 186, 194, 197, 199, 200, 201, 203, 204, 205, 209, 215, 216, 217, 219, 220, 221, 224, 229, 230, 232, 234, 235, 239, 244, 246, 252, 259, 260, 262, 263, 264, 267, 277, 279, 280, 283, 284, 286, 288, 291, 292, 293, 297, 301, 302, 303, 304, 305, 306, 307, 312, 316, 322, 323, 328, 329, 332, 334, 338, 340, 349, 352, 356, 358, 361, 362, 364, 366, 377, 382, 383, 384, 386, 388, 389, 390, 393, 397, 399, 400, 401, 406, 407, 408, 409, 410, 412, 414, 415, 419, 420, 421, 425, 426, 427, 430, 434, 436, 439, 449, 451, 452, 457, 458, 459, 461, 464, 466, 467, 469, 473, 476, 477, 484, 485, 487, 488, 489, 491, 495, 496, 504, 509, 510, 511, 512, 516, 522, 528, 530, 533, 535, 538, 540, 541, 543, 544, 549, 550, 553, 554, 556, 558, 561, 567, 571, 572, 573, 574, 575, 576, 578, 580, 581, 585, 593, 595, 597, 598, 600, 601, 602, 604, 605, 611, 612, 613, 614, 615, 616, 617, 618, 620, 621, 627, 628, 631, 632, 634, 636, 637, 638, 639, 640, 642, 644, 653, 654, 656, 659, 663, 668, 672, 674, 676, 680, 681, 685, 688, 693, 699, 700, 708, 709, 710, 712, 716, 718, 722, 724, 727, 739, 741, 742, 744, 747, 750, 756, 758, 761, 762, 763, 765, 770, 773, 776, 781, 783, 784, 786, 788, 800, 803, 806, 807, 808, 810, 814, 815, 819, 821, 823, 825, 826, 827, 829, 840, 842, 844, 847, 848, 850, 851, 853, 854, 856, 861, 864, 865, 872, 873, 874, 876, 877, 885]
[11, 25, 27, 30, 36, 43, 44, 48, 49, 50, 59, 60, 62, 69, 84, 95, 97, 102, 107, 110, 134, 143, 158, 173, 177, 179, 182, 193, 201, 232, 234, 250, 259, 262, 263, 269, 272, 278, 279, 282, 289, 292, 301, 303, 310, 315, 331, 332, 335, 339, 340, 363, 369, 370, 373, 395, 404, 407, 408, 409, 414, 416, 419, 431, 433, 435, 451, 459, 471, 478, 479, 491, 500, 502, 503, 504, 507, 508, 517, 519, 528, 531, 533, 552, 575, 583, 597, 601, 607, 610, 632, 633, 642, 648, 652, 663, 691, 698, 712, 717, 723, 724, 738, 743, 744, 746, 759, 763, 778, 789, 793, 798, 799, 804, 841, 846, 854, 858, 866, 872, 880, 886]

[1, 3, 9, 10, 12, 19, 24, 26, 31, 35, 37, 39, 41, 42, 45, 48, 50, 54, 56, 57, 58, 59, 62, 64, 65, 67, 68, 69, 70, 71, 72, 75, 77, 83, 87, 88, 90, 92, 93, 94, 101, 102, 105, 106, 117, 120, 125, 126, 127, 128, 129, 131, 132, 133, 134, 138, 142, 145, 147, 148, 149, 151, 155, 156, 158, 159, 162, 169, 171, 174, 177, 180, 181, 186, 187, 194, 196, 197, 199, 200, 201, 202, 203, 204, 205, 209, 215, 216, 217, 218, 219, 220, 221, 224, 229, 230, 232, 234, 235, 239, 244, 246, 247, 252, 259, 260, 262, 263, 264, 267, 274, 276, 277, 279, 280, 283, 284, 286, 288, 291, 292, 293, 297, 301, 302, 303, 304, 305, 306, 307, 312, 316, 318, 322, 323, 325, 328, 329, 331, 332, 334, 337, 338, 340, 349, 352, 353, 356, 358, 361, 362, 364, 366, 371, 372, 377, 378, 382, 383, 384, 386, 387, 388, 389, 390, 393, 397, 399, 400, 401, 406, 407, 408, 409, 410, 412, 413, 414, 415, 419, 420, 421, 425, 426, 427, 430, 434, 436, 438, 439, 449, 451, 452, 457, 458, 459, 461, 462, 464, 466, 467, 469, 473, 476, 477, 484, 485, 487, 488, 489, 490, 491, 493, 495, 496, 504, 509, 510, 511, 512, 515, 516, 521, 522, 523, 525, 528, 530, 533, 535, 538, 540, 541, 543, 544, 546, 549, 550, 553, 554, 556, 558, 560, 561, 567, 571, 572, 573, 574, 575, 576, 578, 579, 580, 581, 585, 593, 595, 597, 598, 600, 601, 602, 604, 605, 611, 612, 613, 614, 615, 616, 617, 618, 620, 621, 625, 627, 628, 630, 631, 632, 634, 636, 637, 638, 639, 640, 642, 644, 647, 648, 653, 654, 656, 659, 662, 663, 668, 670, 672, 674, 675, 676, 677, 680, 681, 685, 688, 689, 693, 696, 697, 698, 699, 700, 704, 706, 708, 709, 710, 712, 713, 715, 716, 718, 722, 724, 727, 734, 737, 739, 740, 741, 742, 744, 745, 747, 749, 750, 751, 752, 756, 757, 758, 761, 762, 763, 764, 765, 770, 773, 776, 781, 783, 784, 786, 788, 792, 798, 800, 803, 806, 807, 808, 810, 812, 814, 815, 816, 819, 821, 823, 824, 825, 826, 827, 829, 840, 842, 844, 847, 848, 850, 851, 853, 854, 856, 861, 864, 865, 872, 873, 874, 876, 877, 885, 889]
[11, 25, 27, 30, 36, 43, 44, 48, 49, 50, 59, 60, 62, 69, 84, 95, 97, 102, 107, 110, 134, 143, 158, 173, 177, 179, 182, 193, 201, 232, 234, 250, 259, 262, 263, 269, 272, 278, 279, 282, 289, 292, 301, 303, 310, 315, 331, 332, 335, 339, 340, 363, 369, 370, 373, 395, 404, 407, 408, 409, 414, 416, 419, 431, 433, 435, 451, 459, 471, 478, 479, 491, 500, 502, 503, 504, 507, 508, 517, 519, 528, 531, 533, 552, 575, 583, 597, 601, 607, 610, 632, 633, 642, 648, 652, 663, 691, 698, 712, 717, 723, 724, 738, 743, 744, 746, 759, 763, 778, 789, 793, 798, 799, 804, 841, 846, 854, 858, 866, 872, 880, 886]

[1, 3, 4, 9, 10, 12, 19, 23, 24, 26, 30, 31, 35, 37, 38, 39, 41, 42, 43, 45, 48, 50, 54, 56, 57, 58, 59, 61, 62, 64, 65, 67, 68, 69, 70, 71, 72, 73, 75, 76, 77, 82, 83, 86, 87, 88, 90, 91, 92, 93, 94, 101, 102, 105, 106, 107, 117, 120, 125, 126, 127, 128, 129, 131, 132, 133, 134, 136, 138, 142, 145, 146, 147, 148, 149, 151, 155, 156, 157, 158, 159, 162, 164, 166, 169, 171, 174, 175, 177, 179, 180, 181, 186, 187, 193, 194, 196, 197, 199, 200, 201, 202, 203, 204, 205, 209, 211, 215, 216, 217, 218, 219, 220, 221, 224, 229, 230, 231, 232, 234, 235, 236, 239, 241, 244, 246, 247, 252, 253, 254, 259, 260, 262, 263, 264, 267, 268, 274, 276, 277, 279, 280, 281, 282, 283, 284, 286, 288, 291, 292, 293, 297, 300, 301, 302, 303, 304, 305, 306, 307, 310, 312, 316, 317, 318, 322, 323, 325, 328, 329, 331, 332, 334, 335, 337, 338, 340, 345, 349, 352, 353, 356, 358, 361, 362, 364, 366, 367, 371, 372, 376, 377, 378, 382, 383, 384, 386, 387, 388, 389, 390, 392, 393, 396, 397, 399, 400, 401, 406, 407, 408, 409, 410, 412, 413, 414, 415, 419, 420, 421, 422, 424, 425, 426, 427, 430, 434, 436, 438, 439, 449, 450, 451, 452, 457, 458, 459, 461, 462, 464, 466, 467, 469, 473, 476, 477, 479, 484, 485, 486, 487, 488, 489, 490, 491, 493, 495, 496, 504, 509, 510, 511, 512, 515, 516, 520, 521, 522, 523, 524, 525, 526, 528, 530, 533, 535, 537, 538, 540, 541, 543, 544, 546, 549, 550, 553, 554, 556, 558, 560, 561, 567, 570, 571, 572, 573, 574, 575, 576, 577, 578, 579, 580, 581, 585, 593, 595, 597, 598, 600, 601, 602, 604, 605, 611, 612, 613, 614, 615, 616, 617, 618, 620, 621, 625, 627, 628, 630, 631, 632, 634, 636, 637, 638, 639, 640, 642, 644, 645, 646, 647, 648, 649, 652, 653, 654, 656, 659, 661, 662, 663, 668, 669, 670, 672, 674, 675, 676, 677, 680, 681, 683, 685, 686, 688, 689, 690, 693, 696, 697, 698, 699, 700, 704, 706, 708, 709, 710, 712, 713, 715, 716, 718, 722, 724, 727, 731, 734, 737, 739, 740, 741, 742, 744, 745, 747, 748, 749, 750, 751, 752, 756, 757, 758, 761, 762, 763, 764, 765, 770, 771, 773, 776, 777, 781, 782, 783, 784, 786, 788, 791, 792, 793, 795, 798, 800, 803, 806, 807, 808, 810, 812, 814, 815, 816, 819, 821, 823, 824, 825, 826, 827, 829, 833, 835, 839, 840, 842, 843, 844, 847, 848, 850, 851, 853, 854, 856, 859, 861, 864, 865, 866, 867, 869, 872, 873, 874, 876, 877, 879, 885, 889]
[11, 25, 27, 30, 36, 43, 44, 48, 49, 50, 59, 60, 62, 69, 84, 95, 97, 102, 107, 110, 134, 143, 158, 173, 177, 179, 182, 193, 201, 232, 234, 250, 259, 262, 263, 269, 272, 278, 279, 282, 289, 292, 301, 303, 310, 315, 331, 332, 335, 339, 340, 363, 369, 370, 373, 395, 404, 407, 408, 409, 414, 416, 419, 431, 433, 435, 451, 459, 471, 478, 479, 491, 500, 502, 503, 504, 507, 508, 517, 519, 528, 531, 533, 552, 575, 583, 597, 601, 607, 610, 632, 633, 642, 648, 652, 663, 691, 698, 712, 717, 723, 724, 738, 743, 744, 746, 759, 763, 778, 789, 793, 798, 799, 804, 841, 846, 854, 858, 866, 872, 880, 886]

[1, 3, 4, 9, 10, 12, 19, 20, 22, 23, 24, 26, 30, 31, 34, 35, 37, 38, 39, 41, 42, 43, 45, 47, 48, 50, 54, 56, 57, 58, 59, 61, 62, 64, 65, 67, 68, 69, 70, 71, 72, 73, 75, 76, 77, 82, 83, 84, 86, 87, 88, 90, 91, 92, 93, 94, 95, 97, 101, 102, 103, 105, 106, 107, 114, 117, 120, 125, 126, 127, 128, 129, 131, 132, 133, 134, 136, 138, 142, 143, 145, 146, 147, 148, 149, 151, 155, 156, 157, 158, 159, 160, 162, 164, 166, 169, 171, 172, 173, 174, 175, 176, 177, 179, 180, 181, 186, 187, 192, 193, 194, 196, 197, 199, 200, 201, 202, 203, 204, 205, 209, 211, 212, 215, 216, 217, 218, 219, 220, 221, 223, 224, 229, 230, 231, 232, 234, 235, 236, 239, 240, 241, 242, 243, 244, 246, 247, 251, 252, 253, 254, 258, 259, 260, 261, 262, 263, 264, 267, 268, 269, 274, 276, 277, 279, 280, 281, 282, 283, 284, 286, 287, 288, 291, 292, 293, 297, 300, 301, 302, 303, 304, 305, 306, 307, 310, 312, 316, 317, 318, 319, 321, 322, 323, 325, 327, 328, 329, 331, 332, 334, 335, 337, 338, 339, 340, 345, 348, 349, 350, 352, 353, 356, 358, 361, 362, 364, 366, 367, 369, 371, 372, 373, 375, 376, 377, 378, 382, 383, 384, 385, 386, 387, 388, 389, 390, 392, 393, 396, 397, 399, 400, 401, 406, 407, 408, 409, 410, 412, 413, 414, 415, 417, 419, 420, 421, 422, 424, 425, 426, 427, 428, 430, 431, 434, 436, 438, 439, 442, 444, 448, 449, 450, 451, 452, 453, 457, 458, 459, 461, 462, 464, 466, 467, 469, 471, 473, 476, 477, 479, 481, 484, 485, 486, 487, 488, 489, 490, 491, 493, 495, 496, 504, 505, 506, 508, 509, 510, 511, 512, 515, 516, 520, 521, 522, 523, 524, 525, 526, 528, 530, 532, 533, 535, 537, 538, 540, 541, 543, 544, 546, 549, 550, 553, 554, 556, 558, 560, 561, 564, 566, 567, 568, 570, 571, 572, 573, 574, 575, 576, 577, 578, 579, 580, 581, 582, 585, 593, 595, 597, 598, 600, 601, 602, 604, 605, 608, 611, 612, 613, 614, 615, 616, 617, 618, 620, 621, 624, 625, 627, 628, 629, 630, 631, 632, 634, 636, 637, 638, 639, 640, 642, 644, 645, 646, 647, 648, 649, 651, 652, 653, 654, 656, 659, 661, 662, 663, 665, 668, 669, 670, 672, 674, 675, 676, 677, 678, 679, 680, 681, 682, 683, 685, 686, 688, 689, 690, 691, 693, 696, 697, 698, 699, 700, 704, 706, 708, 709, 710, 712, 713, 715, 716, 717, 718, 722, 724, 726, 727, 731, 734, 735, 737, 739, 740, 741, 742, 744, 745, 746, 747, 748, 749, 750, 751, 752, 754, 756, 757, 758, 759, 761, 762, 763, 764, 765, 770, 771, 772, 773, 774, 775, 776, 777, 781, 782, 783, 784, 786, 788, 791, 792, 793, 795, 798, 800, 803, 806, 807, 808, 810, 811, 812, 813, 814, 815, 816, 819, 821, 823, 824, 825, 826, 827, 829, 833, 835, 839, 840, 842, 843, 844, 845, 847, 848, 850, 851, 853, 854, 855, 856, 859, 860, 861, 864, 865, 866, 867, 869, 872, 873, 874, 876, 877, 878, 879, 880, 885, 889]
[11, 25, 27, 30, 36, 43, 44, 48, 49, 50, 59, 60, 62, 69, 84, 95, 97, 102, 107, 110, 134, 143, 158, 173, 177, 179, 182, 193, 201, 232, 234, 250, 259, 262, 263, 269, 272, 278, 279, 282, 289, 292, 301, 303, 310, 315, 331, 332, 335, 339, 340, 363, 369, 370, 373, 395, 404, 407, 408, 409, 414, 416, 419, 431, 433, 435, 451, 459, 471, 478, 479, 491, 500, 502, 503, 504, 507, 508, 517, 519, 528, 531, 533, 552, 575, 583, 597, 601, 607, 610, 632, 633, 642, 648, 652, 663, 691, 698, 712, 717, 723, 724, 738, 743, 744, 746, 759, 763, 778, 789, 793, 798, 799, 804, 841, 846, 854, 858, 866, 872, 880, 886]

[1, 2, 3, 4, 9, 10, 12, 13, 17, 19, 20, 22, 23, 24, 26, 30, 31, 32, 34, 35, 37, 38, 39, 41, 42, 43, 45, 47, 48, 49, 50, 53, 54, 56, 57, 58, 59, 61, 62, 64, 65, 67, 68, 69, 70, 71, 72, 73, 75, 76, 77, 82, 83, 84, 86, 87, 88, 89, 90, 91, 92, 93, 94, 95, 97, 100, 101, 102, 103, 105, 106, 107, 109, 110, 114, 117, 119, 120, 121, 125, 126, 127, 128, 129, 131, 132, 133, 134, 135, 136, 138, 141, 142, 143, 145, 146, 147, 148, 149, 151, 155, 156, 157, 158, 159, 160, 161, 162, 164, 165, 166, 169, 171, 172, 173, 174, 175, 176, 177, 179, 180, 181, 184, 186, 187, 192, 193, 194, 196, 197, 199, 200, 201, 202, 203, 204, 205, 209, 211, 212, 213, 215, 216, 217, 218, 219, 220, 221, 223, 224, 225, 229, 230, 231, 232, 234, 235, 236, 239, 240, 241, 242, 243, 244, 245, 246, 247, 249, 251, 252, 253, 254, 256, 257, 258, 259, 260, 261, 262, 263, 264, 267, 268, 269, 272, 274, 276, 277, 279, 280, 281, 282, 283, 284, 286, 287, 288, 289, 291, 292, 293, 295, 297, 300, 301, 302, 303, 304, 305, 306, 307, 309, 310, 312, 315, 316, 317, 318, 319, 320, 321, 322, 323, 325, 327, 328, 329, 331, 332, 334, 335, 337, 338, 339, 340, 345, 348, 349, 350, 351, 352, 353, 356, 358, 359, 361, 362, 363, 364, 366, 367, 369, 371, 372, 373, 375, 376, 377, 378, 382, 383, 384, 385, 386, 387, 388, 389, 390, 392, 393, 396, 397, 399, 400, 401, 402, 406, 407, 408, 409, 410, 412, 413, 414, 415, 416, 417, 419, 420, 421, 422, 423, 424, 425, 426, 427, 428, 430, 431, 434, 436, 438, 439, 442, 443, 444, 445, 448, 449, 450, 451, 452, 453, 454, 455, 457, 458, 459, 461, 462, 464, 466, 467, 469, 471, 472, 473, 476, 477, 479, 481, 484, 485, 486, 487, 488, 489, 490, 491, 492, 493, 494, 495, 496, 502, 504, 505, 506, 508, 509, 510, 511, 512, 513, 515, 516, 520, 521, 522, 523, 524, 525, 526, 528, 529, 530, 532, 533, 535, 537, 538, 540, 541, 542, 543, 544, 546, 549, 550, 553, 554, 555, 556, 557, 558, 560, 561, 564, 566, 567, 568, 570, 571, 572, 573, 574, 575, 576, 577, 578, 579, 580, 581, 582, 585, 586, 588, 590, 593, 595, 596, 597, 598, 600, 601, 602, 604, 605, 606, 608, 611, 612, 613, 614, 615, 616, 617, 618, 620, 621, 624, 625, 627, 628, 629, 630, 631, 632, 634, 636, 637, 638, 639, 640, 642, 643, 644, 645, 646, 647, 648, 649, 651, 652, 653, 654, 655, 656, 657, 659, 661, 662, 663, 664, 665, 668, 669, 670, 672, 674, 675, 676, 677, 678, 679, 680, 681, 682, 683, 684, 685, 686, 688, 689, 690, 691, 693, 695, 696, 697, 698, 699, 700, 704, 706, 708, 709, 710, 712, 713, 715, 716, 717, 718, 721, 722, 724, 726, 727, 728, 731, 733, 734, 735, 737, 739, 740, 741, 742, 743, 744, 745, 746, 747, 748, 749, 750, 751, 752, 754, 755, 756, 757, 758, 759, 760, 761, 762, 763, 764, 765, 770, 771, 772, 773, 774, 775, 776, 777, 781, 782, 783, 784, 786, 787, 788, 790, 791, 792, 793, 795, 798, 800, 802, 803, 806, 807, 808, 810, 811, 812, 813, 814, 815, 816, 817, 819, 820, 821, 823, 824, 825, 826, 827, 829, 833, 835, 836, 838, 839, 840, 842, 843, 844, 845, 847, 848, 850, 851, 853, 854, 855, 856, 859, 860, 861, 864, 865, 866, 867, 868, 869, 870, 872, 873, 874, 875, 876, 877, 878, 879, 880, 884, 885, 886, 889]
[11, 25, 27, 30, 36, 43, 44, 48, 49, 50, 59, 60, 62, 69, 84, 95, 97, 102, 107, 110, 134, 143, 158, 173, 177, 179, 182, 193, 201, 232, 234, 250, 259, 262, 263, 269, 272, 278, 279, 282, 289, 292, 301, 303, 310, 315, 331, 332, 335, 339, 340, 363, 369, 370, 373, 395, 404, 407, 408, 409, 414, 416, 419, 431, 433, 435, 451, 459, 471, 478, 479, 491, 500, 502, 503, 504, 507, 508, 517, 519, 528, 531, 533, 552, 575, 583, 597, 601, 607, 610, 632, 633, 642, 648, 652, 663, 691, 698, 712, 717, 723, 724, 738, 743, 744, 746, 759, 763, 778, 789, 793, 798, 799, 804, 841, 846, 854, 858, 866, 872, 880, 886]

[1, 2, 3, 4, 5, 9, 10, 12, 13, 17, 19, 20, 22, 23, 24, 26, 30, 31, 32, 34, 35, 36, 37, 38, 39, 41, 42, 43, 45, 46, 47, 48, 49, 50, 52, 53, 54, 55, 56, 57, 58, 59, 60, 61, 62, 64, 65, 67, 68, 69, 70, 71, 72, 73, 75, 76, 77, 79, 80, 82, 83, 84, 86, 87, 88, 89, 90, 91, 92, 93, 94, 95, 97, 100, 101, 102, 103, 105, 106, 107, 108, 109, 110, 112, 113, 114, 115, 117, 119, 120, 121, 125, 126, 127, 128, 129, 130, 131, 132, 133, 134, 135, 136, 137, 138, 139, 141, 142, 143, 145, 146, 147, 148, 149, 150, 151, 154, 155, 156, 157, 158, 159, 160, 161, 162, 163, 164, 165, 166, 169, 170, 171, 172, 173, 174, 175, 176, 177, 178, 179, 180, 181, 183, 184, 186, 187, 188, 190, 192, 193, 194, 196, 197, 198, 199, 200, 201, 202, 203, 204, 205, 208, 209, 211, 212, 213, 215, 216, 217, 218, 219, 220, 221, 223, 224, 225, 229, 230, 231, 232, 233, 234, 235, 236, 239, 240, 241, 242, 243, 244, 245, 246, 247, 249, 251, 252, 253, 254, 256, 257, 258, 259, 260, 261, 262, 263, 264, 265, 267, 268, 269, 272, 274, 276, 277, 279, 280, 281, 282, 283, 284, 285, 286, 287, 288, 289, 291, 292, 293, 295, 297, 299, 300, 301, 302, 303, 304, 305, 306, 307, 309, 310, 312, 313, 315, 316, 317, 318, 319, 320, 321, 322, 323, 325, 327, 328, 329, 331, 332, 334, 335, 337, 338, 339, 340, 341, 345, 348, 349, 350, 351, 352, 353, 356, 357, 358, 359, 361, 362, 363, 364, 365, 366, 367, 369, 371, 372, 373, 375, 376, 377, 378, 382, 383, 384, 385, 386, 387, 388, 389, 390, 391, 392, 393, 394, 396, 397, 399, 400, 401, 402, 403, 406, 407, 408, 409, 410, 412, 413, 414, 415, 416, 417, 419, 420, 421, 422, 423, 424, 425, 426, 427, 428, 430, 431, 434, 436, 437, 438, 439, 441, 442, 443, 444, 445, 448, 449, 450, 451, 452, 453, 454, 455, 457, 458, 459, 461, 462, 464, 465, 466, 467, 469, 471, 472, 473, 475, 476, 477, 478, 479, 481, 482, 484, 485, 486, 487, 488, 489, 490, 491, 492, 493, 494, 495, 496, 497, 498, 499, 502, 503, 504, 505, 506, 508, 509, 510, 511, 512, 513, 514, 515, 516, 517, 520, 521, 522, 523, 524, 525, 526, 528, 529, 530, 532, 533, 535, 537, 538, 540, 541, 542, 543, 544, 546, 548, 549, 550, 552, 553, 554, 555, 556, 557, 558, 560, 561, 562, 564, 566, 567, 568, 570, 571, 572, 573, 574, 575, 576, 577, 578, 579, 580, 581, 582, 583, 584, 585, 586, 588, 590, 593, 595, 596, 597, 598, 600, 601, 602, 603, 604, 605, 606, 607, 608, 610, 611, 612, 613, 614, 615, 616, 617, 618, 620, 621, 624, 625, 627, 628, 629, 630, 631, 632, 633, 634, 635, 636, 637, 638, 639, 640, 642, 643, 644, 645, 646, 647, 648, 649, 650, 651, 652, 653, 654, 655, 656, 657, 659, 661, 662, 663, 664, 665, 666, 668, 669, 670, 671, 672, 673, 674, 675, 676, 677, 678, 679, 680, 681, 682, 683, 684, 685, 686, 688, 689, 690, 691, 693, 695, 696, 697, 698, 699, 700, 704, 706, 708, 709, 710, 712, 713, 715, 716, 717, 718, 720, 721, 722, 724, 726, 727, 728, 731, 733, 734, 735, 736, 737, 738, 739, 740, 741, 742, 743, 744, 745, 746, 747, 748, 749, 750, 751, 752, 753, 754, 755, 756, 757, 758, 759, 760, 761, 762, 763, 764, 765, 766, 770, 771, 772, 773, 774, 775, 776, 777, 780, 781, 782, 783, 784, 786, 787, 788, 789, 790, 791, 792, 793, 795, 797, 798, 799, 800, 802, 803, 806, 807, 808, 810, 811, 812, 813, 814, 815, 816, 817, 818, 819, 820, 821, 822, 823, 824, 825, 826, 827, 829, 831, 833, 834, 835, 836, 838, 839, 840, 842, 843, 844, 845, 847, 848, 849, 850, 851, 853, 854, 855, 856, 859, 860, 861, 864, 865, 866, 867, 868, 869, 870, 872, 873, 874, 875, 876, 877, 878, 879, 880, 884, 885, 886, 887, 889]
[11, 25, 27, 30, 36, 43, 44, 48, 49, 50, 59, 60, 62, 69, 84, 95, 97, 102, 107, 110, 134, 143, 158, 173, 177, 179, 182, 193, 201, 232, 234, 250, 259, 262, 263, 269, 272, 278, 279, 282, 289, 292, 301, 303, 310, 315, 331, 332, 335, 339, 340, 363, 369, 370, 373, 395, 404, 407, 408, 409, 414, 416, 419, 431, 433, 435, 451, 459, 471, 478, 479, 491, 500, 502, 503, 504, 507, 508, 517, 519, 528, 531, 533, 552, 575, 583, 597, 601, 607, 610, 632, 633, 642, 648, 652, 663, 691, 698, 712, 717, 723, 724, 738, 743, 744, 746, 759, 763, 778, 789, 793, 798, 799, 804, 841, 846, 854, 858, 866, 872, 880, 886]

[1, 2, 3, 4, 5, 9, 10, 12, 13, 15, 17, 18, 19, 20, 22, 23, 24, 26, 30, 31, 32, 34, 35, 36, 37, 38, 39, 40, 41, 42, 43, 45, 46, 47, 48, 49, 50, 51, 52, 53, 54, 55, 56, 57, 58, 59, 60, 61, 62, 64, 65, 66, 67, 68, 69, 70, 71, 72, 73, 74, 75, 76, 77, 79, 80, 81, 82, 83, 84, 86, 87, 88, 89, 90, 91, 92, 93, 94, 95, 96, 97, 100, 101, 102, 103, 104, 105, 106, 107, 108, 109, 110, 111, 112, 113, 114, 115, 117, 118, 119, 120, 121, 122, 124, 125, 126, 127, 128, 129, 130, 131, 132, 133, 134, 135, 136, 137, 138, 139, 141, 142, 143, 144, 145, 146, 147, 148, 149, 150, 151, 152, 154, 155, 156, 157, 158, 159, 160, 161, 162, 163, 164, 165, 166, 169, 170, 171, 172, 173, 174, 175, 176, 177, 178, 179, 180, 181, 183, 184, 186, 187, 188, 190, 192, 193, 194, 195, 196, 197, 198, 199, 200, 201, 202, 203, 204, 205, 206, 207, 208, 209, 211, 212, 213, 214, 215, 216, 217, 218, 219, 220, 221, 223, 224, 225, 229, 230, 231, 232, 233, 234, 235, 236, 238, 239, 240, 241, 242, 243, 244, 245, 246, 247, 249, 250, 251, 252, 253, 254, 255, 256, 257, 258, 259, 260, 261, 262, 263, 264, 265, 267, 268, 269, 270, 272, 274, 275, 276, 277, 279, 280, 281, 282, 283, 284, 285, 286, 287, 288, 289, 291, 292, 293, 295, 296, 297, 299, 300, 301, 302, 303, 304, 305, 306, 307, 308, 309, 310, 311, 312, 313, 314, 315, 316, 317, 318, 319, 320, 321, 322, 323, 325, 327, 328, 329, 330, 331, 332, 333, 334, 335, 336, 337, 338, 339, 340, 341, 342, 345, 347, 348, 349, 350, 351, 352, 353, 354, 356, 357, 358, 359, 361, 362, 363, 364, 365, 366, 367, 368, 369, 370, 371, 372, 373, 375, 376, 377, 378, 380, 382, 383, 384, 385, 386, 387, 388, 389, 390, 391, 392, 393, 394, 395, 396, 397, 399, 400, 401, 402, 403, 404, 406, 407, 408, 409, 410, 411, 412, 413, 414, 415, 416, 417, 418, 419, 420, 421, 422, 423, 424, 425, 426, 427, 428, 429, 430, 431, 432, 433, 434, 435, 436, 437, 438, 439, 441, 442, 443, 444, 445, 448, 449, 450, 451, 452, 453, 454, 455, 457, 458, 459, 461, 462, 463, 464, 465, 466, 467, 469, 470, 471, 472, 473, 475, 476, 477, 478, 479, 481, 482, 483, 484, 485, 486, 487, 488, 489, 490, 491, 492, 493, 494, 495, 496, 497, 498, 499, 502, 503, 504, 505, 506, 508, 509, 510, 511, 512, 513, 514, 515, 516, 517, 520, 521, 522, 523, 524, 525, 526, 528, 529, 530, 531, 532, 533, 535, 537, 538, 540, 541, 542, 543, 544, 545, 546, 547, 548, 549, 550, 552, 553, 554, 555, 556, 557, 558, 560, 561, 562, 564, 565, 566, 567, 568, 570, 571, 572, 573, 574, 575, 576, 577, 578, 579, 580, 581, 582, 583, 584, 585, 586, 588, 589, 590, 593, 595, 596, 597, 598, 600, 601, 602, 603, 604, 605, 606, 607, 608, 609, 610, 611, 612, 613, 614, 615, 616, 617, 618, 619, 620, 621, 624, 625, 627, 628, 629, 630, 631, 632, 633, 634, 635, 636, 637, 638, 639, 640, 641, 642, 643, 644, 645, 646, 647, 648, 649, 650, 651, 652, 653, 654, 655, 656, 657, 659, 660, 661, 662, 663, 664, 665, 666, 667, 668, 669, 670, 671, 672, 673, 674, 675, 676, 677, 678, 679, 680, 681, 682, 683, 684, 685, 686, 688, 689, 690, 691, 692, 693, 694, 695, 696, 697, 698, 699, 700, 702, 704, 706, 707, 708, 709, 710, 712, 713, 714, 715, 716, 717, 718, 720, 721, 722, 723, 724, 725, 726, 727, 728, 731, 733, 734, 735, 736, 737, 738, 739, 740, 741, 742, 743, 744, 745, 746, 747, 748, 749, 750, 751, 752, 753, 754, 755, 756, 757, 758, 759, 760, 761, 762, 763, 764, 765, 766, 767, 768, 769, 770, 771, 772, 773, 774, 775, 776, 777, 778, 780, 781, 782, 783, 784, 786, 787, 788, 789, 790, 791, 792, 793, 794, 795, 796, 797, 798, 799, 800, 801, 802, 803, 804, 806, 807, 808, 809, 810, 811, 812, 813, 814, 815, 816, 817, 818, 819, 820, 821, 822, 823, 824, 825, 826, 827, 828, 829, 830, 831, 833, 834, 835, 836, 837, 838, 839, 840, 842, 843, 844, 845, 847, 848, 849, 850, 851, 853, 854, 855, 856, 859, 860, 861, 864, 865, 866, 867, 868, 869, 870, 872, 873, 874, 875, 876, 877, 878, 879, 880, 881, 882, 883, 884, 885, 886, 887, 888, 889]
[11, 25, 27, 30, 36, 43, 44, 48, 49, 50, 59, 60, 62, 69, 84, 95, 97, 102, 107, 110, 134, 143, 158, 173, 177, 179, 182, 193, 201, 232, 234, 250, 259, 262, 263, 269, 272, 278, 279, 282, 289, 292, 301, 303, 310, 315, 331, 332, 335, 339, 340, 363, 369, 370, 373, 395, 404, 407, 408, 409, 414, 416, 419, 431, 433, 435, 451, 459, 471, 478, 479, 491, 500, 502, 503, 504, 507, 508, 517, 519, 528, 531, 533, 552, 575, 583, 597, 601, 607, 610, 632, 633, 642, 648, 652, 663, 691, 698, 712, 717, 723, 724, 738, 743, 744, 746, 759, 763, 778, 789, 793, 798, 799, 804, 841, 846, 854, 858, 866, 872, 880, 886]

