[11, 26, 102, 107, 158, 192, 251, 260, 263, 276, 290, 350, 464, 508, 583, 606, 623, 689, 727, 747, 853, 885]
[117, 224, 283, 294, 305, 327, 381, 384, 425, 436, 463, 490, 557, 572, 586, 628, 716, 779, 781, 782, 807, 881]

[11, 26, 102, 107, 158, 192, 251, 260, 263, 276, 290, 350, 464, 508, 583, 606, 623, 689, 727, 747, 853, 885]
[20, 40, 47, 49, 52, 55, 61, 72, 99, 112, 115, 117, 119, 133, 139, 141, 151, 157, 161, 174, 178, 186, 189, 200, 213, 224, 232, 247, 269, 270, 271, 283, 293, 294, 305, 312, 313, 314, 317, 319, 327, 331, 336, 338, 363, 369, 370, 372, 380, 381, 382, 384, 386, 389, 392, 395, 423, 425, 436, 447, 458, 461, 463, 465, 466, 469, 477, 484, 486, 490, 495, 501, 521, 528, 530, 544, 549, 553, 557, 572, 586, 593, 615, 628, 660, 666, 667, 677, 680, 684, 685, 701, 715, 716, 730, 736, 740, 745, 750, 753, 754, 779, 781, 782, 786, 787, 794, 807, 810, 821, 824, 826, 833, 840, 842, 855, 872, 874, 875, 881, 883, 888]

[1, 2, 4, 11, 26, 41, 42, 60, 95, 102, 105, 107, 118, 140, 141, 143, 150, 158, 170, 181, 186, 190, 192, 202, 203, 214, 221, 243, 250, 251, 260, 263, 264, 276, 278, 283, 286, 290, 312, 316, 324, 334, 336, 338, 349, 350, 359, 364, 365, 374, 380, 386, 401, 428, 437, 464, 465, 471, 481, 482, 484, 507, 508, 511, 519, 526, 535, 553, 561, 580, 583, 584, 603, 606, 623, 635, 643, 652, 660, 669, 680, 681, 688, 689, 714, 723, 727, 747, 750, 775, 782, 802, 817, 820, 853, 856, 885]
[20, 40, 47, 49, 52, 55, 61, 72, 99, 112, 115, 117, 119, 133, 139, 141, 151, 157, 161, 174, 178, 186, 189, 200, 213, 224, 232, 247, 269, 270, 271, 283, 293, 294, 305, 312, 313, 314, 317, 319, 327, 331, 336, 338, 363, 369, 370, 372, 380, 381, 382, 384, 386, 389, 392, 395, 423, 425, 436, 447, 458, 461, 463, 465, 466, 469, 477, 484, 486, 490, 495, 501, 521, 528, 530, 544, 549, 553, 557, 572, 586, 593, 615, 628, 660, 666, 667, 677, 680, 684, 685, 701, 715, 716, 730, 736, 740, 745, 750, 753, 754, 779, 781, 782, 786, 787, 794, 807, 810, 821, 824, 826, 833, 840, 842, 855, 872, 874, 875, 881, 883, 888]

[1, 2, 4, 6, 11, 16, 26, 27, 31, 34, 41, 42, 58, 60, 61, 65, 87, 95, 102, 105, 107, 114, 118, 119, 125, 137, 140, 141, 143, 150, 158, 161, 162, 170, 172, 181, 186, 190, 192, 196, 197, 202, 203, 208, 214, 215, 217, 218, 221, 230, 243, 250, 251, 256, 257, 260, 263, 264, 276, 278, 283, 286, 289, 290, 298, 312, 316, 318, 324, 334, 336, 338, 349, 350, 352, 359, 364, 365, 371, 373, 374, 375, 379, 380, 386, 401, 408, 417, 428, 437, 438, 444, 454, 464, 465, 471, 477, 481, 482, 484, 489, 507, 508, 511, 515, 517, 518, 519, 526, 535, 544, 553, 554, 561, 569, 580, 581, 583, 584, 594, 603, 606, 611, 614, 619, 623, 635, 642, 643, 652, 660, 664, 666, 669, 676, 678, 679, 680, 681, 688, 689, 708, 714, 720, 723, 727, 728, 738, 747, 748, 750, 755, 761, 763, 764, 769, 775, 777, 782, 794, 802, 809, 814, 817, 820, 853, 855, 856, 857, 861, 866, 885]
[20, 40, 47, 49, 52, 55, 61, 72, 99, 112, 115, 117, 119, 133, 139, 141, 151, 157, 161, 174, 178, 186, 189, 200, 213, 224, 232, 247, 269, 270, 271, 283, 293, 294, 305, 312, 313, 314, 317, 319, 327, 331, 336, 338, 363, 369, 370, 372, 380, 381, 382, 384, 386, 389, 392, 395, 423, 425, 436, 447, 458, 461, 463, 465, 466, 469, 477, 484, 486, 490, 495, 501, 521, 528, 530, 544, 549, 553, 557, 572, 586, 593, 615, 628, 660, 666, 667, 677, 680, 684, 685, 701, 715, 716, 730, 736, 740, 745, 750, 753, 754, 779, 781, 782, 786, 787, 794, 807, 810, 821, 824, 826, 833, 840, 842, 855, 872, 874, 875, 881, 883, 888]

[1, 2, 4, 6, 11, 16, 17, 19, 26, 27, 31, 34, 36, 41, 42, 58, 60, 61, 65, 71, 82, 87, 95, 102, 103, 105, 107, 112, 114, 118, 119, 122, 125, 126, 135, 136, 137, 140, 141, 143, 145, 147, 149, 150, 152, 158, 159, 161, 162, 168, 170, 172, 179, 181, 185, 186, 190, 192, 195, 196, 197, 202, 203, 204, 208, 211, 214, 215, 217, 218, 221, 230, 237, 243, 250, 251, 255, 256, 257, 260, 263, 264, 268, 276, 278, 283, 284, 285, 286, 289, 290, 292, 298, 312, 316, 318, 323, 324, 334, 336, 338, 339, 342, 349, 350, 352, 359, 363, 364, 365, 367, 371, 373, 374, 375, 379, 380, 386, 387, 401, 408, 412, 413, 417, 428, 435, 437, 438, 440, 444, 446, 449, 450, 454, 457, 461, 464, 465, 471, 477, 481, 482, 484, 489, 492, 497, 502, 507, 508, 511, 515, 517, 518, 519, 520, 526, 535, 544, 553, 554, 555, 561, 563, 567, 569, 580, 581, 583, 584, 594, 595, 603, 604, 606, 610, 611, 614, 617, 619, 623, 635, 642, 643, 647, 649, 652, 660, 664, 666, 669, 676, 677, 678, 679, 680, 681, 682, 688, 689, 697, 700, 707, 708, 714, 720, 723, 727, 728, 738, 742, 743, 745, 747, 748, 749, 750, 754, 755, 761, 763, 764, 769, 775, 777, 780, 782, 794, 802, 804, 809, 811, 814, 817, 820, 823, 834, 837, 853, 855, 856, 857, 861, 866, 876, 878, 882, 885]
[20, 40, 47, 49, 52, 55, 61, 72, 99, 112, 115, 117, 119, 133, 139, 141, 151, 157, 161, 174, 178, 186, 189, 200, 213, 224, 232, 247, 269, 270, 271, 283, 293, 294, 305, 312, 313, 314, 317, 319, 327, 331, 336, 338, 363, 369, 370, 372, 380, 381, 382, 384, 386, 389, 392, 395, 423, 425, 436, 447, 458, 461, 463, 465, 466, 469, 477, 484, 486, 490, 495, 501, 521, 528, 530, 544, 549, 553, 557, 572, 586, 593, 615, 628, 660, 666, 667, 677, 680, 684, 685, 701, 715, 716, 730, 736, 740, 745, 750, 753, 754, 779, 781, 782, 786, 787, 794, 807, 810, 821, 824, 826, 833, 840, 842, 855, 872, 874, 875, 881, 883, 888]

[1, 2, 4, 6, 11, 12, 14, 16, 17, 19, 22, 26, 27, 31, 33, 34, 36, 41, 42, 53, 54, 56, 58, 59, 60, 61, 65, 67, 71, 78, 82, 87, 90, 95, 102, 103, 105, 106, 107, 112, 114, 118, 119, 122, 125, 126, 129, 130, 135, 136, 137, 140, 141, 143, 145, 146, 147, 149, 150, 152, 158, 159, 161, 162, 168, 170, 172, 177, 179, 181, 184, 185, 186, 190, 192, 194, 195, 196, 197, 202, 203, 204, 208, 211, 214, 215, 217, 218, 221, 223, 224, 227, 229, 230, 237, 243, 247, 250, 251, 255, 256, 257, 260, 263, 264, 268, 276, 278, 283, 284, 285, 286, 289, 290, 292, 298, 312, 316, 318, 323, 324, 326, 327, 334, 336, 338, 339, 342, 343, 349, 350, 352, 359, 360, 363, 364, 365, 366, 367, 371, 373, 374, 375, 379, 380, 386, 387, 393, 395, 396, 401, 408, 410, 412, 413, 417, 428, 435, 437, 438, 440, 442, 444, 446, 449, 450, 454, 457, 460, 461, 464, 465, 467, 468, 471, 477, 478, 480, 481, 482, 484, 489, 492, 497, 502, 503, 504, 506, 507, 508, 511, 513, 515, 517, 518, 519, 520, 525, 526, 531, 535, 544, 553, 554, 555, 557, 560, 561, 563, 565, 567, 569, 571, 580, 581, 582, 583, 584, 585, 594, 595, 601, 603, 604, 606, 610, 611, 614, 617, 619, 623, 635, 642, 643, 644, 647, 649, 652, 653, 660, 663, 664, 666, 667, 668, 669, 676, 677, 678, 679, 680, 681, 682, 687, 688, 689, 694, 696, 697, 700, 707, 708, 714, 715, 720, 723, 727, 728, 737, 738, 742, 743, 745, 747, 748, 749, 750, 754, 755, 759, 761, 763, 764, 769, 775, 777, 779, 780, 782, 789, 794, 799, 802, 804, 805, 809, 811, 814, 816, 817, 820, 823, 825, 832, 833, 834, 835, 837, 841, 848, 853, 855, 856, 857, 861, 866, 873, 876, 878, 882, 883, 885]
[20, 40, 47, 49, 52, 55, 61, 72, 99, 112, 115, 117, 119, 133, 139, 141, 151, 157, 161, 174, 178, 186, 189, 200, 213, 224, 232, 247, 269, 270, 271, 283, 293, 294, 305, 312, 313, 314, 317, 319, 327, 331, 336, 338, 363, 369, 370, 372, 380, 381, 382, 384, 386, 389, 392, 395, 423, 425, 436, 447, 458, 461, 463, 465, 466, 469, 477, 484, 486, 490, 495, 501, 521, 528, 530, 544, 549, 553, 557, 572, 586, 593, 615, 628, 660, 666, 667, 677, 680, 684, 685, 701, 715, 716, 730, 736, 740, 745, 750, 753, 754, 779, 781, 782, 786, 787, 794, 807, 810, 821, 824, 826, 833, 840, 842, 855, 872, 874, 875, 881, 883, 888]

[1, 2, 4, 6, 7, 11, 12, 14, 16, 17, 19, 20, 22, 26, 27, 31, 33, 34, 36, 37, 41, 42, 49, 53, 54, 56, 58, 59, 60, 61, 65, 67, 70, 71, 76, 78, 82, 87, 90, 91, 95, 102, 103, 104, 105, 106, 107, 108, 112, 114, 118, 119, 122, 125, 126, 129, 130, 135, 136, 137, 140, 141, 143, 145, 146, 147, 149, 150, 152, 158, 159, 161, 162, 164, 168, 170, 172, 173, 177, 178, 179, 181, 184, 185, 186, 188, 190, 192, 194, 195, 196, 197, 202, 203, 204, 208, 211, 213, 214, 215, 217, 218, 221, 223, 224, 227, 229, 230, 236, 237, 241, 242, 243, 247, 250, 251, 255, 256, 257, 258, 260, 263, 264, 266, 268, 271, 274, 276, 278, 279, 283, 284, 285, 286, 289, 290, 292, 298, 306, 312, 315, 316, 318, 323, 324, 326, 327, 329, 333, 334, 335, 336, 337, 338, 339, 342, 343, 349, 350, 352, 354, 358, 359, 360, 363, 364, 365, 366, 367, 371, 373, 374, 375, 379, 380, 381, 386, 387, 389, 393, 395, 396, 397, 401, 405, 408, 410, 412, 413, 417, 428, 432, 435, 437, 438, 440, 441, 442, 444, 446, 449, 450, 452, 453, 454, 457, 460, 461, 463, 464, 465, 467, 468, 471, 472, 477, 478, 480, 481, 482, 483, 484, 489, 491, 492, 497, 502, 503, 504, 506, 507, 508, 510, 511, 512, 513, 515, 517, 518, 519, 520, 522, 525, 526, 531, 535, 544, 546, 547, 548, 549, 553, 554, 555, 557, 560, 561, 563, 565, 567, 569, 571, 575, 577, 580, 581, 582, 583, 584, 585, 594, 595, 601, 602, 603, 604, 606, 609, 610, 611, 614, 617, 619, 620, 621, 623, 635, 637, 642, 643, 644, 645, 647, 649, 652, 653, 659, 660, 661, 663, 664, 666, 667, 668, 669, 673, 676, 677, 678, 679, 680, 681, 682, 687, 688, 689, 691, 694, 696, 697, 700, 707, 708, 714, 715, 717, 720, 723, 726, 727, 728, 731, 733, 737, 738, 742, 743, 745, 747, 748, 749, 750, 754, 755, 756, 759, 761, 763, 764, 769, 771, 775, 777, 779, 780, 782, 789, 794, 799, 802, 804, 805, 807, 809, 811, 814, 816, 817, 820, 821, 823, 824, 825, 831, 832, 833, 834, 835, 837, 841, 845, 848, 853, 855, 856, 857, 861, 862, 866, 871, 873, 876, 878, 880, 882, 883, 885]
[20, 40, 47, 49, 52, 55, 61, 72, 99, 112, 115, 117, 119, 133, 139, 141, 151, 157, 161, 174, 178, 186, 189, 200, 213, 224, 232, 247, 269, 270, 271, 283, 293, 294, 305, 312, 313, 314, 317, 319, 327, 331, 336, 338, 363, 369, 370, 372, 380, 381, 382, 384, 386, 389, 392, 395, 423, 425, 436, 447, 458, 461, 463, 465, 466, 469, 477, 484, 486, 490, 495, 501, 521, 528, 530, 544, 549, 553, 557, 572, 586, 593, 615, 628, 660, 666, 667, 677, 680, 684, 685, 701, 715, 716, 730, 736, 740, 745, 750, 753, 754, 779, 781, 782, 786, 787, 794, 807, 810, 821, 824, 826, 833, 840, 842, 855, 872, 874, 875, 881, 883, 888]

[1, 2, 4, 5, 6, 7, 11, 12, 14, 16, 17, 19, 20, 22, 26, 27, 30, 31, 33, 34, 36, 37, 39, 41, 42, 49, 53, 54, 56, 58, 59, 60, 61, 62, 63, 65, 67, 70, 71, 72, 76, 78, 82, 87, 90, 91, 93, 95, 100, 102, 103, 104, 105, 106, 107, 108, 112, 114, 116, 118, 119, 122, 124, 125, 126, 129, 130, 135, 136, 137, 140, 141, 143, 144, 145, 146, 147, 149, 150, 152, 155, 157, 158, 159, 161, 162, 164, 167, 168, 170, 172, 173, 177, 178, 179, 181, 184, 185, 186, 188, 190, 191, 192, 193, 194, 195, 196, 197, 202, 203, 204, 207, 208, 211, 213, 214, 215, 217, 218, 221, 223, 224, 227, 228, 229, 230, 233, 236, 237, 241, 242, 243, 247, 250, 251, 255, 256, 257, 258, 260, 263, 264, 266, 268, 271, 274, 276, 278, 279, 281, 283, 284, 285, 286, 289, 290, 292, 298, 304, 306, 307, 312, 313, 315, 316, 318, 321, 323, 324, 326, 327, 329, 333, 334, 335, 336, 337, 338, 339, 340, 342, 343, 344, 349, 350, 352, 354, 358, 359, 360, 363, 364, 365, 366, 367, 371, 373, 374, 375, 378, 379, 380, 381, 383, 386, 387, 389, 390, 393, 394, 395, 396, 397, 401, 405, 406, 408, 410, 411, 412, 413, 417, 425, 428, 432, 435, 437, 438, 440, 441, 442, 444, 446, 449, 450, 452, 453, 454, 457, 458, 460, 461, 462, 463, 464, 465, 467, 468, 471, 472, 475, 477, 478, 479, 480, 481, 482, 483, 484, 489, 491, 492, 493, 497, 499, 502, 503, 504, 506, 507, 508, 509, 510, 511, 512, 513, 515, 517, 518, 519, 520, 522, 523, 525, 526, 530, 531, 534, 535, 536, 541, 544, 545, 546, 547, 548, 549, 553, 554, 555, 557, 560, 561, 563, 565, 567, 568, 569, 570, 571, 575, 577, 578, 580, 581, 582, 583, 584, 585, 589, 594, 595, 596, 601, 602, 603, 604, 605, 606, 609, 610, 611, 613, 614, 617, 618, 619, 620, 621, 623, 625, 630, 635, 637, 639, 641, 642, 643, 644, 645, 647, 649, 652, 653, 656, 659, 660, 661, 663, 664, 666, 667, 668, 669, 673, 676, 677, 678, 679, 680, 681, 682, 687, 688, 689, 691, 694, 696, 697, 700, 703, 705, 707, 708, 714, 715, 716, 717, 720, 723, 726, 727, 728, 731, 733, 735, 737, 738, 739, 742, 743, 745, 747, 748, 749, 750, 754, 755, 756, 759, 760, 761, 762, 763, 764, 769, 770, 771, 775, 777, 779, 780, 782, 787, 789, 794, 795, 799, 800, 801, 802, 804, 805, 807, 809, 810, 811, 814, 816, 817, 820, 821, 823, 824, 825, 831, 832, 833, 834, 835, 837, 841, 842, 845, 847, 848, 853, 854, 855, 856, 857, 861, 862, 866, 871, 873, 876, 878, 880, 882, 883, 885]
[20, 40, 47, 49, 52, 55, 61, 72, 99, 112, 115, 117, 119, 133, 139, 141, 151, 157, 161, 174, 178, 186, 189, 200, 213, 224, 232, 247, 269, 270, 271, 283, 293, 294, 305, 312, 313, 314, 317, 319, 327, 331, 336, 338, 363, 369, 370, 372, 380, 381, 382, 384, 386, 389, 392, 395, 423, 425, 436, 447, 458, 461, 463, 465, 466, 469, 477, 484, 486, 490, 495, 501, 521, 528, 530, 544, 549, 553, 557, 572, 586, 593, 615, 628, 660, 666, 667, 677, 680, 684, 685, 701, 715, 716, 730, 736, 740, 745, 750, 753, 754, 779, 781, 782, 786, 787, 794, 807, 810, 821, 824, 826, 833, 840, 842, 855, 872, 874, 875, 881, 883, 888]

[1, 2, 4, 5, 6, 7, 11, 12, 13, 14, 15, 16, 17, 18, 19, 20, 21, 22, 26, 27, 30, 31, 33, 34, 36, 37, 39, 41, 42, 49, 51, 53, 54, 56, 58, 59, 60, 61, 62, 63, 65, 67, 68, 69, 70, 71, 72, 73, 76, 78, 79, 82, 84, 87, 88, 90, 91, 93, 95, 100, 102, 103, 104, 105, 106, 107, 108, 109, 112, 114, 115, 116, 118, 119, 122, 124, 125, 126, 129, 130, 131, 133, 135, 136, 137, 138, 140, 141, 143, 144, 145, 146, 147, 149, 150, 152, 155, 157, 158, 159, 161, 162, 164, 167, 168, 169, 170, 172, 173, 177, 178, 179, 181, 184, 185, 186, 188, 190, 191, 192, 193, 194, 195, 196, 197, 202, 203, 204, 206, 207, 208, 211, 212, 213, 214, 215, 217, 218, 221, 222, 223, 224, 227, 228, 229, 230, 231, 233, 234, 235, 236, 237, 239, 241, 242, 243, 247, 248, 250, 251, 255, 256, 257, 258, 260, 263, 264, 266, 268, 270, 271, 274, 276, 278, 279, 281, 283, 284, 285, 286, 288, 289, 290, 292, 295, 297, 298, 299, 304, 306, 307, 308, 312, 313, 315, 316, 318, 320, 321, 323, 324, 326, 327, 329, 333, 334, 335, 336, 337, 338, 339, 340, 342, 343, 344, 346, 347, 349, 350, 352, 354, 357, 358, 359, 360, 363, 364, 365, 366, 367, 371, 373, 374, 375, 376, 378, 379, 380, 381, 383, 386, 387, 389, 390, 392, 393, 394, 395, 396, 397, 400, 401, 402, 405, 406, 407, 408, 410, 411, 412, 413, 417, 418, 419, 424, 425, 428, 432, 435, 437, 438, 440, 441, 442, 444, 446, 449, 450, 451, 452, 453, 454, 457, 458, 460, 461, 462, 463, 464, 465, 467, 468, 471, 472, 475, 476, 477, 478, 479, 480, 481, 482, 483, 484, 489, 491, 492, 493, 494, 496, 497, 499, 502, 503, 504, 506, 507, 508, 509, 510, 511, 512, 513, 514, 515, 517, 518, 519, 520, 522, 523, 525, 526, 530, 531, 534, 535, 536, 538, 541, 544, 545, 546, 547, 548, 549, 550, 553, 554, 555, 556, 557, 560, 561, 563, 565, 566, 567, 568, 569, 570, 571, 572, 575, 577, 578, 580, 581, 582, 583, 584, 585, 587, 589, 594, 595, 596, 598, 599, 601, 602, 603, 604, 605, 606, 609, 610, 611, 612, 613, 614, 617, 618, 619, 620, 621, 623, 625, 630, 632, 635, 637, 639, 641, 642, 643, 644, 645, 647, 649, 652, 653, 656, 659, 660, 661, 663, 664, 666, 667, 668, 669, 670, 673, 676, 677, 678, 679, 680, 681, 682, 687, 688, 689, 690, 691, 694, 696, 697, 700, 703, 705, 707, 708, 713, 714, 715, 716, 717, 718, 720, 723, 726, 727, 728, 730, 731, 733, 735, 737, 738, 739, 741, 742, 743, 745, 747, 748, 749, 750, 753, 754, 755, 756, 759, 760, 761, 762, 763, 764, 766, 767, 769, 770, 771, 775, 777, 779, 780, 782, 786, 787, 789, 790, 792, 793, 794, 795, 799, 800, 801, 802, 803, 804, 805, 807, 809, 810, 811, 814, 816, 817, 820, 821, 823, 824, 825, 827, 828, 831, 832, 833, 834, 835, 837, 841, 842, 844, 845, 847, 848, 853, 854, 855, 856, 857, 861, 862, 866, 868, 869, 870, 871, 872, 873, 875, 876, 878, 880, 882, 883, 884, 885, 886, 889]
[20, 40, 47, 49, 52, 55, 61, 72, 99, 112, 115, 117, 119, 133, 139, 141, 151, 157, 161, 174, 178, 186, 189, 200, 213, 224, 232, 247, 269, 270, 271, 283, 293, 294, 305, 312, 313, 314, 317, 319, 327, 331, 336, 338, 363, 369, 370, 372, 380, 381, 382, 384, 386, 389, 392, 395, 423, 425, 436, 447, 458, 461, 463, 465, 466, 469, 477, 484, 486, 490, 495, 501, 521, 528, 530, 544, 549, 553, 557, 572, 586, 593, 615, 628, 660, 666, 667, 677, 680, 684, 685, 701, 715, 716, 730, 736, 740, 745, 750, 753, 754, 779, 781, 782, 786, 787, 794, 807, 810, 821, 824, 826, 833, 840, 842, 855, 872, 874, 875, 881, 883, 888]

[1, 2, 4, 5, 6, 7, 11, 12, 13, 14, 15, 16, 17, 18, 19, 20, 21, 22, 23, 24, 25, 26, 27, 30, 31, 33, 34, 35, 36, 37, 38, 39, 41, 42, 49, 51, 52, 53, 54, 56, 57, 58, 59, 60, 61, 62, 63, 64, 65, 66, 67, 68, 69, 70, 71, 72, 73, 74, 76, 78, 79, 82, 84, 87, 88, 89, 90, 91, 93, 95, 100, 102, 103, 104, 105, 106, 107, 108, 109, 111, 112, 114, 115, 116, 118, 119, 122, 124, 125, 126, 128, 129, 130, 131, 133, 135, 136, 137, 138, 140, 141, 143, 144, 145, 146, 147, 148, 149, 150, 152, 153, 155, 156, 157, 158, 159, 161, 162, 164, 167, 168, 169, 170, 172, 173, 175, 177, 178, 179, 181, 184, 185, 186, 188, 190, 191, 192, 193, 194, 195, 196, 197, 202, 203, 204, 206, 207, 208, 209, 211, 212, 213, 214, 215, 217, 218, 220, 221, 222, 223, 224, 225, 226, 227, 228, 229, 230, 231, 233, 234, 235, 236, 237, 238, 239, 241, 242, 243, 244, 245, 247, 248, 250, 251, 255, 256, 257, 258, 259, 260, 263, 264, 266, 268, 269, 270, 271, 274, 276, 278, 279, 281, 283, 284, 285, 286, 288, 289, 290, 291, 292, 295, 297, 298, 299, 301, 304, 306, 307, 308, 309, 312, 313, 314, 315, 316, 317, 318, 320, 321, 323, 324, 325, 326, 327, 329, 333, 334, 335, 336, 337, 338, 339, 340, 342, 343, 344, 346, 347, 349, 350, 352, 354, 357, 358, 359, 360, 363, 364, 365, 366, 367, 371, 373, 374, 375, 376, 378, 379, 380, 381, 383, 385, 386, 387, 389, 390, 391, 392, 393, 394, 395, 396, 397, 400, 401, 402, 404, 405, 406, 407, 408, 409, 410, 411, 412, 413, 415, 417, 418, 419, 422, 423, 424, 425, 427, 428, 429, 432, 435, 437, 438, 440, 441, 442, 443, 444, 446, 448, 449, 450, 451, 452, 453, 454, 456, 457, 458, 460, 461, 462, 463, 464, 465, 467, 468, 471, 472, 475, 476, 477, 478, 479, 480, 481, 482, 483, 484, 489, 490, 491, 492, 493, 494, 496, 497, 498, 499, 500, 502, 503, 504, 505, 506, 507, 508, 509, 510, 511, 512, 513, 514, 515, 517, 518, 519, 520, 522, 523, 524, 525, 526, 528, 530, 531, 534, 535, 536, 538, 541, 542, 544, 545, 546, 547, 548, 549, 550, 551, 553, 554, 555, 556, 557, 560, 561, 562, 563, 564, 565, 566, 567, 568, 569, 570, 571, 572, 573, 574, 575, 577, 578, 580, 581, 582, 583, 584, 585, 587, 589, 594, 595, 596, 598, 599, 601, 602, 603, 604, 605, 606, 607, 609, 610, 611, 612, 613, 614, 616, 617, 618, 619, 620, 621, 622, 623, 625, 630, 632, 633, 635, 637, 639, 641, 642, 643, 644, 645, 647, 649, 650, 652, 653, 656, 659, 660, 661, 663, 664, 665, 666, 667, 668, 669, 670, 672, 673, 676, 677, 678, 679, 680, 681, 682, 687, 688, 689, 690, 691, 694, 696, 697, 698, 700, 703, 705, 707, 708, 709, 711, 713, 714, 715, 716, 717, 718, 719, 720, 723, 726, 727, 728, 730, 731, 733, 735, 737, 738, 739, 741, 742, 743, 745, 747, 748, 749, 750, 753, 754, 755, 756, 757, 759, 760, 761, 762, 763, 764, 765, 766, 767, 769, 770, 771, 772, 775, 777, 779, 780, 782, 786, 787, 789, 790, 791, 792, 793, 794, 795, 796, 799, 800, 801, 802, 803, 804, 805, 807, 809, 810, 811, 814, 816, 817, 820, 821, 823, 824, 825, 826, 827, 828, 830, 831, 832, 833, 834, 835, 837, 838, 841, 842, 844, 845, 847, 848, 852, 853, 854, 855, 856, 857, 861, 862, 866, 868, 869, 870, 871, 872, 873, 875, 876, 877, 878, 880, 882, 883, 884, 885, 886, 889]
[20, 40, 47, 49, 52, 55, 61, 72, 99, 112, 115, 117, 119, 133, 139, 141, 151, 157, 161, 174, 178, 186, 189, 200, 213, 224, 232, 247, 269, 270, 271, 283, 293, 294, 305, 312, 313, 314, 317, 319, 327, 331, 336, 338, 363, 369, 370, 372, 380, 381, 382, 384, 386, 389, 392, 395, 423, 425, 436, 447, 458, 461, 463, 465, 466, 469, 477, 484, 486, 490, 495, 501, 521, 528, 530, 544, 549, 553, 557, 572, 586, 593, 615, 628, 660, 666, 667, 677, 680, 684, 685, 701, 715, 716, 730, 736, 740, 745, 750, 753, 754, 779, 781, 782, 786, 787, 794, 807, 810, 821, 824, 826, 833, 840, 842, 855, 872, 874, 875, 881, 883, 888]

[0, 1, 2, 4, 5, 6, 7, 9, 11, 12, 13, 14, 15, 16, 17, 18, 19, 20, 21, 22, 23, 24, 25, 26, 27, 30, 31, 32, 33, 34, 35, 36, 37, 38, 39, 41, 42, 49, 51, 52, 53, 54, 56, 57, 58, 59, 60, 61, 62, 63, 64, 65, 66, 67, 68, 69, 70, 71, 72, 73, 74, 76, 78, 79, 82, 83, 84, 87, 88, 89, 90, 91, 92, 93, 95, 97, 98, 100, 102, 103, 104, 105, 106, 107, 108, 109, 110, 111, 112, 113, 114, 115, 116, 117, 118, 119, 122, 124, 125, 126, 128, 129, 130, 131, 132, 133, 135, 136, 137, 138, 139, 140, 141, 142, 143, 144, 145, 146, 147, 148, 149, 150, 152, 153, 155, 156, 157, 158, 159, 161, 162, 164, 167, 168, 169, 170, 172, 173, 175, 176, 177, 178, 179, 180, 181, 182, 184, 185, 186, 188, 189, 190, 191, 192, 193, 194, 195, 196, 197, 199, 201, 202, 203, 204, 206, 207, 208, 209, 211, 212, 213, 214, 215, 217, 218, 220, 221, 222, 223, 224, 225, 226, 227, 228, 229, 230, 231, 232, 233, 234, 235, 236, 237, 238, 239, 240, 241, 242, 243, 244, 245, 247, 248, 249, 250, 251, 252, 255, 256, 257, 258, 259, 260, 263, 264, 265, 266, 268, 269, 270, 271, 274, 276, 277, 278, 279, 281, 283, 284, 285, 286, 288, 289, 290, 291, 292, 293, 295, 297, 298, 299, 301, 304, 305, 306, 307, 308, 309, 312, 313, 314, 315, 316, 317, 318, 320, 321, 322, 323, 324, 325, 326, 327, 329, 332, 333, 334, 335, 336, 337, 338, 339, 340, 342, 343, 344, 346, 347, 349, 350, 352, 354, 357, 358, 359, 360, 361, 363, 364, 365, 366, 367, 369, 370, 371, 373, 374, 375, 376, 378, 379, 380, 381, 383, 385, 386, 387, 389, 390, 391, 392, 393, 394, 395, 396, 397, 400, 401, 402, 403, 404, 405, 406, 407, 408, 409, 410, 411, 412, 413, 415, 417, 418, 419, 420, 422, 423, 424, 425, 427, 428, 429, 430, 431, 432, 434, 435, 436, 437, 438, 439, 440, 441, 442, 443, 444, 445, 446, 448, 449, 450, 451, 452, 453, 454, 455, 456, 457, 458, 460, 461, 462, 463, 464, 465, 467, 468, 470, 471, 472, 475, 476, 477, 478, 479, 480, 481, 482, 483, 484, 487, 489, 490, 491, 492, 493, 494, 496, 497, 498, 499, 500, 502, 503, 504, 505, 506, 507, 508, 509, 510, 511, 512, 513, 514, 515, 516, 517, 518, 519, 520, 521, 522, 523, 524, 525, 526, 528, 530, 531, 534, 535, 536, 538, 539, 541, 542, 544, 545, 546, 547, 548, 549, 550, 551, 553, 554, 555, 556, 557, 560, 561, 562, 563, 564, 565, 566, 567, 568, 569, 570, 571, 572, 573, 574, 575, 577, 578, 580, 581, 582, 583, 584, 585, 587, 589, 590, 591, 593, 594, 595, 596, 598, 599, 600, 601, 602, 603, 604, 605, 606, 607, 609, 610, 611, 612, 613, 614, 615, 616, 617, 618, 619, 620, 621, 622, 623, 625, 627, 629, 630, 631, 632, 633, 635, 636, 637, 639, 641, 642, 643, 644, 645, 647, 649, 650, 652, 653, 656, 657, 659, 660, 661, 663, 664, 665, 666, 667, 668, 669, 670, 672, 673, 676, 677, 678, 679, 680, 681, 682, 683, 687, 688, 689, 690, 691, 694, 695, 696, 697, 698, 700, 701, 702, 703, 705, 707, 708, 709, 711, 713, 714, 715, 716, 717, 718, 719, 720, 721, 723, 724, 725, 726, 727, 728, 730, 731, 733, 735, 737, 738, 739, 741, 742, 743, 744, 745, 747, 748, 749, 750, 753, 754, 755, 756, 757, 758, 759, 760, 761, 762, 763, 764, 765, 766, 767, 769, 770, 771, 772, 775, 776, 777, 779, 780, 781, 782, 785, 786, 787, 789, 790, 791, 792, 793, 794, 795, 796, 797, 799, 800, 801, 802, 803, 804, 805, 806, 807, 809, 810, 811, 813, 814, 816, 817, 820, 821, 823, 824, 825, 826, 827, 828, 830, 831, 832, 833, 834, 835, 837, 838, 841, 842, 844, 845, 846, 847, 848, 852, 853, 854, 855, 856, 857, 858, 861, 862, 863, 866, 868, 869, 870, 871, 872, 873, 875, 876, 877, 878, 879, 880, 882, 883, 884, 885, 886, 889]
[20, 40, 47, 49, 52, 55, 61, 72, 99, 112, 115, 117, 119, 133, 139, 141, 151, 157, 161, 174, 178, 186, 189, 200, 213, 224, 232, 247, 269, 270, 271, 283, 293, 294, 305, 312, 313, 314, 317, 319, 327, 331, 336, 338, 363, 369, 370, 372, 380, 381, 382, 384, 386, 389, 392, 395, 423, 425, 436, 447, 458, 461, 463, 465, 466, 469, 477, 484, 486, 490, 495, 501, 521, 528, 530, 544, 549, 553, 557, 572, 586, 593, 615, 628, 660, 666, 667, 677, 680, 684, 685, 701, 715, 716, 730, 736, 740, 745, 750, 753, 754, 779, 781, 782, 786, 787, 794, 807, 810, 821, 824, 826, 833, 840, 842, 855, 872, 874, 875, 881, 883, 888]

[0, 1, 2, 4, 5, 6, 7, 9, 10, 11, 12, 13, 14, 15, 16, 17, 18, 19, 20, 21, 22, 23, 24, 25, 26, 27, 28, 29, 30, 31, 32, 33, 34, 35, 36, 37, 38, 39, 41, 42, 47, 48, 49, 51, 52, 53, 54, 56, 57, 58, 59, 60, 61, 62, 63, 64, 65, 66, 67, 68, 69, 70, 71, 72, 73, 74, 76, 77, 78, 79, 80, 82, 83, 84, 87, 88, 89, 90, 91, 92, 93, 94, 95, 97, 98, 99, 100, 101, 102, 103, 104, 105, 106, 107, 108, 109, 110, 111, 112, 113, 114, 115, 116, 117, 118, 119, 120, 122, 124, 125, 126, 128, 129, 130, 131, 132, 133, 134, 135, 136, 137, 138, 139, 140, 141, 142, 143, 144, 145, 146, 147, 148, 149, 150, 152, 153, 154, 155, 156, 157, 158, 159, 161, 162, 163, 164, 167, 168, 169, 170, 171, 172, 173, 175, 176, 177, 178, 179, 180, 181, 182, 184, 185, 186, 187, 188, 189, 190, 191, 192, 193, 194, 195, 196, 197, 199, 201, 202, 203, 204, 206, 207, 208, 209, 210, 211, 212, 213, 214, 215, 217, 218, 219, 220, 221, 222, 223, 224, 225, 226, 227, 228, 229, 230, 231, 232, 233, 234, 235, 236, 237, 238, 239, 240, 241, 242, 243, 244, 245, 247, 248, 249, 250, 251, 252, 253, 254, 255, 256, 257, 258, 259, 260, 263, 264, 265, 266, 268, 269, 270, 271, 272, 273, 274, 276, 277, 278, 279, 281, 283, 284, 285, 286, 287, 288, 289, 290, 291, 292, 293, 294, 295, 296, 297, 298, 299, 300, 301, 302, 304, 305, 306, 307, 308, 309, 311, 312, 313, 314, 315, 316, 317, 318, 319, 320, 321, 322, 323, 324, 325, 326, 327, 328, 329, 330, 332, 333, 334, 335, 336, 337, 338, 339, 340, 342, 343, 344, 346, 347, 349, 350, 351, 352, 354, 355, 357, 358, 359, 360, 361, 363, 364, 365, 366, 367, 369, 370, 371, 372, 373, 374, 375, 376, 378, 379, 380, 381, 382, 383, 384, 385, 386, 387, 388, 389, 390, 391, 392, 393, 394, 395, 396, 397, 400, 401, 402, 403, 404, 405, 406, 407, 408, 409, 410, 411, 412, 413, 414, 415, 417, 418, 419, 420, 421, 422, 423, 424, 425, 427, 428, 429, 430, 431, 432, 434, 435, 436, 437, 438, 439, 440, 441, 442, 443, 444, 445, 446, 447, 448, 449, 450, 451, 452, 453, 454, 455, 456, 457, 458, 460, 461, 462, 463, 464, 465, 467, 468, 470, 471, 472, 473, 474, 475, 476, 477, 478, 479, 480, 481, 482, 483, 484, 485, 486, 487, 488, 489, 490, 491, 492, 493, 494, 495, 496, 497, 498, 499, 500, 502, 503, 504, 505, 506, 507, 508, 509, 510, 511, 512, 513, 514, 515, 516, 517, 518, 519, 520, 521, 522, 523, 524, 525, 526, 527, 528, 530, 531, 534, 535, 536, 537, 538, 539, 541, 542, 544, 545, 546, 547, 548, 549, 550, 551, 552, 553, 554, 555, 556, 557, 559, 560, 561, 562, 563, 564, 565, 566, 567, 568, 569, 570, 571, 572, 573, 574, 575, 576, 577, 578, 579, 580, 581, 582, 583, 584, 585, 587, 589, 590, 591, 593, 594, 595, 596, 598, 599, 600, 601, 602, 603, 604, 605, 606, 607, 609, 610, 611, 612, 613, 614, 615, 616, 617, 618, 619, 620, 621, 622, 623, 624, 625, 626, 627, 629, 630, 631, 632, 633, 635, 636, 637, 639, 641, 642, 643, 644, 645, 647, 649, 650, 652, 653, 654, 655, 656, 657, 659, 660, 661, 663, 664, 665, 666, 667, 668, 669, 670, 671, 672, 673, 674, 676, 677, 678, 679, 680, 681, 682, 683, 684, 687, 688, 689, 690, 691, 694, 695, 696, 697, 698, 699, 700, 701, 702, 703, 704, 705, 706, 707, 708, 709, 711, 713, 714, 715, 716, 717, 718, 719, 720, 721, 723, 724, 725, 726, 727, 728, 729, 730, 731, 733, 735, 737, 738, 739, 741, 742, 743, 744, 745, 747, 748, 749, 750, 753, 754, 755, 756, 757, 758, 759, 760, 761, 762, 763, 764, 765, 766, 767, 769, 770, 771, 772, 773, 774, 775, 776, 777, 779, 780, 781, 782, 785, 786, 787, 788, 789, 790, 791, 792, 793, 794, 795, 796, 797, 799, 800, 801, 802, 803, 804, 805, 806, 807, 808, 809, 810, 811, 812, 813, 814, 815, 816, 817, 819, 820, 821, 822, 823, 824, 825, 826, 827, 828, 830, 831, 832, 833, 834, 835, 836, 837, 838, 841, 842, 844, 845, 846, 847, 848, 852, 853, 854, 855, 856, 857, 858, 859, 861, 862, 863, 866, 867, 868, 869, 870, 871, 872, 873, 874, 875, 876, 877, 878, 879, 880, 882, 883, 884, 885, 886, 887, 888, 889]
[20, 40, 47, 49, 52, 55, 61, 72, 99, 112, 115, 117, 119, 133, 139, 141, 151, 157, 161, 174, 178, 186, 189, 200, 213, 224, 232, 247, 269, 270, 271, 283, 293, 294, 305, 312, 313, 314, 317, 319, 327, 331, 336, 338, 363, 369, 370, 372, 380, 381, 382, 384, 386, 389, 392, 395, 423, 425, 436, 447, 458, 461, 463, 465, 466, 469, 477, 484, 486, 490, 495, 501, 521, 528, 530, 544, 549, 553, 557, 572, 586, 593, 615, 628, 660, 666, 667, 677, 680, 684, 685, 701, 715, 716, 730, 736, 740, 745, 750, 753, 754, 779, 781, 782, 786, 787, 794, 807, 810, 821, 824, 826, 833, 840, 842, 855, 872, 874, 875, 881, 883, 888]

