[31, 47, 83, 141, 180, 215, 225, 301, 326, 330, 378, 396, 425, 459, 483, 661, 678, 690, 722, 728, 807, 832]
[91, 108, 138, 143, 250, 304, 331, 351, 371, 384, 408, 479, 500, 563, 575, 596, 617, 658, 742, 754, 766, 840]

[31, 47, 83, 141, 180, 215, 225, 301, 326, 330, 378, 396, 425, 459, 483, 661, 678, 690, 722, 728, 807, 832]
[4, 21, 28, 29, 38, 50, 57, 60, 64, 65, 72, 78, 86, 91, 94, 96, 106, 108, 128, 133, 134, 138, 143, 156, 161, 165, 192, 193, 194, 199, 210, 212, 214, 216, 217, 218, 230, 250, 251, 256, 258, 279, 281, 282, 297, 304, 305, 310, 314, 317, 320, 331, 342, 345, 351, 364, 371, 384, 393, 408, 418, 430, 439, 441, 447, 448, 450, 454, 461, 463, 472, 477, 479, 481, 487, 490, 500, 502, 518, 520, 523, 526, 532, 563, 567, 573, 575, 578, 594, 596, 605, 607, 617, 622, 626, 630, 631, 650, 658, 670, 683, 694, 700, 703, 706, 707, 711, 723, 724, 739, 742, 748, 754, 766, 770, 779, 781, 806, 835, 837, 840, 855]

[31, 32, 47, 70, 78, 83, 92, 106, 114, 124, 141, 167, 180, 215, 225, 236, 239, 262, 294, 301, 305, 316, 319, 326, 329, 330, 338, 373, 375, 378, 380, 388, 396, 404, 407, 414, 425, 431, 438, 452, 459, 463, 468, 475, 477, 483, 487, 488, 495, 498, 510, 513, 514, 515, 536, 539, 555, 577, 588, 593, 602, 632, 641, 642, 646, 647, 657, 661, 662, 663, 668, 669, 676, 678, 688, 690, 694, 722, 726, 728, 730, 736, 750, 775, 776, 777, 784, 805, 807, 810, 821, 832, 857, 867, 872, 881, 883]
[4, 21, 28, 29, 38, 50, 57, 60, 64, 65, 72, 78, 86, 91, 94, 96, 106, 108, 128, 133, 134, 138, 143, 156, 161, 165, 192, 193, 194, 199, 210, 212, 214, 216, 217, 218, 230, 250, 251, 256, 258, 279, 281, 282, 297, 304, 305, 310, 314, 317, 320, 331, 342, 345, 351, 364, 371, 384, 393, 408, 418, 430, 439, 441, 447, 448, 450, 454, 461, 463, 472, 477, 479, 481, 487, 490, 500, 502, 518, 520, 523, 526, 532, 563, 567, 573, 575, 578, 594, 596, 605, 607, 617, 622, 626, 630, 631, 650, 658, 670, 683, 694, 700, 703, 706, 707, 711, 723, 724, 739, 742, 748, 754, 766, 770, 779, 781, 806, 835, 837, 840, 855]

[19, 20, 31, 32, 43, 47, 49, 51, 59, 68, 70, 78, 83, 92, 96, 99, 106, 112, 114, 117, 124, 140, 141, 167, 171, 180, 182, 188, 189, 210, 215, 218, 225, 234, 236, 239, 246, 255, 262, 270, 276, 293, 294, 295, 301, 304, 305, 313, 316, 319, 320, 323, 326, 329, 330, 338, 347, 369, 373, 375, 378, 380, 385, 388, 396, 404, 405, 407, 410, 414, 419, 425, 429, 431, 436, 438, 444, 446, 452, 454, 459, 463, 468, 473, 475, 477, 483, 486, 487, 488, 495, 498, 510, 513, 514, 515, 517, 523, 536, 539, 546, 552, 555, 557, 562, 576, 577, 578, 580, 588, 593, 602, 606, 632, 638, 641, 642, 646, 647, 653, 656, 657, 661, 662, 663, 668, 669, 676, 678, 687, 688, 690, 694, 697, 711, 722, 726, 728, 730, 736, 744, 745, 750, 753, 756, 762, 763, 773, 774, 775, 776, 777, 781, 784, 800, 805, 807, 810, 821, 823, 827, 831, 832, 835, 857, 860, 862, 867, 872, 878, 881, 883]
[4, 21, 28, 29, 38, 50, 57, 60, 64, 65, 72, 78, 86, 91, 94, 96, 106, 108, 128, 133, 134, 138, 143, 156, 161, 165, 192, 193, 194, 199, 210, 212, 214, 216, 217, 218, 230, 250, 251, 256, 258, 279, 281, 282, 297, 304, 305, 310, 314, 317, 320, 331, 342, 345, 351, 364, 371, 384, 393, 408, 418, 430, 439, 441, 447, 448, 450, 454, 461, 463, 472, 477, 479, 481, 487, 490, 500, 502, 518, 520, 523, 526, 532, 563, 567, 573, 575, 578, 594, 596, 605, 607, 617, 622, 626, 630, 631, 650, 658, 670, 683, 694, 700, 703, 706, 707, 711, 723, 724, 739, 742, 748, 754, 766, 770, 779, 781, 806, 835, 837, 840, 855]

[19, 20, 24, 31, 32, 43, 47, 49, 51, 59, 61, 64, 68, 70, 78, 83, 85, 92, 93, 94, 96, 98, 99, 101, 106, 108, 112, 114, 115, 117, 124, 138, 140, 141, 149, 152, 161, 167, 170, 171, 173, 180, 182, 188, 189, 197, 203, 210, 215, 216, 218, 225, 234, 236, 239, 246, 250, 254, 255, 262, 270, 276, 292, 293, 294, 295, 301, 304, 305, 313, 316, 318, 319, 320, 323, 326, 329, 330, 335, 336, 338, 347, 351, 353, 365, 369, 371, 373, 375, 378, 379, 380, 385, 388, 396, 404, 405, 407, 410, 414, 418, 419, 424, 425, 429, 431, 432, 434, 435, 436, 438, 441, 444, 446, 447, 449, 452, 454, 459, 463, 465, 466, 468, 473, 475, 477, 482, 483, 486, 487, 488, 495, 498, 510, 511, 513, 514, 515, 517, 523, 536, 539, 545, 546, 552, 555, 557, 562, 565, 570, 576, 577, 578, 580, 582, 588, 593, 602, 606, 614, 620, 629, 632, 638, 641, 642, 646, 647, 648, 653, 656, 657, 661, 662, 663, 668, 669, 673, 674, 676, 678, 687, 688, 689, 690, 694, 697, 711, 720, 721, 722, 726, 728, 730, 736, 741, 742, 744, 745, 746, 749, 750, 753, 756, 762, 763, 764, 765, 767, 768, 772, 773, 774, 775, 776, 777, 780, 781, 784, 792, 799, 800, 805, 806, 807, 810, 819, 821, 823, 825, 827, 831, 832, 834, 835, 837, 844, 851, 857, 860, 862, 864, 867, 872, 874, 878, 881, 883, 885]
[4, 21, 28, 29, 38, 50, 57, 60, 64, 65, 72, 78, 86, 91, 94, 96, 106, 108, 128, 133, 134, 138, 143, 156, 161, 165, 192, 193, 194, 199, 210, 212, 214, 216, 217, 218, 230, 250, 251, 256, 258, 279, 281, 282, 297, 304, 305, 310, 314, 317, 320, 331, 342, 345, 351, 364, 371, 384, 393, 408, 418, 430, 439, 441, 447, 448, 450, 454, 461, 463, 472, 477, 479, 481, 487, 490, 500, 502, 518, 520, 523, 526, 532, 563, 567, 573, 575, 578, 594, 596, 605, 607, 617, 622, 626, 630, 631, 650, 658, 670, 683, 694, 700, 703, 706, 707, 711, 723, 724, 739, 742, 748, 754, 766, 770, 779, 781, 806, 835, 837, 840, 855]

[7, 19, 20, 24, 31, 32, 43, 46, 47, 49, 51, 59, 60, 61, 64, 66, 68, 70, 73, 78, 83, 85, 88, 92, 93, 94, 96, 98, 99, 101, 102, 106, 108, 112, 114, 115, 117, 123, 124, 127, 128, 138, 140, 141, 149, 151, 152, 161, 166, 167, 168, 170, 171, 173, 176, 180, 182, 188, 189, 192, 197, 203, 204, 210, 215, 216, 218, 220, 225, 234, 236, 239, 241, 243, 246, 248, 250, 254, 255, 260, 262, 270, 274, 276, 282, 288, 289, 291, 292, 293, 294, 295, 296, 297, 301, 304, 305, 306, 313, 316, 318, 319, 320, 323, 326, 328, 329, 330, 335, 336, 338, 346, 347, 351, 353, 357, 365, 369, 371, 373, 375, 378, 379, 380, 384, 385, 388, 394, 396, 400, 401, 404, 405, 407, 410, 414, 418, 419, 421, 424, 425, 429, 431, 432, 434, 435, 436, 438, 441, 444, 446, 447, 449, 451, 452, 454, 459, 463, 465, 466, 468, 473, 475, 477, 479, 482, 483, 486, 487, 488, 489, 491, 492, 495, 498, 501, 510, 511, 513, 514, 515, 517, 520, 523, 530, 531, 536, 539, 540, 545, 546, 552, 554, 555, 557, 562, 565, 570, 576, 577, 578, 580, 582, 586, 588, 591, 593, 597, 602, 605, 606, 612, 614, 620, 629, 632, 638, 641, 642, 646, 647, 648, 651, 653, 656, 657, 661, 662, 663, 668, 669, 670, 673, 674, 675, 676, 678, 680, 682, 687, 688, 689, 690, 694, 696, 697, 705, 711, 713, 720, 721, 722, 725, 726, 728, 730, 736, 741, 742, 744, 745, 746, 747, 749, 750, 753, 756, 758, 760, 762, 763, 764, 765, 767, 768, 772, 773, 774, 775, 776, 777, 780, 781, 784, 792, 794, 796, 799, 800, 801, 805, 806, 807, 810, 813, 819, 821, 823, 825, 827, 831, 832, 834, 835, 837, 844, 847, 848, 851, 857, 860, 862, 864, 865, 867, 869, 872, 874, 878, 881, 883, 885, 886, 888]
[4, 21, 28, 29, 38, 50, 57, 60, 64, 65, 72, 78, 86, 91, 94, 96, 106, 108, 128, 133, 134, 138, 143, 156, 161, 165, 192, 193, 194, 199, 210, 212, 214, 216, 217, 218, 230, 250, 251, 256, 258, 279, 281, 282, 297, 304, 305, 310, 314, 317, 320, 331, 342, 345, 351, 364, 371, 384, 393, 408, 418, 430, 439, 441, 447, 448, 450, 454, 461, 463, 472, 477, 479, 481, 487, 490, 500, 502, 518, 520, 523, 526, 532, 563, 567, 573, 575, 578, 594, 596, 605, 607, 617, 622, 626, 630, 631, 650, 658, 670, 683, 694, 700, 703, 706, 707, 711, 723, 724, 739, 742, 748, 754, 766, 770, 779, 781, 806, 835, 837, 840, 855]

[7, 19, 20, 24, 31, 32, 33, 34, 37, 43, 46, 47, 49, 51, 52, 56, 59, 60, 61, 64, 66, 68, 70, 73, 78, 79, 83, 85, 87, 88, 90, 92, 93, 94, 96, 98, 99, 101, 102, 106, 108, 111, 112, 114, 115, 117, 120, 123, 124, 127, 128, 133, 138, 140, 141, 142, 149, 151, 152, 161, 166, 167, 168, 170, 171, 173, 176, 180, 182, 188, 189, 192, 193, 195, 196, 197, 198, 203, 204, 210, 215, 216, 217, 218, 219, 220, 223, 225, 234, 236, 238, 239, 241, 243, 246, 248, 250, 254, 255, 260, 261, 262, 264, 270, 274, 276, 282, 284, 285, 288, 289, 291, 292, 293, 294, 295, 296, 297, 301, 304, 305, 306, 313, 316, 318, 319, 320, 322, 323, 326, 328, 329, 330, 335, 336, 338, 346, 347, 349, 351, 353, 357, 361, 364, 365, 369, 371, 373, 375, 378, 379, 380, 384, 385, 388, 391, 394, 396, 399, 400, 401, 404, 405, 407, 410, 414, 418, 419, 420, 421, 424, 425, 428, 429, 431, 432, 434, 435, 436, 438, 441, 444, 446, 447, 449, 450, 451, 452, 454, 459, 463, 465, 466, 468, 470, 471, 473, 475, 477, 479, 482, 483, 484, 486, 487, 488, 489, 490, 491, 492, 493, 495, 498, 501, 506, 510, 511, 513, 514, 515, 516, 517, 519, 520, 523, 524, 529, 530, 531, 535, 536, 539, 540, 542, 543, 545, 546, 552, 554, 555, 557, 562, 563, 565, 570, 576, 577, 578, 580, 582, 586, 588, 591, 593, 594, 596, 597, 599, 600, 602, 605, 606, 612, 614, 620, 621, 629, 632, 634, 635, 636, 638, 641, 642, 646, 647, 648, 651, 653, 656, 657, 661, 662, 663, 668, 669, 670, 673, 674, 675, 676, 677, 678, 680, 681, 682, 687, 688, 689, 690, 694, 696, 697, 700, 703, 704, 705, 708, 711, 713, 718, 720, 721, 722, 725, 726, 728, 730, 734, 736, 737, 740, 741, 742, 744, 745, 746, 747, 749, 750, 753, 756, 758, 759, 760, 762, 763, 764, 765, 767, 768, 772, 773, 774, 775, 776, 777, 778, 780, 781, 784, 786, 792, 793, 794, 796, 799, 800, 801, 805, 806, 807, 809, 810, 813, 819, 821, 823, 825, 827, 829, 831, 832, 834, 835, 837, 844, 847, 848, 851, 855, 857, 858, 860, 862, 864, 865, 867, 868, 869, 872, 874, 878, 881, 883, 885, 886, 887, 888]
[4, 21, 28, 29, 38, 50, 57, 60, 64, 65, 72, 78, 86, 91, 94, 96, 106, 108, 128, 133, 134, 138, 143, 156, 161, 165, 192, 193, 194, 199, 210, 212, 214, 216, 217, 218, 230, 250, 251, 256, 258, 279, 281, 282, 297, 304, 305, 310, 314, 317, 320, 331, 342, 345, 351, 364, 371, 384, 393, 408, 418, 430, 439, 441, 447, 448, 450, 454, 461, 463, 472, 477, 479, 481, 487, 490, 500, 502, 518, 520, 523, 526, 532, 563, 567, 573, 575, 578, 594, 596, 605, 607, 617, 622, 626, 630, 631, 650, 658, 670, 683, 694, 700, 703, 706, 707, 711, 723, 724, 739, 742, 748, 754, 766, 770, 779, 781, 806, 835, 837, 840, 855]

[2, 6, 7, 19, 20, 24, 31, 32, 33, 34, 37, 40, 43, 46, 47, 48, 49, 51, 52, 56, 59, 60, 61, 63, 64, 66, 68, 70, 73, 75, 78, 79, 83, 84, 85, 87, 88, 90, 91, 92, 93, 94, 96, 97, 98, 99, 101, 102, 105, 106, 108, 111, 112, 114, 115, 116, 117, 118, 120, 123, 124, 127, 128, 133, 134, 135, 138, 140, 141, 142, 143, 144, 149, 151, 152, 159, 161, 166, 167, 168, 170, 171, 173, 176, 177, 180, 181, 182, 185, 186, 187, 188, 189, 192, 193, 195, 196, 197, 198, 200, 203, 204, 210, 213, 215, 216, 217, 218, 219, 220, 223, 225, 226, 234, 236, 238, 239, 241, 243, 246, 248, 250, 254, 255, 259, 260, 261, 262, 263, 264, 270, 274, 276, 279, 282, 284, 285, 288, 289, 290, 291, 292, 293, 294, 295, 296, 297, 299, 301, 304, 305, 306, 307, 310, 313, 315, 316, 318, 319, 320, 322, 323, 324, 326, 328, 329, 330, 333, 335, 336, 338, 340, 345, 346, 347, 349, 351, 353, 357, 359, 361, 362, 364, 365, 369, 371, 373, 375, 378, 379, 380, 384, 385, 387, 388, 391, 393, 394, 396, 399, 400, 401, 403, 404, 405, 407, 410, 413, 414, 418, 419, 420, 421, 422, 424, 425, 428, 429, 431, 432, 434, 435, 436, 438, 441, 444, 446, 447, 449, 450, 451, 452, 454, 459, 463, 465, 466, 468, 470, 471, 473, 475, 477, 479, 482, 483, 484, 486, 487, 488, 489, 490, 491, 492, 493, 495, 498, 501, 506, 508, 510, 511, 512, 513, 514, 515, 516, 517, 519, 520, 523, 524, 528, 529, 530, 531, 535, 536, 538, 539, 540, 542, 543, 545, 546, 547, 551, 552, 554, 555, 557, 562, 563, 565, 566, 568, 570, 576, 577, 578, 580, 582, 585, 586, 588, 589, 591, 593, 594, 596, 597, 599, 600, 602, 605, 606, 610, 612, 614, 620, 621, 622, 624, 629, 632, 634, 635, 636, 638, 641, 642, 646, 647, 648, 651, 653, 654, 656, 657, 661, 662, 663, 667, 668, 669, 670, 673, 674, 675, 676, 677, 678, 680, 681, 682, 683, 687, 688, 689, 690, 694, 696, 697, 700, 703, 704, 705, 706, 708, 711, 713, 718, 720, 721, 722, 725, 726, 728, 730, 734, 736, 737, 740, 741, 742, 744, 745, 746, 747, 749, 750, 753, 756, 758, 759, 760, 762, 763, 764, 765, 767, 768, 772, 773, 774, 775, 776, 777, 778, 779, 780, 781, 784, 785, 786, 792, 793, 794, 796, 799, 800, 801, 802, 805, 806, 807, 809, 810, 811, 813, 814, 815, 818, 819, 821, 823, 825, 827, 828, 829, 830, 831, 832, 834, 835, 837, 840, 841, 844, 846, 847, 848, 851, 855, 857, 858, 860, 862, 864, 865, 867, 868, 869, 870, 871, 872, 874, 878, 881, 883, 885, 886, 887, 888]
[4, 21, 28, 29, 38, 50, 57, 60, 64, 65, 72, 78, 86, 91, 94, 96, 106, 108, 128, 133, 134, 138, 143, 156, 161, 165, 192, 193, 194, 199, 210, 212, 214, 216, 217, 218, 230, 250, 251, 256, 258, 279, 281, 282, 297, 304, 305, 310, 314, 317, 320, 331, 342, 345, 351, 364, 371, 384, 393, 408, 418, 430, 439, 441, 447, 448, 450, 454, 461, 463, 472, 477, 479, 481, 487, 490, 500, 502, 518, 520, 523, 526, 532, 563, 567, 573, 575, 578, 594, 596, 605, 607, 617, 622, 626, 630, 631, 650, 658, 670, 683, 694, 700, 703, 706, 707, 711, 723, 724, 739, 742, 748, 754, 766, 770, 779, 781, 806, 835, 837, 840, 855]

[1, 2, 6, 7, 16, 19, 20, 23, 24, 31, 32, 33, 34, 37, 38, 39, 40, 43, 46, 47, 48, 49, 51, 52, 53, 55, 56, 59, 60, 61, 62, 63, 64, 65, 66, 68, 69, 70, 73, 75, 78, 79, 83, 84, 85, 86, 87, 88, 90, 91, 92, 93, 94, 96, 97, 98, 99, 101, 102, 105, 106, 108, 110, 111, 112, 114, 115, 116, 117, 118, 120, 123, 124, 125, 127, 128, 133, 134, 135, 138, 139, 140, 141, 142, 143, 144, 147, 149, 151, 152, 158, 159, 161, 165, 166, 167, 168, 170, 171, 172, 173, 175, 176, 177, 180, 181, 182, 185, 186, 187, 188, 189, 192, 193, 195, 196, 197, 198, 200, 203, 204, 210, 211, 213, 214, 215, 216, 217, 218, 219, 220, 223, 225, 226, 232, 234, 236, 238, 239, 241, 243, 244, 246, 248, 250, 254, 255, 259, 260, 261, 262, 263, 264, 265, 269, 270, 271, 274, 276, 279, 282, 284, 285, 288, 289, 290, 291, 292, 293, 294, 295, 296, 297, 299, 300, 301, 303, 304, 305, 306, 307, 310, 311, 313, 315, 316, 318, 319, 320, 322, 323, 324, 326, 328, 329, 330, 333, 334, 335, 336, 338, 340, 341, 344, 345, 346, 347, 349, 351, 352, 353, 357, 359, 360, 361, 362, 364, 365, 368, 369, 371, 373, 375, 378, 379, 380, 384, 385, 387, 388, 391, 393, 394, 396, 397, 399, 400, 401, 403, 404, 405, 406, 407, 410, 412, 413, 414, 415, 417, 418, 419, 420, 421, 422, 424, 425, 428, 429, 431, 432, 433, 434, 435, 436, 437, 438, 441, 442, 444, 446, 447, 449, 450, 451, 452, 454, 455, 459, 460, 463, 465, 466, 468, 470, 471, 473, 475, 477, 479, 481, 482, 483, 484, 486, 487, 488, 489, 490, 491, 492, 493, 495, 496, 498, 501, 506, 507, 508, 510, 511, 512, 513, 514, 515, 516, 517, 518, 519, 520, 523, 524, 528, 529, 530, 531, 532, 535, 536, 538, 539, 540, 542, 543, 544, 545, 546, 547, 549, 551, 552, 553, 554, 555, 557, 558, 562, 563, 565, 566, 568, 569, 570, 572, 576, 577, 578, 580, 582, 585, 586, 588, 589, 591, 593, 594, 596, 597, 599, 600, 602, 605, 606, 610, 612, 614, 618, 620, 621, 622, 624, 629, 632, 633, 634, 635, 636, 638, 640, 641, 642, 646, 647, 648, 650, 651, 652, 653, 654, 655, 656, 657, 659, 661, 662, 663, 667, 668, 669, 670, 673, 674, 675, 676, 677, 678, 680, 681, 682, 683, 687, 688, 689, 690, 691, 694, 696, 697, 699, 700, 703, 704, 705, 706, 708, 710, 711, 713, 718, 720, 721, 722, 725, 726, 728, 730, 734, 736, 737, 740, 741, 742, 744, 745, 746, 747, 748, 749, 750, 752, 753, 756, 757, 758, 759, 760, 762, 763, 764, 765, 767, 768, 771, 772, 773, 774, 775, 776, 777, 778, 779, 780, 781, 784, 785, 786, 792, 793, 794, 796, 799, 800, 801, 802, 803, 805, 806, 807, 809, 810, 811, 813, 814, 815, 818, 819, 821, 823, 825, 827, 828, 829, 830, 831, 832, 834, 835, 837, 839, 840, 841, 843, 844, 846, 847, 848, 851, 855, 857, 858, 859, 860, 862, 864, 865, 866, 867, 868, 869, 870, 871, 872, 874, 878, 881, 883, 885, 886, 887, 888]
[4, 21, 28, 29, 38, 50, 57, 60, 64, 65, 72, 78, 86, 91, 94, 96, 106, 108, 128, 133, 134, 138, 143, 156, 161, 165, 192, 193, 194, 199, 210, 212, 214, 216, 217, 218, 230, 250, 251, 256, 258, 279, 281, 282, 297, 304, 305, 310, 314, 317, 320, 331, 342, 345, 351, 364, 371, 384, 393, 408, 418, 430, 439, 441, 447, 448, 450, 454, 461, 463, 472, 477, 479, 481, 487, 490, 500, 502, 518, 520, 523, 526, 532, 563, 567, 573, 575, 578, 594, 596, 605, 607, 617, 622, 626, 630, 631, 650, 658, 670, 683, 694, 700, 703, 706, 707, 711, 723, 724, 739, 742, 748, 754, 766, 770, 779, 781, 806, 835, 837, 840, 855]

[1, 2, 3, 4, 6, 7, 15, 16, 19, 20, 23, 24, 27, 29, 31, 32, 33, 34, 37, 38, 39, 40, 43, 46, 47, 48, 49, 50, 51, 52, 53, 54, 55, 56, 57, 59, 60, 61, 62, 63, 64, 65, 66, 67, 68, 69, 70, 73, 75, 78, 79, 80, 82, 83, 84, 85, 86, 87, 88, 89, 90, 91, 92, 93, 94, 96, 97, 98, 99, 101, 102, 105, 106, 108, 110, 111, 112, 114, 115, 116, 117, 118, 120, 121, 122, 123, 124, 125, 126, 127, 128, 130, 133, 134, 135, 136, 137, 138, 139, 140, 141, 142, 143, 144, 147, 149, 151, 152, 157, 158, 159, 161, 165, 166, 167, 168, 170, 171, 172, 173, 175, 176, 177, 180, 181, 182, 185, 186, 187, 188, 189, 192, 193, 194, 195, 196, 197, 198, 200, 203, 204, 205, 210, 211, 213, 214, 215, 216, 217, 218, 219, 220, 223, 224, 225, 226, 230, 232, 234, 235, 236, 238, 239, 241, 242, 243, 244, 246, 247, 248, 250, 251, 254, 255, 256, 259, 260, 261, 262, 263, 264, 265, 268, 269, 270, 271, 272, 274, 276, 277, 279, 282, 284, 285, 286, 288, 289, 290, 291, 292, 293, 294, 295, 296, 297, 299, 300, 301, 302, 303, 304, 305, 306, 307, 310, 311, 313, 315, 316, 317, 318, 319, 320, 322, 323, 324, 326, 328, 329, 330, 333, 334, 335, 336, 338, 339, 340, 341, 344, 345, 346, 347, 349, 351, 352, 353, 355, 357, 359, 360, 361, 362, 364, 365, 368, 369, 371, 373, 375, 376, 378, 379, 380, 381, 382, 383, 384, 385, 387, 388, 391, 392, 393, 394, 396, 397, 398, 399, 400, 401, 403, 404, 405, 406, 407, 408, 410, 411, 412, 413, 414, 415, 417, 418, 419, 420, 421, 422, 424, 425, 428, 429, 431, 432, 433, 434, 435, 436, 437, 438, 439, 441, 442, 444, 446, 447, 449, 450, 451, 452, 454, 455, 459, 460, 463, 465, 466, 468, 470, 471, 473, 475, 477, 479, 481, 482, 483, 484, 486, 487, 488, 489, 490, 491, 492, 493, 495, 496, 498, 501, 506, 507, 508, 509, 510, 511, 512, 513, 514, 515, 516, 517, 518, 519, 520, 523, 524, 525, 528, 529, 530, 531, 532, 535, 536, 538, 539, 540, 542, 543, 544, 545, 546, 547, 549, 551, 552, 553, 554, 555, 557, 558, 560, 561, 562, 563, 565, 566, 568, 569, 570, 572, 576, 577, 578, 580, 582, 585, 586, 588, 589, 591, 593, 594, 596, 597, 599, 600, 602, 604, 605, 606, 607, 610, 611, 612, 614, 615, 618, 620, 621, 622, 623, 624, 629, 632, 633, 634, 635, 636, 637, 638, 640, 641, 642, 643, 644, 646, 647, 648, 650, 651, 652, 653, 654, 655, 656, 657, 659, 661, 662, 663, 667, 668, 669, 670, 672, 673, 674, 675, 676, 677, 678, 679, 680, 681, 682, 683, 687, 688, 689, 690, 691, 693, 694, 696, 697, 699, 700, 702, 703, 704, 705, 706, 708, 710, 711, 713, 715, 716, 718, 720, 721, 722, 724, 725, 726, 728, 730, 732, 733, 734, 736, 737, 740, 741, 742, 743, 744, 745, 746, 747, 748, 749, 750, 752, 753, 756, 757, 758, 759, 760, 762, 763, 764, 765, 767, 768, 769, 771, 772, 773, 774, 775, 776, 777, 778, 779, 780, 781, 783, 784, 785, 786, 792, 793, 794, 796, 798, 799, 800, 801, 802, 803, 805, 806, 807, 809, 810, 811, 813, 814, 815, 816, 818, 819, 821, 823, 825, 827, 828, 829, 830, 831, 832, 834, 835, 837, 839, 840, 841, 842, 843, 844, 846, 847, 848, 851, 855, 856, 857, 858, 859, 860, 862, 864, 865, 866, 867, 868, 869, 870, 871, 872, 874, 878, 880, 881, 883, 884, 885, 886, 887, 888]
[4, 21, 28, 29, 38, 50, 57, 60, 64, 65, 72, 78, 86, 91, 94, 96, 106, 108, 128, 133, 134, 138, 143, 156, 161, 165, 192, 193, 194, 199, 210, 212, 214, 216, 217, 218, 230, 250, 251, 256, 258, 279, 281, 282, 297, 304, 305, 310, 314, 317, 320, 331, 342, 345, 351, 364, 371, 384, 393, 408, 418, 430, 439, 441, 447, 448, 450, 454, 461, 463, 472, 477, 479, 481, 487, 490, 500, 502, 518, 520, 523, 526, 532, 563, 567, 573, 575, 578, 594, 596, 605, 607, 617, 622, 626, 630, 631, 650, 658, 670, 683, 694, 700, 703, 706, 707, 711, 723, 724, 739, 742, 748, 754, 766, 770, 779, 781, 806, 835, 837, 840, 855]

[1, 2, 3, 4, 6, 7, 10, 12, 15, 16, 18, 19, 20, 23, 24, 27, 29, 30, 31, 32, 33, 34, 37, 38, 39, 40, 42, 43, 46, 47, 48, 49, 50, 51, 52, 53, 54, 55, 56, 57, 59, 60, 61, 62, 63, 64, 65, 66, 67, 68, 69, 70, 72, 73, 75, 76, 77, 78, 79, 80, 82, 83, 84, 85, 86, 87, 88, 89, 90, 91, 92, 93, 94, 96, 97, 98, 99, 101, 102, 103, 105, 106, 108, 109, 110, 111, 112, 114, 115, 116, 117, 118, 119, 120, 121, 122, 123, 124, 125, 126, 127, 128, 129, 130, 133, 134, 135, 136, 137, 138, 139, 140, 141, 142, 143, 144, 147, 149, 151, 152, 153, 155, 157, 158, 159, 161, 163, 165, 166, 167, 168, 170, 171, 172, 173, 175, 176, 177, 180, 181, 182, 185, 186, 187, 188, 189, 190, 191, 192, 193, 194, 195, 196, 197, 198, 200, 201, 203, 204, 205, 210, 211, 213, 214, 215, 216, 217, 218, 219, 220, 223, 224, 225, 226, 228, 230, 232, 234, 235, 236, 237, 238, 239, 241, 242, 243, 244, 246, 247, 248, 249, 250, 251, 254, 255, 256, 259, 260, 261, 262, 263, 264, 265, 267, 268, 269, 270, 271, 272, 273, 274, 275, 276, 277, 279, 281, 282, 284, 285, 286, 288, 289, 290, 291, 292, 293, 294, 295, 296, 297, 299, 300, 301, 302, 303, 304, 305, 306, 307, 310, 311, 313, 315, 316, 317, 318, 319, 320, 321, 322, 323, 324, 326, 327, 328, 329, 330, 332, 333, 334, 335, 336, 338, 339, 340, 341, 343, 344, 345, 346, 347, 348, 349, 351, 352, 353, 355, 356, 357, 359, 360, 361, 362, 364, 365, 367, 368, 369, 371, 372, 373, 375, 376, 377, 378, 379, 380, 381, 382, 383, 384, 385, 387, 388, 391, 392, 393, 394, 396, 397, 398, 399, 400, 401, 403, 404, 405, 406, 407, 408, 410, 411, 412, 413, 414, 415, 417, 418, 419, 420, 421, 422, 424, 425, 427, 428, 429, 430, 431, 432, 433, 434, 435, 436, 437, 438, 439, 441, 442, 444, 446, 447, 448, 449, 450, 451, 452, 454, 455, 457, 459, 460, 461, 463, 465, 466, 468, 470, 471, 472, 473, 475, 477, 478, 479, 481, 482, 483, 484, 486, 487, 488, 489, 490, 491, 492, 493, 495, 496, 498, 500, 501, 506, 507, 508, 509, 510, 511, 512, 513, 514, 515, 516, 517, 518, 519, 520, 523, 524, 525, 527, 528, 529, 530, 531, 532, 533, 535, 536, 538, 539, 540, 542, 543, 544, 545, 546, 547, 549, 551, 552, 553, 554, 555, 556, 557, 558, 559, 560, 561, 562, 563, 564, 565, 566, 568, 569, 570, 572, 574, 576, 577, 578, 580, 581, 582, 584, 585, 586, 588, 589, 591, 592, 593, 594, 595, 596, 597, 599, 600, 602, 603, 604, 605, 606, 607, 608, 610, 611, 612, 614, 615, 618, 620, 621, 622, 623, 624, 627, 628, 629, 631, 632, 633, 634, 635, 636, 637, 638, 640, 641, 642, 643, 644, 646, 647, 648, 650, 651, 652, 653, 654, 655, 656, 657, 659, 661, 662, 663, 665, 667, 668, 669, 670, 672, 673, 674, 675, 676, 677, 678, 679, 680, 681, 682, 683, 684, 685, 686, 687, 688, 689, 690, 691, 693, 694, 696, 697, 699, 700, 702, 703, 704, 705, 706, 708, 710, 711, 713, 715, 716, 717, 718, 720, 721, 722, 723, 724, 725, 726, 728, 730, 732, 733, 734, 736, 737, 738, 740, 741, 742, 743, 744, 745, 746, 747, 748, 749, 750, 752, 753, 754, 756, 757, 758, 759, 760, 762, 763, 764, 765, 766, 767, 768, 769, 771, 772, 773, 774, 775, 776, 777, 778, 779, 780, 781, 782, 783, 784, 785, 786, 789, 792, 793, 794, 795, 796, 797, 798, 799, 800, 801, 802, 803, 804, 805, 806, 807, 809, 810, 811, 813, 814, 815, 816, 818, 819, 821, 822, 823, 825, 827, 828, 829, 830, 831, 832, 834, 835, 837, 838, 839, 840, 841, 842, 843, 844, 846, 847, 848, 849, 851, 852, 853, 855, 856, 857, 858, 859, 860, 862, 863, 864, 865, 866, 867, 868, 869, 870, 871, 872, 874, 878, 880, 881, 883, 884, 885, 886, 887, 888]
[4, 21, 28, 29, 38, 50, 57, 60, 64, 65, 72, 78, 86, 91, 94, 96, 106, 108, 128, 133, 134, 138, 143, 156, 161, 165, 192, 193, 194, 199, 210, 212, 214, 216, 217, 218, 230, 250, 251, 256, 258, 279, 281, 282, 297, 304, 305, 310, 314, 317, 320, 331, 342, 345, 351, 364, 371, 384, 393, 408, 418, 430, 439, 441, 447, 448, 450, 454, 461, 463, 472, 477, 479, 481, 487, 490, 500, 502, 518, 520, 523, 526, 532, 563, 567, 573, 575, 578, 594, 596, 605, 607, 617, 622, 626, 630, 631, 650, 658, 670, 683, 694, 700, 703, 706, 707, 711, 723, 724, 739, 742, 748, 754, 766, 770, 779, 781, 806, 835, 837, 840, 855]

[1, 2, 3, 4, 6, 7, 9, 10, 11, 12, 13, 15, 16, 18, 19, 20, 22, 23, 24, 25, 26, 27, 29, 30, 31, 32, 33, 34, 36, 37, 38, 39, 40, 41, 42, 43, 44, 46, 47, 48, 49, 50, 51, 52, 53, 54, 55, 56, 57, 59, 60, 61, 62, 63, 64, 65, 66, 67, 68, 69, 70, 71, 72, 73, 74, 75, 76, 77, 78, 79, 80, 81, 82, 83, 84, 85, 86, 87, 88, 89, 90, 91, 92, 93, 94, 95, 96, 97, 98, 99, 100, 101, 102, 103, 104, 105, 106, 108, 109, 110, 111, 112, 114, 115, 116, 117, 118, 119, 120, 121, 122, 123, 124, 125, 126, 127, 128, 129, 130, 131, 132, 133, 134, 135, 136, 137, 138, 139, 140, 141, 142, 143, 144, 147, 148, 149, 151, 152, 153, 155, 157, 158, 159, 161, 162, 163, 165, 166, 167, 168, 169, 170, 171, 172, 173, 175, 176, 177, 179, 180, 181, 182, 185, 186, 187, 188, 189, 190, 191, 192, 193, 194, 195, 196, 197, 198, 200, 201, 202, 203, 204, 205, 207, 210, 211, 213, 214, 215, 216, 217, 218, 219, 220, 223, 224, 225, 226, 228, 229, 230, 232, 233, 234, 235, 236, 237, 238, 239, 241, 242, 243, 244, 245, 246, 247, 248, 249, 250, 251, 253, 254, 255, 256, 257, 259, 260, 261, 262, 263, 264, 265, 267, 268, 269, 270, 271, 272, 273, 274, 275, 276, 277, 279, 280, 281, 282, 284, 285, 286, 288, 289, 290, 291, 292, 293, 294, 295, 296, 297, 299, 300, 301, 302, 303, 304, 305, 306, 307, 308, 310, 311, 312, 313, 315, 316, 317, 318, 319, 320, 321, 322, 323, 324, 326, 327, 328, 329, 330, 332, 333, 334, 335, 336, 338, 339, 340, 341, 343, 344, 345, 346, 347, 348, 349, 351, 352, 353, 354, 355, 356, 357, 358, 359, 360, 361, 362, 364, 365, 366, 367, 368, 369, 370, 371, 372, 373, 374, 375, 376, 377, 378, 379, 380, 381, 382, 383, 384, 385, 387, 388, 389, 391, 392, 393, 394, 395, 396, 397, 398, 399, 400, 401, 403, 404, 405, 406, 407, 408, 410, 411, 412, 413, 414, 415, 417, 418, 419, 420, 421, 422, 424, 425, 427, 428, 429, 430, 431, 432, 433, 434, 435, 436, 437, 438, 439, 441, 442, 443, 444, 446, 447, 448, 449, 450, 451, 452, 454, 455, 456, 457, 459, 460, 461, 462, 463, 464, 465, 466, 468, 470, 471, 472, 473, 475, 477, 478, 479, 480, 481, 482, 483, 484, 486, 487, 488, 489, 490, 491, 492, 493, 495, 496, 498, 499, 500, 501, 503, 506, 507, 508, 509, 510, 511, 512, 513, 514, 515, 516, 517, 518, 519, 520, 521, 523, 524, 525, 526, 527, 528, 529, 530, 531, 532, 533, 534, 535, 536, 537, 538, 539, 540, 542, 543, 544, 545, 546, 547, 548, 549, 551, 552, 553, 554, 555, 556, 557, 558, 559, 560, 561, 562, 563, 564, 565, 566, 568, 569, 570, 571, 572, 574, 576, 577, 578, 579, 580, 581, 582, 584, 585, 586, 588, 589, 591, 592, 593, 594, 595, 596, 597, 598, 599, 600, 602, 603, 604, 605, 606, 607, 608, 609, 610, 611, 612, 614, 615, 618, 620, 621, 622, 623, 624, 626, 627, 628, 629, 631, 632, 633, 634, 635, 636, 637, 638, 639, 640, 641, 642, 643, 644, 645, 646, 647, 648, 650, 651, 652, 653, 654, 655, 656, 657, 659, 660, 661, 662, 663, 665, 667, 668, 669, 670, 672, 673, 674, 675, 676, 677, 678, 679, 680, 681, 682, 683, 684, 685, 686, 687, 688, 689, 690, 691, 692, 693, 694, 696, 697, 699, 700, 701, 702, 703, 704, 705, 706, 707, 708, 710, 711, 713, 714, 715, 716, 717, 718, 719, 720, 721, 722, 723, 724, 725, 726, 728, 730, 732, 733, 734, 736, 737, 738, 739, 740, 741, 742, 743, 744, 745, 746, 747, 748, 749, 750, 751, 752, 753, 754, 756, 757, 758, 759, 760, 762, 763, 764, 765, 766, 767, 768, 769, 771, 772, 773, 774, 775, 776, 777, 778, 779, 780, 781, 782, 783, 784, 785, 786, 787, 789, 792, 793, 794, 795, 796, 797, 798, 799, 800, 801, 802, 803, 804, 805, 806, 807, 809, 810, 811, 812, 813, 814, 815, 816, 817, 818, 819, 821, 822, 823, 824, 825, 826, 827, 828, 829, 830, 831, 832, 834, 835, 837, 838, 839, 840, 841, 842, 843, 844, 846, 847, 848, 849, 850, 851, 852, 853, 855, 856, 857, 858, 859, 860, 862, 863, 864, 865, 866, 867, 868, 869, 870, 871, 872, 873, 874, 876, 877, 878, 879, 880, 881, 883, 884, 885, 886, 887, 888]
[4, 21, 28, 29, 38, 50, 57, 60, 64, 65, 72, 78, 86, 91, 94, 96, 106, 108, 128, 133, 134, 138, 143, 156, 161, 165, 192, 193, 194, 199, 210, 212, 214, 216, 217, 218, 230, 250, 251, 256, 258, 279, 281, 282, 297, 304, 305, 310, 314, 317, 320, 331, 342, 345, 351, 364, 371, 384, 393, 408, 418, 430, 439, 441, 447, 448, 450, 454, 461, 463, 472, 477, 479, 481, 487, 490, 500, 502, 518, 520, 523, 526, 532, 563, 567, 573, 575, 578, 594, 596, 605, 607, 617, 622, 626, 630, 631, 650, 658, 670, 683, 694, 700, 703, 706, 707, 711, 723, 724, 739, 742, 748, 754, 766, 770, 779, 781, 806, 835, 837, 840, 855]

