[8, 18, 61, 94, 99, 102, 116, 147, 176, 177, 185, 230, 313, 412, 415, 605, 607, 643, 670, 707, 739, 756]
[25, 37, 53, 54, 74, 80, 118, 146, 198, 263, 292, 383, 397, 438, 495, 580, 603, 641, 763, 777, 841, 887]

[8, 18, 61, 94, 99, 102, 116, 147, 176, 177, 185, 230, 313, 412, 415, 605, 607, 643, 670, 707, 739, 756]
[3, 10, 21, 25, 37, 53, 54, 69, 74, 77, 79, 80, 81, 82, 83, 109, 118, 122, 145, 146, 151, 154, 168, 191, 193, 198, 201, 234, 237, 239, 240, 242, 246, 248, 249, 255, 263, 285, 292, 306, 308, 336, 340, 360, 370, 383, 384, 394, 395, 397, 404, 405, 407, 411, 418, 425, 438, 440, 443, 477, 479, 483, 484, 490, 495, 498, 505, 507, 513, 520, 523, 534, 540, 554, 562, 567, 576, 578, 580, 587, 596, 603, 606, 616, 617, 620, 621, 624, 630, 635, 641, 652, 660, 666, 688, 695, 704, 720, 733, 738, 747, 749, 757, 758, 763, 769, 776, 777, 781, 798, 799, 804, 805, 809, 811, 841, 847, 863, 866, 869, 876, 887]

[7, 8, 9, 18, 22, 25, 61, 65, 72, 75, 78, 94, 99, 101, 102, 104, 116, 125, 138, 147, 154, 156, 166, 167, 168, 176, 177, 185, 230, 249, 251, 255, 257, 260, 276, 285, 294, 313, 326, 333, 362, 369, 377, 387, 411, 412, 415, 425, 453, 465, 470, 471, 474, 478, 480, 491, 504, 509, 513, 515, 548, 560, 575, 577, 587, 588, 605, 607, 618, 622, 629, 633, 638, 643, 653, 664, 665, 670, 677, 680, 707, 739, 756, 759, 763, 767, 779, 789, 807, 815, 816, 839, 851, 860, 862, 873, 879]
[3, 10, 21, 25, 37, 53, 54, 69, 74, 77, 79, 80, 81, 82, 83, 109, 118, 122, 145, 146, 151, 154, 168, 191, 193, 198, 201, 234, 237, 239, 240, 242, 246, 248, 249, 255, 263, 285, 292, 306, 308, 336, 340, 360, 370, 383, 384, 394, 395, 397, 404, 405, 407, 411, 418, 425, 438, 440, 443, 477, 479, 483, 484, 490, 495, 498, 505, 507, 513, 520, 523, 534, 540, 554, 562, 567, 576, 578, 580, 587, 596, 603, 606, 616, 617, 620, 621, 624, 630, 635, 641, 652, 660, 666, 688, 695, 704, 720, 733, 738, 747, 749, 757, 758, 763, 769, 776, 777, 781, 798, 799, 804, 805, 809, 811, 841, 847, 863, 866, 869, 876, 887]

[7, 8, 9, 16, 18, 21, 22, 25, 26, 28, 32, 40, 43, 45, 48, 51, 61, 64, 65, 66, 72, 75, 78, 90, 93, 94, 99, 101, 102, 104, 110, 116, 125, 138, 145, 147, 149, 154, 156, 164, 166, 167, 168, 171, 176, 177, 181, 185, 195, 197, 218, 222, 227, 230, 235, 249, 251, 254, 255, 257, 260, 267, 276, 278, 285, 294, 313, 318, 326, 333, 340, 357, 361, 362, 369, 371, 376, 377, 381, 387, 390, 411, 412, 414, 415, 425, 432, 435, 442, 451, 453, 457, 465, 470, 471, 474, 477, 478, 479, 480, 484, 491, 492, 499, 504, 509, 512, 513, 515, 520, 544, 545, 548, 552, 554, 560, 571, 575, 577, 587, 588, 591, 605, 607, 612, 618, 622, 627, 629, 633, 638, 642, 643, 653, 655, 659, 664, 665, 668, 670, 677, 680, 690, 707, 715, 731, 732, 733, 739, 740, 742, 746, 749, 750, 756, 759, 763, 767, 779, 789, 807, 815, 816, 820, 829, 839, 849, 851, 860, 862, 873, 879]
[3, 10, 21, 25, 37, 53, 54, 69, 74, 77, 79, 80, 81, 82, 83, 109, 118, 122, 145, 146, 151, 154, 168, 191, 193, 198, 201, 234, 237, 239, 240, 242, 246, 248, 249, 255, 263, 285, 292, 306, 308, 336, 340, 360, 370, 383, 384, 394, 395, 397, 404, 405, 407, 411, 418, 425, 438, 440, 443, 477, 479, 483, 484, 490, 495, 498, 505, 507, 513, 520, 523, 534, 540, 554, 562, 567, 576, 578, 580, 587, 596, 603, 606, 616, 617, 620, 621, 624, 630, 635, 641, 652, 660, 666, 688, 695, 704, 720, 733, 738, 747, 749, 757, 758, 763, 769, 776, 777, 781, 798, 799, 804, 805, 809, 811, 841, 847, 863, 866, 869, 876, 887]

[5, 7, 8, 9, 10, 16, 18, 21, 22, 25, 26, 28, 31, 32, 40, 43, 45, 48, 51, 61, 64, 65, 66, 72, 73, 75, 78, 87, 88, 90, 93, 94, 95, 99, 101, 102, 104, 106, 107, 110, 112, 116, 125, 131, 138, 139, 142, 145, 147, 149, 154, 156, 160, 164, 166, 167, 168, 171, 174, 176, 177, 181, 185, 195, 197, 203, 216, 218, 222, 224, 227, 228, 230, 231, 235, 242, 245, 246, 249, 251, 254, 255, 257, 260, 267, 268, 276, 278, 285, 286, 294, 300, 305, 313, 318, 324, 326, 329, 333, 340, 347, 357, 360, 361, 362, 366, 369, 371, 372, 376, 377, 381, 387, 388, 390, 392, 394, 407, 411, 412, 414, 415, 425, 432, 435, 442, 444, 445, 451, 453, 457, 459, 460, 465, 470, 471, 474, 477, 478, 479, 480, 484, 485, 486, 491, 492, 493, 497, 498, 499, 500, 502, 504, 509, 512, 513, 515, 520, 532, 544, 545, 548, 552, 554, 557, 560, 571, 574, 575, 577, 586, 587, 588, 591, 594, 604, 605, 607, 608, 612, 618, 622, 627, 629, 633, 638, 640, 642, 643, 653, 655, 656, 659, 664, 665, 668, 670, 677, 680, 690, 703, 707, 714, 715, 717, 726, 731, 732, 733, 734, 738, 739, 740, 742, 746, 749, 750, 756, 759, 763, 767, 771, 773, 779, 786, 788, 789, 807, 815, 816, 820, 829, 831, 838, 839, 845, 849, 851, 852, 857, 860, 861, 862, 872, 873, 874, 879]
[3, 10, 21, 25, 37, 53, 54, 69, 74, 77, 79, 80, 81, 82, 83, 109, 118, 122, 145, 146, 151, 154, 168, 191, 193, 198, 201, 234, 237, 239, 240, 242, 246, 248, 249, 255, 263, 285, 292, 306, 308, 336, 340, 360, 370, 383, 384, 394, 395, 397, 404, 405, 407, 411, 418, 425, 438, 440, 443, 477, 479, 483, 484, 490, 495, 498, 505, 507, 513, 520, 523, 534, 540, 554, 562, 567, 576, 578, 580, 587, 596, 603, 606, 616, 617, 620, 621, 624, 630, 635, 641, 652, 660, 666, 688, 695, 704, 720, 733, 738, 747, 749, 757, 758, 763, 769, 776, 777, 781, 798, 799, 804, 805, 809, 811, 841, 847, 863, 866, 869, 876, 887]

[2, 5, 7, 8, 9, 10, 14, 15, 16, 18, 21, 22, 25, 26, 28, 31, 32, 40, 43, 45, 48, 51, 61, 64, 65, 66, 72, 73, 75, 78, 85, 87, 88, 90, 93, 94, 95, 99, 100, 101, 102, 104, 105, 106, 107, 110, 112, 113, 116, 118, 125, 128, 130, 131, 133, 138, 139, 142, 145, 147, 149, 154, 156, 159, 160, 164, 166, 167, 168, 171, 173, 174, 176, 177, 181, 185, 195, 197, 203, 216, 218, 222, 224, 227, 228, 229, 230, 231, 235, 237, 242, 243, 245, 246, 249, 251, 254, 255, 257, 260, 263, 266, 267, 268, 269, 270, 274, 275, 276, 278, 285, 286, 294, 300, 305, 307, 313, 318, 319, 324, 326, 329, 333, 339, 340, 343, 345, 347, 353, 357, 360, 361, 362, 366, 369, 371, 372, 376, 377, 381, 387, 388, 390, 392, 394, 407, 408, 409, 411, 412, 414, 415, 420, 421, 425, 430, 432, 434, 435, 441, 442, 444, 445, 451, 453, 457, 459, 460, 465, 466, 467, 469, 470, 471, 473, 474, 477, 478, 479, 480, 484, 485, 486, 491, 492, 493, 497, 498, 499, 500, 502, 503, 504, 507, 509, 512, 513, 515, 520, 523, 524, 532, 534, 536, 544, 545, 548, 552, 554, 557, 559, 560, 562, 563, 566, 571, 574, 575, 577, 579, 581, 582, 586, 587, 588, 591, 593, 594, 596, 603, 604, 605, 607, 608, 612, 613, 617, 618, 622, 627, 629, 633, 638, 640, 642, 643, 653, 654, 655, 656, 659, 664, 665, 666, 667, 668, 670, 676, 677, 680, 690, 703, 704, 707, 710, 714, 715, 716, 717, 720, 726, 731, 732, 733, 734, 738, 739, 740, 742, 746, 749, 750, 756, 759, 763, 765, 767, 771, 773, 779, 782, 783, 786, 788, 789, 804, 807, 815, 816, 820, 829, 831, 838, 839, 845, 849, 850, 851, 852, 853, 857, 860, 861, 862, 872, 873, 874, 879, 880, 885, 886, 888]
[3, 10, 21, 25, 37, 53, 54, 69, 74, 77, 79, 80, 81, 82, 83, 109, 118, 122, 145, 146, 151, 154, 168, 191, 193, 198, 201, 234, 237, 239, 240, 242, 246, 248, 249, 255, 263, 285, 292, 306, 308, 336, 340, 360, 370, 383, 384, 394, 395, 397, 404, 405, 407, 411, 418, 425, 438, 440, 443, 477, 479, 483, 484, 490, 495, 498, 505, 507, 513, 520, 523, 534, 540, 554, 562, 567, 576, 578, 580, 587, 596, 603, 606, 616, 617, 620, 621, 624, 630, 635, 641, 652, 660, 666, 688, 695, 704, 720, 733, 738, 747, 749, 757, 758, 763, 769, 776, 777, 781, 798, 799, 804, 805, 809, 811, 841, 847, 863, 866, 869, 876, 887]

[2, 4, 5, 7, 8, 9, 10, 13, 14, 15, 16, 17, 18, 21, 22, 25, 26, 28, 31, 32, 40, 43, 45, 48, 50, 51, 55, 61, 64, 65, 66, 72, 73, 75, 78, 85, 87, 88, 90, 93, 94, 95, 99, 100, 101, 102, 104, 105, 106, 107, 110, 112, 113, 116, 117, 118, 123, 124, 125, 128, 130, 131, 133, 136, 138, 139, 142, 145, 147, 148, 149, 154, 156, 159, 160, 164, 166, 167, 168, 171, 173, 174, 176, 177, 181, 182, 184, 185, 193, 195, 197, 199, 201, 203, 207, 216, 218, 219, 222, 224, 227, 228, 229, 230, 231, 232, 235, 237, 238, 242, 243, 245, 246, 249, 251, 254, 255, 257, 259, 260, 261, 263, 266, 267, 268, 269, 270, 274, 275, 276, 278, 284, 285, 286, 288, 289, 292, 294, 300, 303, 305, 307, 313, 318, 319, 320, 324, 325, 326, 327, 329, 333, 339, 340, 343, 344, 345, 346, 347, 349, 353, 357, 360, 361, 362, 365, 366, 369, 371, 372, 376, 377, 380, 381, 384, 387, 388, 390, 391, 392, 394, 396, 407, 408, 409, 411, 412, 414, 415, 416, 420, 421, 424, 425, 426, 430, 432, 434, 435, 437, 438, 441, 442, 444, 445, 448, 451, 453, 454, 456, 457, 459, 460, 464, 465, 466, 467, 469, 470, 471, 473, 474, 475, 477, 478, 479, 480, 481, 482, 484, 485, 486, 491, 492, 493, 495, 497, 498, 499, 500, 502, 503, 504, 505, 507, 509, 512, 513, 515, 518, 520, 522, 523, 524, 532, 533, 534, 536, 543, 544, 545, 547, 548, 552, 554, 557, 559, 560, 562, 563, 566, 571, 572, 574, 575, 577, 579, 581, 582, 585, 586, 587, 588, 591, 593, 594, 596, 597, 603, 604, 605, 607, 608, 612, 613, 617, 618, 622, 623, 627, 628, 629, 633, 636, 638, 640, 642, 643, 652, 653, 654, 655, 656, 659, 660, 664, 665, 666, 667, 668, 670, 676, 677, 680, 681, 683, 690, 695, 699, 703, 704, 707, 710, 714, 715, 716, 717, 720, 724, 726, 731, 732, 733, 734, 738, 739, 740, 742, 746, 747, 749, 750, 756, 759, 763, 764, 765, 767, 771, 773, 777, 779, 780, 782, 783, 786, 788, 789, 791, 804, 807, 815, 816, 820, 829, 831, 838, 839, 842, 845, 849, 850, 851, 852, 853, 857, 860, 861, 862, 872, 873, 874, 879, 880, 885, 886, 888]
[3, 10, 21, 25, 37, 53, 54, 69, 74, 77, 79, 80, 81, 82, 83, 109, 118, 122, 145, 146, 151, 154, 168, 191, 193, 198, 201, 234, 237, 239, 240, 242, 246, 248, 249, 255, 263, 285, 292, 306, 308, 336, 340, 360, 370, 383, 384, 394, 395, 397, 404, 405, 407, 411, 418, 425, 438, 440, 443, 477, 479, 483, 484, 490, 495, 498, 505, 507, 513, 520, 523, 534, 540, 554, 562, 567, 576, 578, 580, 587, 596, 603, 606, 616, 617, 620, 621, 624, 630, 635, 641, 652, 660, 666, 688, 695, 704, 720, 733, 738, 747, 749, 757, 758, 763, 769, 776, 777, 781, 798, 799, 804, 805, 809, 811, 841, 847, 863, 866, 869, 876, 887]

[2, 4, 5, 7, 8, 9, 10, 13, 14, 15, 16, 17, 18, 21, 22, 25, 26, 28, 30, 31, 32, 40, 42, 43, 45, 48, 50, 51, 55, 58, 60, 61, 63, 64, 65, 66, 71, 72, 73, 75, 78, 79, 85, 86, 87, 88, 90, 93, 94, 95, 99, 100, 101, 102, 104, 105, 106, 107, 110, 111, 112, 113, 116, 117, 118, 121, 123, 124, 125, 128, 130, 131, 133, 135, 136, 138, 139, 142, 145, 147, 148, 149, 154, 156, 157, 159, 160, 164, 166, 167, 168, 169, 171, 173, 174, 175, 176, 177, 181, 182, 184, 185, 193, 195, 197, 199, 201, 203, 204, 207, 216, 218, 219, 222, 224, 227, 228, 229, 230, 231, 232, 235, 237, 238, 240, 242, 243, 245, 246, 247, 248, 249, 251, 254, 255, 257, 259, 260, 261, 263, 266, 267, 268, 269, 270, 272, 273, 274, 275, 276, 278, 281, 284, 285, 286, 288, 289, 292, 294, 296, 300, 303, 305, 307, 308, 309, 313, 318, 319, 320, 322, 324, 325, 326, 327, 329, 332, 333, 335, 339, 340, 343, 344, 345, 346, 347, 349, 353, 354, 357, 360, 361, 362, 363, 365, 366, 369, 370, 371, 372, 376, 377, 380, 381, 384, 387, 388, 390, 391, 392, 394, 396, 407, 408, 409, 410, 411, 412, 414, 415, 416, 418, 419, 420, 421, 424, 425, 426, 427, 430, 432, 434, 435, 437, 438, 441, 442, 443, 444, 445, 448, 450, 451, 452, 453, 454, 456, 457, 458, 459, 460, 463, 464, 465, 466, 467, 468, 469, 470, 471, 473, 474, 475, 477, 478, 479, 480, 481, 482, 484, 485, 486, 487, 491, 492, 493, 495, 497, 498, 499, 500, 501, 502, 503, 504, 505, 506, 507, 509, 511, 512, 513, 515, 518, 520, 522, 523, 524, 525, 532, 533, 534, 536, 543, 544, 545, 546, 547, 548, 549, 552, 553, 554, 557, 559, 560, 562, 563, 566, 571, 572, 574, 575, 577, 579, 581, 582, 585, 586, 587, 588, 591, 593, 594, 596, 597, 601, 602, 603, 604, 605, 606, 607, 608, 611, 612, 613, 617, 618, 619, 622, 623, 625, 626, 627, 628, 629, 631, 633, 636, 638, 640, 642, 643, 646, 652, 653, 654, 655, 656, 659, 660, 664, 665, 666, 667, 668, 670, 672, 676, 677, 680, 681, 683, 687, 690, 691, 695, 699, 703, 704, 707, 710, 711, 714, 715, 716, 717, 720, 723, 724, 726, 731, 732, 733, 734, 738, 739, 740, 742, 746, 747, 749, 750, 756, 759, 762, 763, 764, 765, 767, 771, 773, 777, 779, 780, 781, 782, 783, 786, 788, 789, 791, 795, 799, 803, 804, 807, 815, 816, 820, 826, 827, 829, 831, 838, 839, 840, 842, 845, 849, 850, 851, 852, 853, 855, 856, 857, 859, 860, 861, 862, 866, 870, 872, 873, 874, 879, 880, 885, 886, 888]
[3, 10, 21, 25, 37, 53, 54, 69, 74, 77, 79, 80, 81, 82, 83, 109, 118, 122, 145, 146, 151, 154, 168, 191, 193, 198, 201, 234, 237, 239, 240, 242, 246, 248, 249, 255, 263, 285, 292, 306, 308, 336, 340, 360, 370, 383, 384, 394, 395, 397, 404, 405, 407, 411, 418, 425, 438, 440, 443, 477, 479, 483, 484, 490, 495, 498, 505, 507, 513, 520, 523, 534, 540, 554, 562, 567, 576, 578, 580, 587, 596, 603, 606, 616, 617, 620, 621, 624, 630, 635, 641, 652, 660, 666, 688, 695, 704, 720, 733, 738, 747, 749, 757, 758, 763, 769, 776, 777, 781, 798, 799, 804, 805, 809, 811, 841, 847, 863, 866, 869, 876, 887]

[0, 2, 4, 5, 6, 7, 8, 9, 10, 13, 14, 15, 16, 17, 18, 21, 22, 23, 25, 26, 28, 30, 31, 32, 40, 42, 43, 45, 48, 50, 51, 55, 58, 60, 61, 63, 64, 65, 66, 68, 70, 71, 72, 73, 75, 78, 79, 82, 85, 86, 87, 88, 90, 93, 94, 95, 99, 100, 101, 102, 103, 104, 105, 106, 107, 110, 111, 112, 113, 116, 117, 118, 120, 121, 122, 123, 124, 125, 126, 128, 129, 130, 131, 133, 135, 136, 137, 138, 139, 140, 141, 142, 145, 147, 148, 149, 154, 156, 157, 159, 160, 164, 166, 167, 168, 169, 171, 173, 174, 175, 176, 177, 180, 181, 182, 184, 185, 193, 195, 197, 199, 201, 203, 204, 205, 206, 207, 216, 217, 218, 219, 220, 221, 222, 223, 224, 225, 227, 228, 229, 230, 231, 232, 234, 235, 237, 238, 240, 241, 242, 243, 244, 245, 246, 247, 248, 249, 251, 254, 255, 257, 259, 260, 261, 263, 266, 267, 268, 269, 270, 272, 273, 274, 275, 276, 277, 278, 281, 284, 285, 286, 288, 289, 292, 294, 296, 300, 301, 303, 305, 307, 308, 309, 313, 317, 318, 319, 320, 322, 323, 324, 325, 326, 327, 328, 329, 332, 333, 335, 339, 340, 343, 344, 345, 346, 347, 349, 352, 353, 354, 356, 357, 358, 359, 360, 361, 362, 363, 365, 366, 368, 369, 370, 371, 372, 376, 377, 380, 381, 384, 387, 388, 390, 391, 392, 394, 396, 407, 408, 409, 410, 411, 412, 414, 415, 416, 418, 419, 420, 421, 424, 425, 426, 427, 430, 432, 433, 434, 435, 437, 438, 441, 442, 443, 444, 445, 448, 449, 450, 451, 452, 453, 454, 455, 456, 457, 458, 459, 460, 463, 464, 465, 466, 467, 468, 469, 470, 471, 473, 474, 475, 477, 478, 479, 480, 481, 482, 484, 485, 486, 487, 491, 492, 493, 495, 496, 497, 498, 499, 500, 501, 502, 503, 504, 505, 506, 507, 509, 511, 512, 513, 514, 515, 516, 518, 520, 522, 523, 524, 525, 532, 533, 534, 536, 543, 544, 545, 546, 547, 548, 549, 552, 553, 554, 556, 557, 558, 559, 560, 562, 563, 566, 570, 571, 572, 574, 575, 577, 579, 581, 582, 583, 585, 586, 587, 588, 591, 593, 594, 596, 597, 600, 601, 602, 603, 604, 605, 606, 607, 608, 610, 611, 612, 613, 617, 618, 619, 620, 622, 623, 625, 626, 627, 628, 629, 631, 632, 633, 636, 638, 640, 642, 643, 646, 652, 653, 654, 655, 656, 659, 660, 664, 665, 666, 667, 668, 670, 671, 672, 674, 676, 677, 680, 681, 683, 687, 690, 691, 695, 697, 699, 702, 703, 704, 707, 710, 711, 714, 715, 716, 717, 720, 721, 723, 724, 726, 731, 732, 733, 734, 735, 736, 738, 739, 740, 741, 742, 746, 747, 749, 750, 756, 758, 759, 762, 763, 764, 765, 767, 771, 772, 773, 775, 777, 779, 780, 781, 782, 783, 786, 788, 789, 791, 795, 796, 798, 799, 803, 804, 807, 810, 814, 815, 816, 820, 821, 824, 825, 826, 827, 828, 829, 831, 832, 834, 838, 839, 840, 841, 842, 843, 845, 849, 850, 851, 852, 853, 855, 856, 857, 859, 860, 861, 862, 866, 870, 872, 873, 874, 877, 878, 879, 880, 884, 885, 886, 888]
[3, 10, 21, 25, 37, 53, 54, 69, 74, 77, 79, 80, 81, 82, 83, 109, 118, 122, 145, 146, 151, 154, 168, 191, 193, 198, 201, 234, 237, 239, 240, 242, 246, 248, 249, 255, 263, 285, 292, 306, 308, 336, 340, 360, 370, 383, 384, 394, 395, 397, 404, 405, 407, 411, 418, 425, 438, 440, 443, 477, 479, 483, 484, 490, 495, 498, 505, 507, 513, 520, 523, 534, 540, 554, 562, 567, 576, 578, 580, 587, 596, 603, 606, 616, 617, 620, 621, 624, 630, 635, 641, 652, 660, 666, 688, 695, 704, 720, 733, 738, 747, 749, 757, 758, 763, 769, 776, 777, 781, 798, 799, 804, 805, 809, 811, 841, 847, 863, 866, 869, 876, 887]

[0, 1, 2, 4, 5, 6, 7, 8, 9, 10, 11, 12, 13, 14, 15, 16, 17, 18, 21, 22, 23, 25, 26, 28, 29, 30, 31, 32, 40, 42, 43, 45, 46, 48, 50, 51, 55, 56, 58, 59, 60, 61, 62, 63, 64, 65, 66, 68, 70, 71, 72, 73, 75, 78, 79, 80, 82, 85, 86, 87, 88, 90, 93, 94, 95, 96, 99, 100, 101, 102, 103, 104, 105, 106, 107, 110, 111, 112, 113, 115, 116, 117, 118, 120, 121, 122, 123, 124, 125, 126, 128, 129, 130, 131, 133, 134, 135, 136, 137, 138, 139, 140, 141, 142, 145, 147, 148, 149, 150, 153, 154, 156, 157, 158, 159, 160, 163, 164, 166, 167, 168, 169, 170, 171, 173, 174, 175, 176, 177, 180, 181, 182, 184, 185, 189, 190, 192, 193, 194, 195, 197, 198, 199, 201, 203, 204, 205, 206, 207, 216, 217, 218, 219, 220, 221, 222, 223, 224, 225, 227, 228, 229, 230, 231, 232, 234, 235, 237, 238, 239, 240, 241, 242, 243, 244, 245, 246, 247, 248, 249, 251, 252, 253, 254, 255, 257, 258, 259, 260, 261, 263, 264, 265, 266, 267, 268, 269, 270, 272, 273, 274, 275, 276, 277, 278, 279, 280, 281, 282, 284, 285, 286, 288, 289, 292, 294, 296, 300, 301, 303, 305, 307, 308, 309, 310, 313, 317, 318, 319, 320, 321, 322, 323, 324, 325, 326, 327, 328, 329, 332, 333, 335, 337, 339, 340, 342, 343, 344, 345, 346, 347, 348, 349, 352, 353, 354, 356, 357, 358, 359, 360, 361, 362, 363, 365, 366, 368, 369, 370, 371, 372, 375, 376, 377, 380, 381, 384, 387, 388, 389, 390, 391, 392, 394, 395, 396, 397, 400, 402, 407, 408, 409, 410, 411, 412, 414, 415, 416, 418, 419, 420, 421, 422, 424, 425, 426, 427, 430, 432, 433, 434, 435, 437, 438, 441, 442, 443, 444, 445, 448, 449, 450, 451, 452, 453, 454, 455, 456, 457, 458, 459, 460, 461, 462, 463, 464, 465, 466, 467, 468, 469, 470, 471, 472, 473, 474, 475, 477, 478, 479, 480, 481, 482, 484, 485, 486, 487, 488, 491, 492, 493, 495, 496, 497, 498, 499, 500, 501, 502, 503, 504, 505, 506, 507, 509, 511, 512, 513, 514, 515, 516, 518, 520, 522, 523, 524, 525, 528, 530, 532, 533, 534, 536, 537, 543, 544, 545, 546, 547, 548, 549, 552, 553, 554, 555, 556, 557, 558, 559, 560, 562, 563, 566, 570, 571, 572, 574, 575, 577, 579, 581, 582, 583, 584, 585, 586, 587, 588, 591, 593, 594, 596, 597, 598, 600, 601, 602, 603, 604, 605, 606, 607, 608, 609, 610, 611, 612, 613, 617, 618, 619, 620, 621, 622, 623, 625, 626, 627, 628, 629, 630, 631, 632, 633, 636, 638, 640, 642, 643, 644, 645, 646, 652, 653, 654, 655, 656, 657, 659, 660, 662, 664, 665, 666, 667, 668, 670, 671, 672, 674, 676, 677, 680, 681, 683, 685, 687, 690, 691, 695, 697, 698, 699, 702, 703, 704, 707, 708, 710, 711, 714, 715, 716, 717, 720, 721, 722, 723, 724, 726, 729, 731, 732, 733, 734, 735, 736, 738, 739, 740, 741, 742, 744, 745, 746, 747, 749, 750, 754, 756, 758, 759, 760, 762, 763, 764, 765, 767, 771, 772, 773, 774, 775, 777, 779, 780, 781, 782, 783, 786, 787, 788, 789, 791, 795, 796, 798, 799, 803, 804, 805, 807, 810, 812, 814, 815, 816, 820, 821, 823, 824, 825, 826, 827, 828, 829, 830, 831, 832, 834, 838, 839, 840, 841, 842, 843, 845, 847, 849, 850, 851, 852, 853, 855, 856, 857, 858, 859, 860, 861, 862, 865, 866, 870, 872, 873, 874, 877, 878, 879, 880, 884, 885, 886, 887, 888]
[3, 10, 21, 25, 37, 53, 54, 69, 74, 77, 79, 80, 81, 82, 83, 109, 118, 122, 145, 146, 151, 154, 168, 191, 193, 198, 201, 234, 237, 239, 240, 242, 246, 248, 249, 255, 263, 285, 292, 306, 308, 336, 340, 360, 370, 383, 384, 394, 395, 397, 404, 405, 407, 411, 418, 425, 438, 440, 443, 477, 479, 483, 484, 490, 495, 498, 505, 507, 513, 520, 523, 534, 540, 554, 562, 567, 576, 578, 580, 587, 596, 603, 606, 616, 617, 620, 621, 624, 630, 635, 641, 652, 660, 666, 688, 695, 704, 720, 733, 738, 747, 749, 757, 758, 763, 769, 776, 777, 781, 798, 799, 804, 805, 809, 811, 841, 847, 863, 866, 869, 876, 887]

[0, 1, 2, 3, 4, 5, 6, 7, 8, 9, 10, 11, 12, 13, 14, 15, 16, 17, 18, 19, 21, 22, 23, 25, 26, 27, 28, 29, 30, 31, 32, 35, 36, 37, 40, 42, 43, 45, 46, 48, 49, 50, 51, 52, 54, 55, 56, 58, 59, 60, 61, 62, 63, 64, 65, 66, 67, 68, 70, 71, 72, 73, 74, 75, 78, 79, 80, 81, 82, 83, 85, 86, 87, 88, 90, 93, 94, 95, 96, 99, 100, 101, 102, 103, 104, 105, 106, 107, 108, 110, 111, 112, 113, 114, 115, 116, 117, 118, 120, 121, 122, 123, 124, 125, 126, 128, 129, 130, 131, 133, 134, 135, 136, 137, 138, 139, 140, 141, 142, 145, 147, 148, 149, 150, 153, 154, 156, 157, 158, 159, 160, 161, 163, 164, 166, 167, 168, 169, 170, 171, 173, 174, 175, 176, 177, 180, 181, 182, 184, 185, 187, 188, 189, 190, 191, 192, 193, 194, 195, 197, 198, 199, 201, 203, 204, 205, 206, 207, 208, 216, 217, 218, 219, 220, 221, 222, 223, 224, 225, 226, 227, 228, 229, 230, 231, 232, 234, 235, 236, 237, 238, 239, 240, 241, 242, 243, 244, 245, 246, 247, 248, 249, 251, 252, 253, 254, 255, 257, 258, 259, 260, 261, 263, 264, 265, 266, 267, 268, 269, 270, 272, 273, 274, 275, 276, 277, 278, 279, 280, 281, 282, 284, 285, 286, 287, 288, 289, 290, 292, 293, 294, 295, 296, 298, 300, 301, 302, 303, 305, 306, 307, 308, 309, 310, 311, 313, 317, 318, 319, 320, 321, 322, 323, 324, 325, 326, 327, 328, 329, 332, 333, 335, 336, 337, 338, 339, 340, 342, 343, 344, 345, 346, 347, 348, 349, 350, 351, 352, 353, 354, 355, 356, 357, 358, 359, 360, 361, 362, 363, 364, 365, 366, 367, 368, 369, 370, 371, 372, 373, 375, 376, 377, 380, 381, 384, 386, 387, 388, 389, 390, 391, 392, 394, 395, 396, 397, 398, 400, 402, 407, 408, 409, 410, 411, 412, 414, 415, 416, 418, 419, 420, 421, 422, 424, 425, 426, 427, 429, 430, 432, 433, 434, 435, 437, 438, 439, 441, 442, 443, 444, 445, 448, 449, 450, 451, 452, 453, 454, 455, 456, 457, 458, 459, 460, 461, 462, 463, 464, 465, 466, 467, 468, 469, 470, 471, 472, 473, 474, 475, 476, 477, 478, 479, 480, 481, 482, 484, 485, 486, 487, 488, 491, 492, 493, 495, 496, 497, 498, 499, 500, 501, 502, 503, 504, 505, 506, 507, 509, 511, 512, 513, 514, 515, 516, 518, 520, 522, 523, 524, 525, 528, 530, 532, 533, 534, 535, 536, 537, 540, 543, 544, 545, 546, 547, 548, 549, 550, 551, 552, 553, 554, 555, 556, 557, 558, 559, 560, 561, 562, 563, 564, 566, 570, 571, 572, 573, 574, 575, 577, 579, 581, 582, 583, 584, 585, 586, 587, 588, 591, 593, 594, 596, 597, 598, 599, 600, 601, 602, 603, 604, 605, 606, 607, 608, 609, 610, 611, 612, 613, 617, 618, 619, 620, 621, 622, 623, 625, 626, 627, 628, 629, 630, 631, 632, 633, 636, 638, 639, 640, 642, 643, 644, 645, 646, 652, 653, 654, 655, 656, 657, 659, 660, 662, 664, 665, 666, 667, 668, 670, 671, 672, 674, 676, 677, 678, 680, 681, 683, 685, 687, 690, 691, 692, 695, 696, 697, 698, 699, 700, 701, 702, 703, 704, 705, 706, 707, 708, 710, 711, 712, 714, 715, 716, 717, 718, 720, 721, 722, 723, 724, 726, 729, 731, 732, 733, 734, 735, 736, 738, 739, 740, 741, 742, 744, 745, 746, 747, 749, 750, 754, 756, 758, 759, 760, 761, 762, 763, 764, 765, 766, 767, 771, 772, 773, 774, 775, 777, 778, 779, 780, 781, 782, 783, 785, 786, 787, 788, 789, 790, 791, 792, 795, 796, 798, 799, 801, 803, 804, 805, 807, 810, 812, 813, 814, 815, 816, 817, 820, 821, 823, 824, 825, 826, 827, 828, 829, 830, 831, 832, 833, 834, 838, 839, 840, 841, 842, 843, 845, 847, 849, 850, 851, 852, 853, 855, 856, 857, 858, 859, 860, 861, 862, 865, 866, 869, 870, 872, 873, 874, 877, 878, 879, 880, 881, 882, 883, 884, 885, 886, 887, 888]
[3, 10, 21, 25, 37, 53, 54, 69, 74, 77, 79, 80, 81, 82, 83, 109, 118, 122, 145, 146, 151, 154, 168, 191, 193, 198, 201, 234, 237, 239, 240, 242, 246, 248, 249, 255, 263, 285, 292, 306, 308, 336, 340, 360, 370, 383, 384, 394, 395, 397, 404, 405, 407, 411, 418, 425, 438, 440, 443, 477, 479, 483, 484, 490, 495, 498, 505, 507, 513, 520, 523, 534, 540, 554, 562, 567, 576, 578, 580, 587, 596, 603, 606, 616, 617, 620, 621, 624, 630, 635, 641, 652, 660, 666, 688, 695, 704, 720, 733, 738, 747, 749, 757, 758, 763, 769, 776, 777, 781, 798, 799, 804, 805, 809, 811, 841, 847, 863, 866, 869, 876, 887]

[0, 1, 2, 3, 4, 5, 6, 7, 8, 9, 10, 11, 12, 13, 14, 15, 16, 17, 18, 19, 21, 22, 23, 25, 26, 27, 28, 29, 30, 31, 32, 33, 35, 36, 37, 39, 40, 41, 42, 43, 45, 46, 48, 49, 50, 51, 52, 54, 55, 56, 57, 58, 59, 60, 61, 62, 63, 64, 65, 66, 67, 68, 69, 70, 71, 72, 73, 74, 75, 78, 79, 80, 81, 82, 83, 85, 86, 87, 88, 90, 92, 93, 94, 95, 96, 97, 98, 99, 100, 101, 102, 103, 104, 105, 106, 107, 108, 109, 110, 111, 112, 113, 114, 115, 116, 117, 118, 119, 120, 121, 122, 123, 124, 125, 126, 128, 129, 130, 131, 132, 133, 134, 135, 136, 137, 138, 139, 140, 141, 142, 144, 145, 146, 147, 148, 149, 150, 151, 153, 154, 156, 157, 158, 159, 160, 161, 163, 164, 166, 167, 168, 169, 170, 171, 172, 173, 174, 175, 176, 177, 179, 180, 181, 182, 183, 184, 185, 186, 187, 188, 189, 190, 191, 192, 193, 194, 195, 197, 198, 199, 201, 203, 204, 205, 206, 207, 208, 210, 211, 214, 216, 217, 218, 219, 220, 221, 222, 223, 224, 225, 226, 227, 228, 229, 230, 231, 232, 234, 235, 236, 237, 238, 239, 240, 241, 242, 243, 244, 245, 246, 247, 248, 249, 251, 252, 253, 254, 255, 257, 258, 259, 260, 261, 262, 263, 264, 265, 266, 267, 268, 269, 270, 271, 272, 273, 274, 275, 276, 277, 278, 279, 280, 281, 282, 283, 284, 285, 286, 287, 288, 289, 290, 291, 292, 293, 294, 295, 296, 297, 298, 300, 301, 302, 303, 305, 306, 307, 308, 309, 310, 311, 312, 313, 314, 316, 317, 318, 319, 320, 321, 322, 323, 324, 325, 326, 327, 328, 329, 332, 333, 334, 335, 336, 337, 338, 339, 340, 342, 343, 344, 345, 346, 347, 348, 349, 350, 351, 352, 353, 354, 355, 356, 357, 358, 359, 360, 361, 362, 363, 364, 365, 366, 367, 368, 369, 370, 371, 372, 373, 374, 375, 376, 377, 380, 381, 382, 384, 386, 387, 388, 389, 390, 391, 392, 393, 394, 395, 396, 397, 398, 400, 401, 402, 403, 407, 408, 409, 410, 411, 412, 413, 414, 415, 416, 418, 419, 420, 421, 422, 424, 425, 426, 427, 429, 430, 432, 433, 434, 435, 437, 438, 439, 440, 441, 442, 443, 444, 445, 447, 448, 449, 450, 451, 452, 453, 454, 455, 456, 457, 458, 459, 460, 461, 462, 463, 464, 465, 466, 467, 468, 469, 470, 471, 472, 473, 474, 475, 476, 477, 478, 479, 480, 481, 482, 483, 484, 485, 486, 487, 488, 489, 491, 492, 493, 494, 495, 496, 497, 498, 499, 500, 501, 502, 503, 504, 505, 506, 507, 509, 511, 512, 513, 514, 515, 516, 517, 518, 520, 522, 523, 524, 525, 526, 528, 529, 530, 532, 533, 534, 535, 536, 537, 540, 541, 543, 544, 545, 546, 547, 548, 549, 550, 551, 552, 553, 554, 555, 556, 557, 558, 559, 560, 561, 562, 563, 564, 565, 566, 570, 571, 572, 573, 574, 575, 577, 578, 579, 581, 582, 583, 584, 585, 586, 587, 588, 589, 591, 593, 594, 595, 596, 597, 598, 599, 600, 601, 602, 603, 604, 605, 606, 607, 608, 609, 610, 611, 612, 613, 615, 617, 618, 619, 620, 621, 622, 623, 624, 625, 626, 627, 628, 629, 630, 631, 632, 633, 636, 638, 639, 640, 642, 643, 644, 645, 646, 647, 649, 650, 651, 652, 653, 654, 655, 656, 657, 658, 659, 660, 661, 662, 664, 665, 666, 667, 668, 669, 670, 671, 672, 673, 674, 676, 677, 678, 680, 681, 682, 683, 685, 687, 689, 690, 691, 692, 695, 696, 697, 698, 699, 700, 701, 702, 703, 704, 705, 706, 707, 708, 710, 711, 712, 714, 715, 716, 717, 718, 719, 720, 721, 722, 723, 724, 726, 729, 731, 732, 733, 734, 735, 736, 738, 739, 740, 741, 742, 744, 745, 746, 747, 748, 749, 750, 753, 754, 756, 758, 759, 760, 761, 762, 763, 764, 765, 766, 767, 768, 769, 770, 771, 772, 773, 774, 775, 776, 777, 778, 779, 780, 781, 782, 783, 784, 785, 786, 787, 788, 789, 790, 791, 792, 794, 795, 796, 798, 799, 801, 803, 804, 805, 807, 809, 810, 812, 813, 814, 815, 816, 817, 820, 821, 823, 824, 825, 826, 827, 828, 829, 830, 831, 832, 833, 834, 835, 837, 838, 839, 840, 841, 842, 843, 845, 847, 849, 850, 851, 852, 853, 855, 856, 857, 858, 859, 860, 861, 862, 865, 866, 867, 868, 869, 870, 872, 873, 874, 876, 877, 878, 879, 880, 881, 882, 883, 884, 885, 886, 887, 888, 889]
[3, 10, 21, 25, 37, 53, 54, 69, 74, 77, 79, 80, 81, 82, 83, 109, 118, 122, 145, 146, 151, 154, 168, 191, 193, 198, 201, 234, 237, 239, 240, 242, 246, 248, 249, 255, 263, 285, 292, 306, 308, 336, 340, 360, 370, 383, 384, 394, 395, 397, 404, 405, 407, 411, 418, 425, 438, 440, 443, 477, 479, 483, 484, 490, 495, 498, 505, 507, 513, 520, 523, 534, 540, 554, 562, 567, 576, 578, 580, 587, 596, 603, 606, 616, 617, 620, 621, 624, 630, 635, 641, 652, 660, 666, 688, 695, 704, 720, 733, 738, 747, 749, 757, 758, 763, 769, 776, 777, 781, 798, 799, 804, 805, 809, 811, 841, 847, 863, 866, 869, 876, 887]

