[16, 24, 27, 121, 224, 227, 293, 341, 396, 428, 437, 468, 476, 521, 542, 582, 653, 659, 703, 716, 755, 771]
[0, 58, 65, 79, 100, 101, 180, 195, 245, 247, 343, 347, 433, 438, 453, 455, 462, 514, 569, 601, 782, 841]

[16, 24, 27, 121, 224, 227, 293, 341, 396, 428, 437, 468, 476, 521, 542, 582, 653, 659, 703, 716, 755, 771]
[0, 5, 17, 18, 21, 29, 35, 41, 47, 48, 58, 65, 69, 72, 74, 76, 79, 94, 96, 100, 101, 102, 105, 115, 124, 126, 132, 146, 155, 170, 171, 172, 178, 180, 195, 199, 205, 218, 238, 245, 247, 265, 280, 281, 285, 294, 298, 302, 304, 305, 308, 317, 326, 333, 336, 343, 347, 358, 364, 376, 382, 391, 393, 398, 403, 433, 438, 442, 453, 455, 458, 462, 470, 473, 484, 506, 514, 516, 520, 523, 524, 525, 528, 535, 539, 555, 558, 559, 560, 561, 569, 583, 595, 601, 604, 608, 657, 662, 668, 675, 680, 681, 684, 700, 702, 718, 720, 728, 748, 750, 769, 773, 777, 782, 806, 816, 832, 841, 842, 848, 859, 889]

[1, 16, 21, 24, 26, 27, 36, 42, 48, 53, 56, 66, 77, 80, 96, 100, 103, 112, 121, 128, 147, 204, 206, 207, 215, 222, 224, 227, 247, 265, 272, 274, 277, 285, 288, 293, 296, 317, 341, 345, 385, 396, 399, 414, 428, 437, 448, 454, 468, 476, 479, 485, 487, 512, 516, 521, 542, 543, 546, 565, 582, 596, 603, 617, 624, 627, 633, 653, 659, 667, 683, 688, 703, 711, 716, 717, 735, 748, 755, 759, 760, 761, 765, 771, 784, 808, 830, 832, 841, 842, 844, 847, 848, 864, 874, 877, 887]
[0, 5, 17, 18, 21, 29, 35, 41, 47, 48, 58, 65, 69, 72, 74, 76, 79, 94, 96, 100, 101, 102, 105, 115, 124, 126, 132, 146, 155, 170, 171, 172, 178, 180, 195, 199, 205, 218, 238, 245, 247, 265, 280, 281, 285, 294, 298, 302, 304, 305, 308, 317, 326, 333, 336, 343, 347, 358, 364, 376, 382, 391, 393, 398, 403, 433, 438, 442, 453, 455, 458, 462, 470, 473, 484, 506, 514, 516, 520, 523, 524, 525, 528, 535, 539, 555, 558, 559, 560, 561, 569, 583, 595, 601, 604, 608, 657, 662, 668, 675, 680, 681, 684, 700, 702, 718, 720, 728, 748, 750, 769, 773, 777, 782, 806, 816, 832, 841, 842, 848, 859, 889]

[1, 5, 6, 7, 10, 16, 20, 21, 24, 26, 27, 36, 42, 48, 53, 56, 58, 65, 66, 70, 75, 77, 79, 80, 83, 94, 96, 100, 103, 104, 112, 118, 121, 123, 128, 129, 132, 133, 134, 136, 147, 155, 159, 181, 204, 206, 207, 215, 222, 223, 224, 227, 236, 239, 242, 247, 265, 269, 272, 274, 277, 278, 285, 288, 293, 296, 297, 309, 311, 317, 341, 345, 346, 351, 364, 365, 374, 385, 389, 396, 399, 405, 414, 416, 417, 420, 422, 427, 428, 437, 448, 449, 454, 468, 471, 476, 479, 485, 487, 490, 503, 512, 516, 518, 521, 526, 542, 543, 546, 559, 564, 565, 582, 593, 596, 603, 604, 617, 624, 627, 633, 637, 638, 646, 653, 659, 667, 674, 681, 683, 688, 698, 701, 703, 711, 716, 717, 735, 748, 755, 759, 760, 761, 764, 765, 768, 771, 782, 783, 784, 785, 786, 797, 808, 810, 829, 830, 832, 833, 841, 842, 844, 847, 848, 860, 862, 864, 866, 874, 877, 882, 887]
[0, 5, 17, 18, 21, 29, 35, 41, 47, 48, 58, 65, 69, 72, 74, 76, 79, 94, 96, 100, 101, 102, 105, 115, 124, 126, 132, 146, 155, 170, 171, 172, 178, 180, 195, 199, 205, 218, 238, 245, 247, 265, 280, 281, 285, 294, 298, 302, 304, 305, 308, 317, 326, 333, 336, 343, 347, 358, 364, 376, 382, 391, 393, 398, 403, 433, 438, 442, 453, 455, 458, 462, 470, 473, 484, 506, 514, 516, 520, 523, 524, 525, 528, 535, 539, 555, 558, 559, 560, 561, 569, 583, 595, 601, 604, 608, 657, 662, 668, 675, 680, 681, 684, 700, 702, 718, 720, 728, 748, 750, 769, 773, 777, 782, 806, 816, 832, 841, 842, 848, 859, 889]

[1, 2, 5, 6, 7, 10, 12, 16, 20, 21, 23, 24, 26, 27, 36, 39, 41, 42, 48, 49, 53, 56, 58, 65, 66, 70, 75, 77, 79, 80, 81, 83, 84, 94, 96, 100, 103, 104, 109, 112, 118, 121, 123, 128, 129, 132, 133, 134, 136, 144, 147, 152, 155, 157, 159, 165, 175, 179, 181, 197, 201, 204, 205, 206, 207, 215, 220, 222, 223, 224, 227, 236, 239, 240, 242, 243, 246, 247, 261, 265, 268, 269, 272, 274, 276, 277, 278, 285, 288, 293, 296, 297, 309, 311, 317, 327, 337, 341, 344, 345, 346, 351, 364, 365, 374, 377, 385, 389, 390, 395, 396, 398, 399, 405, 406, 414, 416, 417, 420, 422, 427, 428, 434, 437, 448, 449, 454, 458, 464, 468, 471, 476, 477, 479, 481, 482, 485, 487, 490, 494, 503, 508, 510, 512, 515, 516, 518, 521, 526, 529, 537, 542, 543, 546, 552, 559, 561, 564, 565, 568, 570, 578, 582, 584, 593, 596, 598, 603, 604, 606, 616, 617, 624, 627, 633, 634, 637, 638, 644, 646, 650, 653, 657, 659, 664, 667, 673, 674, 679, 681, 683, 688, 698, 701, 703, 711, 714, 716, 717, 719, 732, 735, 738, 748, 755, 759, 760, 761, 762, 764, 765, 768, 769, 771, 782, 783, 784, 785, 786, 792, 797, 806, 808, 810, 818, 829, 830, 832, 833, 837, 841, 842, 843, 844, 847, 848, 850, 854, 860, 862, 864, 866, 874, 877, 882, 887, 889]
[0, 5, 17, 18, 21, 29, 35, 41, 47, 48, 58, 65, 69, 72, 74, 76, 79, 94, 96, 100, 101, 102, 105, 115, 124, 126, 132, 146, 155, 170, 171, 172, 178, 180, 195, 199, 205, 218, 238, 245, 247, 265, 280, 281, 285, 294, 298, 302, 304, 305, 308, 317, 326, 333, 336, 343, 347, 358, 364, 376, 382, 391, 393, 398, 403, 433, 438, 442, 453, 455, 458, 462, 470, 473, 484, 506, 514, 516, 520, 523, 524, 525, 528, 535, 539, 555, 558, 559, 560, 561, 569, 583, 595, 601, 604, 608, 657, 662, 668, 675, 680, 681, 684, 700, 702, 718, 720, 728, 748, 750, 769, 773, 777, 782, 806, 816, 832, 841, 842, 848, 859, 889]

[1, 2, 5, 6, 7, 10, 12, 16, 20, 21, 23, 24, 26, 27, 28, 31, 36, 39, 41, 42, 48, 49, 53, 56, 57, 58, 62, 65, 66, 70, 72, 74, 75, 77, 78, 79, 80, 81, 82, 83, 84, 94, 96, 100, 101, 103, 104, 109, 112, 118, 121, 123, 125, 128, 129, 132, 133, 134, 136, 138, 141, 144, 147, 152, 155, 157, 159, 165, 169, 175, 179, 181, 183, 195, 197, 201, 204, 205, 206, 207, 215, 220, 222, 223, 224, 227, 230, 236, 239, 240, 242, 243, 246, 247, 249, 251, 253, 256, 258, 260, 261, 262, 265, 268, 269, 272, 274, 276, 277, 278, 285, 288, 293, 294, 296, 297, 299, 301, 304, 309, 311, 317, 318, 321, 325, 327, 337, 341, 344, 345, 346, 351, 352, 361, 364, 365, 374, 376, 377, 384, 385, 387, 389, 390, 391, 395, 396, 397, 398, 399, 405, 406, 414, 416, 417, 420, 422, 427, 428, 434, 437, 446, 448, 449, 450, 454, 457, 458, 463, 464, 465, 468, 469, 471, 472, 476, 477, 479, 481, 482, 485, 487, 490, 494, 503, 504, 508, 510, 512, 515, 516, 518, 521, 526, 529, 534, 537, 542, 543, 546, 548, 552, 559, 561, 564, 565, 568, 570, 574, 576, 577, 578, 582, 584, 593, 595, 596, 598, 603, 604, 606, 615, 616, 617, 622, 624, 627, 633, 634, 637, 638, 640, 643, 644, 646, 650, 653, 657, 659, 660, 664, 667, 673, 674, 675, 678, 679, 681, 683, 686, 687, 688, 693, 695, 698, 701, 703, 711, 714, 716, 717, 719, 724, 732, 735, 738, 748, 755, 759, 760, 761, 762, 764, 765, 766, 767, 768, 769, 771, 782, 783, 784, 785, 786, 792, 795, 797, 806, 808, 810, 818, 823, 829, 830, 832, 833, 837, 838, 841, 842, 843, 844, 847, 848, 850, 852, 853, 854, 857, 859, 860, 862, 864, 866, 873, 874, 877, 881, 882, 883, 887, 889]
[0, 5, 17, 18, 21, 29, 35, 41, 47, 48, 58, 65, 69, 72, 74, 76, 79, 94, 96, 100, 101, 102, 105, 115, 124, 126, 132, 146, 155, 170, 171, 172, 178, 180, 195, 199, 205, 218, 238, 245, 247, 265, 280, 281, 285, 294, 298, 302, 304, 305, 308, 317, 326, 333, 336, 343, 347, 358, 364, 376, 382, 391, 393, 398, 403, 433, 438, 442, 453, 455, 458, 462, 470, 473, 484, 506, 514, 516, 520, 523, 524, 525, 528, 535, 539, 555, 558, 559, 560, 561, 569, 583, 595, 601, 604, 608, 657, 662, 668, 675, 680, 681, 684, 700, 702, 718, 720, 728, 748, 750, 769, 773, 777, 782, 806, 816, 832, 841, 842, 848, 859, 889]

[1, 2, 3, 5, 6, 7, 10, 12, 16, 20, 21, 23, 24, 25, 26, 27, 28, 31, 35, 36, 38, 39, 41, 42, 48, 49, 53, 56, 57, 58, 62, 63, 65, 66, 67, 70, 72, 74, 75, 77, 78, 79, 80, 81, 82, 83, 84, 94, 95, 96, 97, 99, 100, 101, 103, 104, 109, 112, 118, 119, 121, 122, 123, 124, 125, 128, 129, 132, 133, 134, 136, 138, 141, 142, 144, 145, 146, 147, 151, 152, 154, 155, 157, 159, 165, 166, 169, 175, 179, 181, 183, 185, 193, 195, 197, 201, 202, 204, 205, 206, 207, 215, 217, 220, 222, 223, 224, 227, 230, 236, 239, 240, 242, 243, 246, 247, 249, 251, 253, 256, 258, 260, 261, 262, 265, 268, 269, 271, 272, 274, 276, 277, 278, 283, 285, 288, 289, 293, 294, 296, 297, 299, 301, 304, 309, 311, 313, 317, 318, 321, 325, 327, 337, 341, 342, 344, 345, 346, 351, 352, 361, 364, 365, 369, 374, 375, 376, 377, 381, 383, 384, 385, 387, 389, 390, 391, 395, 396, 397, 398, 399, 405, 406, 412, 414, 416, 417, 420, 422, 426, 427, 428, 430, 434, 437, 440, 446, 448, 449, 450, 454, 457, 458, 463, 464, 465, 468, 469, 471, 472, 476, 477, 479, 481, 482, 485, 487, 490, 494, 495, 503, 504, 505, 508, 510, 512, 514, 515, 516, 518, 521, 525, 526, 529, 534, 537, 542, 543, 546, 548, 552, 559, 560, 561, 564, 565, 567, 568, 569, 570, 574, 576, 577, 578, 582, 583, 584, 592, 593, 595, 596, 598, 603, 604, 606, 607, 608, 613, 614, 615, 616, 617, 622, 624, 626, 627, 633, 634, 637, 638, 640, 643, 644, 646, 650, 652, 653, 657, 659, 660, 664, 667, 672, 673, 674, 675, 677, 678, 679, 681, 683, 686, 687, 688, 693, 695, 696, 697, 698, 701, 703, 711, 714, 715, 716, 717, 718, 719, 721, 723, 724, 732, 735, 737, 738, 748, 749, 753, 754, 755, 758, 759, 760, 761, 762, 764, 765, 766, 767, 768, 769, 771, 774, 781, 782, 783, 784, 785, 786, 790, 792, 793, 795, 797, 798, 799, 806, 808, 809, 810, 818, 823, 827, 829, 830, 832, 833, 837, 838, 841, 842, 843, 844, 847, 848, 850, 852, 853, 854, 855, 857, 859, 860, 862, 863, 864, 866, 873, 874, 876, 877, 881, 882, 883, 887, 888, 889]
[0, 5, 17, 18, 21, 29, 35, 41, 47, 48, 58, 65, 69, 72, 74, 76, 79, 94, 96, 100, 101, 102, 105, 115, 124, 126, 132, 146, 155, 170, 171, 172, 178, 180, 195, 199, 205, 218, 238, 245, 247, 265, 280, 281, 285, 294, 298, 302, 304, 305, 308, 317, 326, 333, 336, 343, 347, 358, 364, 376, 382, 391, 393, 398, 403, 433, 438, 442, 453, 455, 458, 462, 470, 473, 484, 506, 514, 516, 520, 523, 524, 525, 528, 535, 539, 555, 558, 559, 560, 561, 569, 583, 595, 601, 604, 608, 657, 662, 668, 675, 680, 681, 684, 700, 702, 718, 720, 728, 748, 750, 769, 773, 777, 782, 806, 816, 832, 841, 842, 848, 859, 889]

[1, 2, 3, 5, 6, 7, 10, 12, 13, 16, 17, 20, 21, 22, 23, 24, 25, 26, 27, 28, 31, 35, 36, 38, 39, 41, 42, 47, 48, 49, 53, 54, 56, 57, 58, 62, 63, 64, 65, 66, 67, 70, 72, 74, 75, 77, 78, 79, 80, 81, 82, 83, 84, 87, 91, 92, 94, 95, 96, 97, 99, 100, 101, 102, 103, 104, 109, 112, 118, 119, 121, 122, 123, 124, 125, 128, 129, 132, 133, 134, 136, 138, 141, 142, 144, 145, 146, 147, 149, 151, 152, 153, 154, 155, 157, 159, 165, 166, 168, 169, 174, 175, 178, 179, 180, 181, 183, 184, 185, 191, 193, 195, 197, 199, 201, 202, 204, 205, 206, 207, 210, 212, 215, 217, 219, 220, 222, 223, 224, 226, 227, 230, 236, 239, 240, 242, 243, 246, 247, 249, 251, 253, 254, 256, 258, 260, 261, 262, 265, 266, 267, 268, 269, 271, 272, 274, 276, 277, 278, 279, 283, 285, 288, 289, 293, 294, 296, 297, 299, 301, 304, 305, 309, 311, 313, 317, 318, 321, 325, 327, 330, 337, 338, 341, 342, 343, 344, 345, 346, 348, 351, 352, 361, 364, 365, 368, 369, 371, 373, 374, 375, 376, 377, 381, 382, 383, 384, 385, 386, 387, 388, 389, 390, 391, 395, 396, 397, 398, 399, 405, 406, 412, 414, 416, 417, 420, 422, 424, 426, 427, 428, 430, 434, 437, 440, 441, 446, 448, 449, 450, 453, 454, 457, 458, 460, 463, 464, 465, 466, 468, 469, 471, 472, 476, 477, 479, 481, 482, 485, 486, 487, 490, 494, 495, 497, 503, 504, 505, 508, 510, 512, 514, 515, 516, 517, 518, 521, 525, 526, 529, 531, 533, 534, 537, 542, 543, 544, 546, 547, 548, 552, 554, 559, 560, 561, 564, 565, 566, 567, 568, 569, 570, 572, 574, 576, 577, 578, 582, 583, 584, 590, 592, 593, 595, 596, 598, 603, 604, 606, 607, 608, 612, 613, 614, 615, 616, 617, 618, 622, 624, 626, 627, 633, 634, 635, 637, 638, 640, 643, 644, 646, 648, 650, 652, 653, 657, 659, 660, 664, 667, 670, 672, 673, 674, 675, 677, 678, 679, 681, 683, 684, 686, 687, 688, 693, 695, 696, 697, 698, 701, 702, 703, 704, 706, 708, 711, 714, 715, 716, 717, 718, 719, 721, 723, 724, 732, 735, 737, 738, 739, 746, 747, 748, 749, 753, 754, 755, 756, 758, 759, 760, 761, 762, 764, 765, 766, 767, 768, 769, 771, 773, 774, 780, 781, 782, 783, 784, 785, 786, 790, 792, 793, 795, 797, 798, 799, 806, 808, 809, 810, 814, 815, 818, 823, 824, 827, 829, 830, 832, 833, 837, 838, 841, 842, 843, 844, 847, 848, 850, 852, 853, 854, 855, 857, 859, 860, 862, 863, 864, 866, 868, 873, 874, 876, 877, 881, 882, 883, 886, 887, 888, 889]
[0, 5, 17, 18, 21, 29, 35, 41, 47, 48, 58, 65, 69, 72, 74, 76, 79, 94, 96, 100, 101, 102, 105, 115, 124, 126, 132, 146, 155, 170, 171, 172, 178, 180, 195, 199, 205, 218, 238, 245, 247, 265, 280, 281, 285, 294, 298, 302, 304, 305, 308, 317, 326, 333, 336, 343, 347, 358, 364, 376, 382, 391, 393, 398, 403, 433, 438, 442, 453, 455, 458, 462, 470, 473, 484, 506, 514, 516, 520, 523, 524, 525, 528, 535, 539, 555, 558, 559, 560, 561, 569, 583, 595, 601, 604, 608, 657, 662, 668, 675, 680, 681, 684, 700, 702, 718, 720, 728, 748, 750, 769, 773, 777, 782, 806, 816, 832, 841, 842, 848, 859, 889]

[1, 2, 3, 5, 6, 7, 8, 10, 12, 13, 16, 17, 20, 21, 22, 23, 24, 25, 26, 27, 28, 29, 31, 33, 34, 35, 36, 38, 39, 41, 42, 47, 48, 49, 50, 53, 54, 56, 57, 58, 60, 61, 62, 63, 64, 65, 66, 67, 68, 70, 72, 74, 75, 77, 78, 79, 80, 81, 82, 83, 84, 87, 88, 91, 92, 94, 95, 96, 97, 98, 99, 100, 101, 102, 103, 104, 109, 112, 115, 116, 118, 119, 121, 122, 123, 124, 125, 126, 128, 129, 131, 132, 133, 134, 136, 138, 140, 141, 142, 144, 145, 146, 147, 149, 151, 152, 153, 154, 155, 156, 157, 159, 165, 166, 168, 169, 170, 174, 175, 178, 179, 180, 181, 183, 184, 185, 189, 190, 191, 193, 195, 197, 199, 200, 201, 202, 204, 205, 206, 207, 209, 210, 212, 215, 217, 219, 220, 222, 223, 224, 226, 227, 230, 234, 235, 236, 239, 240, 242, 243, 244, 245, 246, 247, 249, 251, 253, 254, 256, 258, 260, 261, 262, 265, 266, 267, 268, 269, 271, 272, 274, 276, 277, 278, 279, 282, 283, 285, 287, 288, 289, 291, 293, 294, 296, 297, 298, 299, 301, 304, 305, 309, 310, 311, 312, 313, 317, 318, 321, 325, 326, 327, 330, 335, 337, 338, 341, 342, 343, 344, 345, 346, 348, 351, 352, 353, 355, 361, 363, 364, 365, 368, 369, 371, 373, 374, 375, 376, 377, 381, 382, 383, 384, 385, 386, 387, 388, 389, 390, 391, 395, 396, 397, 398, 399, 405, 406, 407, 410, 412, 414, 416, 417, 420, 422, 424, 426, 427, 428, 430, 434, 436, 437, 440, 441, 443, 446, 448, 449, 450, 453, 454, 455, 457, 458, 459, 460, 463, 464, 465, 466, 467, 468, 469, 470, 471, 472, 476, 477, 479, 481, 482, 483, 485, 486, 487, 490, 494, 495, 497, 498, 500, 503, 504, 505, 508, 510, 511, 512, 514, 515, 516, 517, 518, 519, 521, 523, 524, 525, 526, 528, 529, 530, 531, 533, 534, 537, 538, 542, 543, 544, 546, 547, 548, 549, 552, 554, 556, 559, 560, 561, 564, 565, 566, 567, 568, 569, 570, 572, 574, 576, 577, 578, 579, 582, 583, 584, 585, 589, 590, 592, 593, 595, 596, 598, 603, 604, 606, 607, 608, 609, 612, 613, 614, 615, 616, 617, 618, 622, 624, 626, 627, 628, 633, 634, 635, 637, 638, 640, 643, 644, 646, 648, 650, 652, 653, 655, 656, 657, 658, 659, 660, 661, 664, 667, 670, 672, 673, 674, 675, 677, 678, 679, 681, 683, 684, 686, 687, 688, 693, 694, 695, 696, 697, 698, 701, 702, 703, 704, 706, 708, 711, 712, 714, 715, 716, 717, 718, 719, 721, 723, 724, 732, 735, 737, 738, 739, 740, 746, 747, 748, 749, 750, 753, 754, 755, 756, 758, 759, 760, 761, 762, 763, 764, 765, 766, 767, 768, 769, 770, 771, 773, 774, 780, 781, 782, 783, 784, 785, 786, 788, 790, 792, 793, 795, 797, 798, 799, 806, 808, 809, 810, 811, 813, 814, 815, 818, 821, 823, 824, 827, 828, 829, 830, 832, 833, 837, 838, 841, 842, 843, 844, 845, 847, 848, 850, 852, 853, 854, 855, 857, 859, 860, 862, 863, 864, 866, 868, 871, 873, 874, 875, 876, 877, 881, 882, 883, 886, 887, 888, 889]
[0, 5, 17, 18, 21, 29, 35, 41, 47, 48, 58, 65, 69, 72, 74, 76, 79, 94, 96, 100, 101, 102, 105, 115, 124, 126, 132, 146, 155, 170, 171, 172, 178, 180, 195, 199, 205, 218, 238, 245, 247, 265, 280, 281, 285, 294, 298, 302, 304, 305, 308, 317, 326, 333, 336, 343, 347, 358, 364, 376, 382, 391, 393, 398, 403, 433, 438, 442, 453, 455, 458, 462, 470, 473, 484, 506, 514, 516, 520, 523, 524, 525, 528, 535, 539, 555, 558, 559, 560, 561, 569, 583, 595, 601, 604, 608, 657, 662, 668, 675, 680, 681, 684, 700, 702, 718, 720, 728, 748, 750, 769, 773, 777, 782, 806, 816, 832, 841, 842, 848, 859, 889]

[0, 1, 2, 3, 5, 6, 7, 8, 10, 12, 13, 14, 16, 17, 20, 21, 22, 23, 24, 25, 26, 27, 28, 29, 31, 33, 34, 35, 36, 38, 39, 41, 42, 47, 48, 49, 50, 51, 53, 54, 56, 57, 58, 60, 61, 62, 63, 64, 65, 66, 67, 68, 69, 70, 72, 73, 74, 75, 77, 78, 79, 80, 81, 82, 83, 84, 87, 88, 91, 92, 93, 94, 95, 96, 97, 98, 99, 100, 101, 102, 103, 104, 109, 112, 115, 116, 118, 119, 120, 121, 122, 123, 124, 125, 126, 127, 128, 129, 131, 132, 133, 134, 136, 138, 140, 141, 142, 144, 145, 146, 147, 149, 151, 152, 153, 154, 155, 156, 157, 159, 161, 162, 164, 165, 166, 167, 168, 169, 170, 173, 174, 175, 178, 179, 180, 181, 183, 184, 185, 189, 190, 191, 193, 195, 197, 199, 200, 201, 202, 204, 205, 206, 207, 208, 209, 210, 211, 212, 215, 217, 219, 220, 222, 223, 224, 225, 226, 227, 230, 231, 233, 234, 235, 236, 239, 240, 242, 243, 244, 245, 246, 247, 249, 251, 253, 254, 255, 256, 258, 260, 261, 262, 263, 265, 266, 267, 268, 269, 271, 272, 274, 276, 277, 278, 279, 280, 282, 283, 285, 287, 288, 289, 290, 291, 292, 293, 294, 295, 296, 297, 298, 299, 301, 303, 304, 305, 307, 309, 310, 311, 312, 313, 316, 317, 318, 321, 324, 325, 326, 327, 330, 332, 335, 337, 338, 341, 342, 343, 344, 345, 346, 348, 350, 351, 352, 353, 355, 357, 361, 363, 364, 365, 366, 368, 369, 371, 373, 374, 375, 376, 377, 380, 381, 382, 383, 384, 385, 386, 387, 388, 389, 390, 391, 392, 395, 396, 397, 398, 399, 405, 406, 407, 410, 411, 412, 414, 416, 417, 420, 422, 423, 424, 425, 426, 427, 428, 430, 431, 434, 436, 437, 440, 441, 443, 446, 447, 448, 449, 450, 451, 453, 454, 455, 457, 458, 459, 460, 461, 462, 463, 464, 465, 466, 467, 468, 469, 470, 471, 472, 476, 477, 479, 481, 482, 483, 484, 485, 486, 487, 489, 490, 491, 494, 495, 497, 498, 499, 500, 502, 503, 504, 505, 506, 508, 510, 511, 512, 514, 515, 516, 517, 518, 519, 520, 521, 523, 524, 525, 526, 527, 528, 529, 530, 531, 533, 534, 537, 538, 542, 543, 544, 546, 547, 548, 549, 552, 554, 556, 557, 559, 560, 561, 564, 565, 566, 567, 568, 569, 570, 572, 574, 576, 577, 578, 579, 581, 582, 583, 584, 585, 589, 590, 592, 593, 595, 596, 597, 598, 602, 603, 604, 606, 607, 608, 609, 612, 613, 614, 615, 616, 617, 618, 619, 621, 622, 624, 626, 627, 628, 630, 633, 634, 635, 637, 638, 639, 640, 643, 644, 646, 648, 650, 652, 653, 654, 655, 656, 657, 658, 659, 660, 661, 664, 666, 667, 670, 672, 673, 674, 675, 676, 677, 678, 679, 681, 683, 684, 685, 686, 687, 688, 692, 693, 694, 695, 696, 697, 698, 700, 701, 702, 703, 704, 706, 707, 708, 710, 711, 712, 714, 715, 716, 717, 718, 719, 721, 723, 724, 726, 730, 731, 732, 735, 737, 738, 739, 740, 741, 746, 747, 748, 749, 750, 753, 754, 755, 756, 758, 759, 760, 761, 762, 763, 764, 765, 766, 767, 768, 769, 770, 771, 772, 773, 774, 780, 781, 782, 783, 784, 785, 786, 787, 788, 789, 790, 791, 792, 793, 795, 797, 798, 799, 806, 808, 809, 810, 811, 813, 814, 815, 817, 818, 819, 821, 823, 824, 827, 828, 829, 830, 832, 833, 835, 837, 838, 841, 842, 843, 844, 845, 847, 848, 850, 851, 852, 853, 854, 855, 857, 859, 860, 862, 863, 864, 866, 868, 869, 871, 873, 874, 875, 876, 877, 879, 880, 881, 882, 883, 884, 885, 886, 887, 888, 889]
[0, 5, 17, 18, 21, 29, 35, 41, 47, 48, 58, 65, 69, 72, 74, 76, 79, 94, 96, 100, 101, 102, 105, 115, 124, 126, 132, 146, 155, 170, 171, 172, 178, 180, 195, 199, 205, 218, 238, 245, 247, 265, 280, 281, 285, 294, 298, 302, 304, 305, 308, 317, 326, 333, 336, 343, 347, 358, 364, 376, 382, 391, 393, 398, 403, 433, 438, 442, 453, 455, 458, 462, 470, 473, 484, 506, 514, 516, 520, 523, 524, 525, 528, 535, 539, 555, 558, 559, 560, 561, 569, 583, 595, 601, 604, 608, 657, 662, 668, 675, 680, 681, 684, 700, 702, 718, 720, 728, 748, 750, 769, 773, 777, 782, 806, 816, 832, 841, 842, 848, 859, 889]

[0, 1, 2, 3, 5, 6, 7, 8, 9, 10, 12, 13, 14, 15, 16, 17, 20, 21, 22, 23, 24, 25, 26, 27, 28, 29, 31, 33, 34, 35, 36, 38, 39, 40, 41, 42, 43, 44, 47, 48, 49, 50, 51, 53, 54, 56, 57, 58, 60, 61, 62, 63, 64, 65, 66, 67, 68, 69, 70, 71, 72, 73, 74, 75, 77, 78, 79, 80, 81, 82, 83, 84, 87, 88, 91, 92, 93, 94, 95, 96, 97, 98, 99, 100, 101, 102, 103, 104, 109, 111, 112, 115, 116, 117, 118, 119, 120, 121, 122, 123, 124, 125, 126, 127, 128, 129, 131, 132, 133, 134, 136, 137, 138, 139, 140, 141, 142, 144, 145, 146, 147, 149, 151, 152, 153, 154, 155, 156, 157, 159, 160, 161, 162, 164, 165, 166, 167, 168, 169, 170, 171, 172, 173, 174, 175, 177, 178, 179, 180, 181, 183, 184, 185, 189, 190, 191, 193, 195, 197, 198, 199, 200, 201, 202, 203, 204, 205, 206, 207, 208, 209, 210, 211, 212, 215, 216, 217, 219, 220, 222, 223, 224, 225, 226, 227, 229, 230, 231, 232, 233, 234, 235, 236, 239, 240, 242, 243, 244, 245, 246, 247, 249, 250, 251, 253, 254, 255, 256, 258, 260, 261, 262, 263, 265, 266, 267, 268, 269, 270, 271, 272, 274, 276, 277, 278, 279, 280, 282, 283, 284, 285, 287, 288, 289, 290, 291, 292, 293, 294, 295, 296, 297, 298, 299, 301, 302, 303, 304, 305, 307, 309, 310, 311, 312, 313, 316, 317, 318, 321, 322, 323, 324, 325, 326, 327, 330, 331, 332, 335, 336, 337, 338, 339, 341, 342, 343, 344, 345, 346, 347, 348, 350, 351, 352, 353, 355, 357, 359, 361, 363, 364, 365, 366, 367, 368, 369, 371, 373, 374, 375, 376, 377, 378, 380, 381, 382, 383, 384, 385, 386, 387, 388, 389, 390, 391, 392, 393, 394, 395, 396, 397, 398, 399, 402, 403, 405, 406, 407, 408, 409, 410, 411, 412, 414, 416, 417, 420, 422, 423, 424, 425, 426, 427, 428, 430, 431, 432, 433, 434, 436, 437, 440, 441, 443, 445, 446, 447, 448, 449, 450, 451, 453, 454, 455, 457, 458, 459, 460, 461, 462, 463, 464, 465, 466, 467, 468, 469, 470, 471, 472, 476, 477, 479, 481, 482, 483, 484, 485, 486, 487, 489, 490, 491, 494, 495, 497, 498, 499, 500, 502, 503, 504, 505, 506, 508, 510, 511, 512, 513, 514, 515, 516, 517, 518, 519, 520, 521, 522, 523, 524, 525, 526, 527, 528, 529, 530, 531, 533, 534, 535, 537, 538, 539, 540, 542, 543, 544, 546, 547, 548, 549, 552, 554, 555, 556, 557, 559, 560, 561, 564, 565, 566, 567, 568, 569, 570, 572, 574, 575, 576, 577, 578, 579, 580, 581, 582, 583, 584, 585, 587, 589, 590, 592, 593, 594, 595, 596, 597, 598, 600, 602, 603, 604, 605, 606, 607, 608, 609, 612, 613, 614, 615, 616, 617, 618, 619, 621, 622, 624, 626, 627, 628, 630, 631, 633, 634, 635, 636, 637, 638, 639, 640, 642, 643, 644, 646, 648, 649, 650, 652, 653, 654, 655, 656, 657, 658, 659, 660, 661, 664, 666, 667, 670, 672, 673, 674, 675, 676, 677, 678, 679, 681, 682, 683, 684, 685, 686, 687, 688, 689, 690, 692, 693, 694, 695, 696, 697, 698, 700, 701, 702, 703, 704, 706, 707, 708, 710, 711, 712, 713, 714, 715, 716, 717, 718, 719, 720, 721, 722, 723, 724, 726, 729, 730, 731, 732, 734, 735, 737, 738, 739, 740, 741, 746, 747, 748, 749, 750, 751, 753, 754, 755, 756, 758, 759, 760, 761, 762, 763, 764, 765, 766, 767, 768, 769, 770, 771, 772, 773, 774, 778, 779, 780, 781, 782, 783, 784, 785, 786, 787, 788, 789, 790, 791, 792, 793, 794, 795, 797, 798, 799, 800, 801, 806, 808, 809, 810, 811, 813, 814, 815, 816, 817, 818, 819, 821, 823, 824, 825, 827, 828, 829, 830, 831, 832, 833, 835, 837, 838, 841, 842, 843, 844, 845, 847, 848, 849, 850, 851, 852, 853, 854, 855, 857, 859, 860, 862, 863, 864, 866, 867, 868, 869, 871, 873, 874, 875, 876, 877, 879, 880, 881, 882, 883, 884, 885, 886, 887, 888, 889]
[0, 5, 17, 18, 21, 29, 35, 41, 47, 48, 58, 65, 69, 72, 74, 76, 79, 94, 96, 100, 101, 102, 105, 115, 124, 126, 132, 146, 155, 170, 171, 172, 178, 180, 195, 199, 205, 218, 238, 245, 247, 265, 280, 281, 285, 294, 298, 302, 304, 305, 308, 317, 326, 333, 336, 343, 347, 358, 364, 376, 382, 391, 393, 398, 403, 433, 438, 442, 453, 455, 458, 462, 470, 473, 484, 506, 514, 516, 520, 523, 524, 525, 528, 535, 539, 555, 558, 559, 560, 561, 569, 583, 595, 601, 604, 608, 657, 662, 668, 675, 680, 681, 684, 700, 702, 718, 720, 728, 748, 750, 769, 773, 777, 782, 806, 816, 832, 841, 842, 848, 859, 889]

[0, 1, 2, 3, 5, 6, 7, 8, 9, 10, 12, 13, 14, 15, 16, 17, 18, 20, 21, 22, 23, 24, 25, 26, 27, 28, 29, 31, 33, 34, 35, 36, 37, 38, 39, 40, 41, 42, 43, 44, 45, 47, 48, 49, 50, 51, 53, 54, 55, 56, 57, 58, 59, 60, 61, 62, 63, 64, 65, 66, 67, 68, 69, 70, 71, 72, 73, 74, 75, 77, 78, 79, 80, 81, 82, 83, 84, 86, 87, 88, 91, 92, 93, 94, 95, 96, 97, 98, 99, 100, 101, 102, 103, 104, 105, 106, 109, 111, 112, 113, 114, 115, 116, 117, 118, 119, 120, 121, 122, 123, 124, 125, 126, 127, 128, 129, 130, 131, 132, 133, 134, 135, 136, 137, 138, 139, 140, 141, 142, 144, 145, 146, 147, 149, 151, 152, 153, 154, 155, 156, 157, 158, 159, 160, 161, 162, 164, 165, 166, 167, 168, 169, 170, 171, 172, 173, 174, 175, 177, 178, 179, 180, 181, 182, 183, 184, 185, 189, 190, 191, 193, 195, 197, 198, 199, 200, 201, 202, 203, 204, 205, 206, 207, 208, 209, 210, 211, 212, 214, 215, 216, 217, 218, 219, 220, 221, 222, 223, 224, 225, 226, 227, 229, 230, 231, 232, 233, 234, 235, 236, 238, 239, 240, 241, 242, 243, 244, 245, 246, 247, 249, 250, 251, 253, 254, 255, 256, 258, 259, 260, 261, 262, 263, 265, 266, 267, 268, 269, 270, 271, 272, 274, 276, 277, 278, 279, 280, 282, 283, 284, 285, 286, 287, 288, 289, 290, 291, 292, 293, 294, 295, 296, 297, 298, 299, 301, 302, 303, 304, 305, 306, 307, 309, 310, 311, 312, 313, 314, 316, 317, 318, 320, 321, 322, 323, 324, 325, 326, 327, 328, 329, 330, 331, 332, 335, 336, 337, 338, 339, 341, 342, 343, 344, 345, 346, 347, 348, 349, 350, 351, 352, 353, 354, 355, 357, 359, 360, 361, 362, 363, 364, 365, 366, 367, 368, 369, 371, 372, 373, 374, 375, 376, 377, 378, 380, 381, 382, 383, 384, 385, 386, 387, 388, 389, 390, 391, 392, 393, 394, 395, 396, 397, 398, 399, 400, 402, 403, 405, 406, 407, 408, 409, 410, 411, 412, 414, 416, 417, 418, 420, 422, 423, 424, 425, 426, 427, 428, 430, 431, 432, 433, 434, 435, 436, 437, 440, 441, 442, 443, 444, 445, 446, 447, 448, 449, 450, 451, 452, 453, 454, 455, 457, 458, 459, 460, 461, 462, 463, 464, 465, 466, 467, 468, 469, 470, 471, 472, 475, 476, 477, 479, 480, 481, 482, 483, 484, 485, 486, 487, 488, 489, 490, 491, 492, 494, 495, 496, 497, 498, 499, 500, 501, 502, 503, 504, 505, 506, 508, 509, 510, 511, 512, 513, 514, 515, 516, 517, 518, 519, 520, 521, 522, 523, 524, 525, 526, 527, 528, 529, 530, 531, 533, 534, 535, 537, 538, 539, 540, 541, 542, 543, 544, 546, 547, 548, 549, 550, 552, 554, 555, 556, 557, 559, 560, 561, 562, 563, 564, 565, 566, 567, 568, 569, 570, 572, 574, 575, 576, 577, 578, 579, 580, 581, 582, 583, 584, 585, 587, 589, 590, 592, 593, 594, 595, 596, 597, 598, 600, 602, 603, 604, 605, 606, 607, 608, 609, 611, 612, 613, 614, 615, 616, 617, 618, 619, 621, 622, 624, 626, 627, 628, 630, 631, 632, 633, 634, 635, 636, 637, 638, 639, 640, 641, 642, 643, 644, 646, 647, 648, 649, 650, 651, 652, 653, 654, 655, 656, 657, 658, 659, 660, 661, 662, 664, 666, 667, 669, 670, 671, 672, 673, 674, 675, 676, 677, 678, 679, 680, 681, 682, 683, 684, 685, 686, 687, 688, 689, 690, 692, 693, 694, 695, 696, 697, 698, 700, 701, 702, 703, 704, 705, 706, 707, 708, 709, 710, 711, 712, 713, 714, 715, 716, 717, 718, 719, 720, 721, 722, 723, 724, 726, 729, 730, 731, 732, 734, 735, 736, 737, 738, 739, 740, 741, 746, 747, 748, 749, 750, 751, 753, 754, 755, 756, 757, 758, 759, 760, 761, 762, 763, 764, 765, 766, 767, 768, 769, 770, 771, 772, 773, 774, 778, 779, 780, 781, 782, 783, 784, 785, 786, 787, 788, 789, 790, 791, 792, 793, 794, 795, 796, 797, 798, 799, 800, 801, 802, 803, 804, 805, 806, 808, 809, 810, 811, 813, 814, 815, 816, 817, 818, 819, 820, 821, 822, 823, 824, 825, 827, 828, 829, 830, 831, 832, 833, 835, 837, 838, 839, 840, 841, 842, 843, 844, 845, 846, 847, 848, 849, 850, 851, 852, 853, 854, 855, 856, 857, 859, 860, 861, 862, 863, 864, 865, 866, 867, 868, 869, 870, 871, 873, 874, 875, 876, 877, 879, 880, 881, 882, 883, 884, 885, 886, 887, 888, 889]
[0, 5, 17, 18, 21, 29, 35, 41, 47, 48, 58, 65, 69, 72, 74, 76, 79, 94, 96, 100, 101, 102, 105, 115, 124, 126, 132, 146, 155, 170, 171, 172, 178, 180, 195, 199, 205, 218, 238, 245, 247, 265, 280, 281, 285, 294, 298, 302, 304, 305, 308, 317, 326, 333, 336, 343, 347, 358, 364, 376, 382, 391, 393, 398, 403, 433, 438, 442, 453, 455, 458, 462, 470, 473, 484, 506, 514, 516, 520, 523, 524, 525, 528, 535, 539, 555, 558, 559, 560, 561, 569, 583, 595, 601, 604, 608, 657, 662, 668, 675, 680, 681, 684, 700, 702, 718, 720, 728, 748, 750, 769, 773, 777, 782, 806, 816, 832, 841, 842, 848, 859, 889]

