[56, 59, 63, 139, 165, 241, 247, 270, 285, 297, 413, 474, 492, 527, 563, 573, 644, 672, 685, 777, 801, 881]
[16, 20, 35, 154, 156, 175, 187, 188, 205, 217, 490, 517, 526, 531, 682, 700, 727, 780, 827, 832, 849, 882]

[56, 59, 63, 139, 165, 241, 247, 270, 285, 297, 413, 474, 492, 527, 563, 573, 644, 672, 685, 777, 801, 881]
[13, 16, 20, 23, 31, 35, 38, 40, 60, 74, 81, 85, 94, 97, 107, 110, 119, 120, 123, 128, 133, 136, 148, 154, 156, 162, 175, 186, 187, 188, 199, 200, 202, 203, 205, 213, 217, 229, 232, 240, 243, 244, 259, 282, 290, 307, 314, 315, 319, 321, 324, 336, 341, 344, 348, 349, 360, 382, 389, 403, 405, 422, 425, 433, 437, 441, 461, 465, 471, 477, 490, 511, 515, 516, 517, 525, 526, 528, 531, 542, 550, 558, 586, 599, 613, 616, 627, 643, 647, 660, 677, 682, 697, 700, 702, 707, 715, 723, 727, 748, 755, 768, 770, 772, 780, 782, 795, 796, 810, 814, 816, 821, 827, 832, 838, 845, 849, 855, 856, 876, 880, 882]

[17, 27, 39, 40, 42, 56, 59, 63, 72, 97, 124, 125, 134, 139, 161, 165, 179, 189, 213, 236, 239, 241, 247, 250, 263, 270, 274, 280, 285, 297, 313, 360, 369, 381, 398, 399, 409, 413, 431, 432, 444, 460, 462, 474, 477, 492, 501, 508, 514, 527, 529, 536, 542, 556, 561, 563, 573, 577, 604, 614, 619, 641, 644, 649, 658, 672, 678, 681, 685, 690, 696, 698, 707, 712, 720, 723, 724, 732, 735, 739, 743, 750, 762, 777, 793, 801, 807, 821, 827, 832, 859, 864, 868, 880, 881, 884, 885]
[13, 16, 20, 23, 31, 35, 38, 40, 60, 74, 81, 85, 94, 97, 107, 110, 119, 120, 123, 128, 133, 136, 148, 154, 156, 162, 175, 186, 187, 188, 199, 200, 202, 203, 205, 213, 217, 229, 232, 240, 243, 244, 259, 282, 290, 307, 314, 315, 319, 321, 324, 336, 341, 344, 348, 349, 360, 382, 389, 403, 405, 422, 425, 433, 437, 441, 461, 465, 471, 477, 490, 511, 515, 516, 517, 525, 526, 528, 531, 542, 550, 558, 586, 599, 613, 616, 627, 643, 647, 660, 677, 682, 697, 700, 702, 707, 715, 723, 727, 748, 755, 768, 770, 772, 780, 782, 795, 796, 810, 814, 816, 821, 827, 832, 838, 845, 849, 855, 856, 876, 880, 882]

[17, 27, 29, 31, 39, 40, 41, 42, 45, 51, 53, 56, 59, 63, 68, 70, 72, 79, 97, 98, 99, 111, 114, 124, 125, 134, 136, 139, 140, 142, 159, 161, 165, 169, 177, 179, 189, 213, 214, 216, 225, 229, 236, 239, 241, 247, 249, 250, 252, 263, 270, 274, 275, 277, 280, 284, 285, 292, 297, 300, 301, 308, 313, 331, 334, 349, 360, 369, 376, 381, 382, 393, 394, 396, 398, 399, 405, 407, 409, 413, 424, 431, 432, 444, 460, 462, 474, 477, 479, 491, 492, 501, 508, 514, 527, 529, 536, 542, 545, 555, 556, 561, 563, 573, 577, 583, 604, 606, 613, 614, 615, 617, 619, 628, 633, 641, 644, 649, 652, 658, 662, 663, 664, 672, 673, 678, 681, 685, 690, 696, 698, 707, 712, 720, 721, 723, 724, 732, 735, 739, 742, 743, 750, 751, 753, 757, 758, 762, 769, 770, 777, 783, 793, 794, 801, 807, 816, 820, 821, 826, 827, 832, 836, 859, 864, 865, 867, 868, 873, 877, 880, 881, 884, 885]
[13, 16, 20, 23, 31, 35, 38, 40, 60, 74, 81, 85, 94, 97, 107, 110, 119, 120, 123, 128, 133, 136, 148, 154, 156, 162, 175, 186, 187, 188, 199, 200, 202, 203, 205, 213, 217, 229, 232, 240, 243, 244, 259, 282, 290, 307, 314, 315, 319, 321, 324, 336, 341, 344, 348, 349, 360, 382, 389, 403, 405, 422, 425, 433, 437, 441, 461, 465, 471, 477, 490, 511, 515, 516, 517, 525, 526, 528, 531, 542, 550, 558, 586, 599, 613, 616, 627, 643, 647, 660, 677, 682, 697, 700, 702, 707, 715, 723, 727, 748, 755, 768, 770, 772, 780, 782, 795, 796, 810, 814, 816, 821, 827, 832, 838, 845, 849, 855, 856, 876, 880, 882]

[9, 11, 17, 24, 27, 29, 31, 39, 40, 41, 42, 45, 46, 51, 53, 56, 59, 62, 63, 68, 70, 72, 79, 93, 96, 97, 98, 99, 108, 109, 111, 114, 117, 124, 125, 131, 134, 136, 139, 140, 142, 153, 159, 161, 165, 169, 177, 179, 189, 190, 195, 206, 210, 211, 213, 214, 215, 216, 225, 229, 230, 236, 239, 241, 247, 248, 249, 250, 252, 263, 265, 270, 274, 275, 277, 280, 284, 285, 288, 289, 290, 292, 297, 300, 301, 306, 308, 312, 313, 324, 326, 331, 334, 338, 341, 349, 358, 360, 362, 365, 367, 369, 373, 376, 381, 382, 388, 393, 394, 396, 398, 399, 405, 407, 409, 411, 413, 424, 431, 432, 434, 444, 459, 460, 462, 469, 474, 477, 479, 491, 492, 495, 500, 501, 508, 514, 527, 529, 530, 532, 536, 539, 542, 545, 548, 555, 556, 561, 563, 572, 573, 577, 578, 581, 583, 584, 604, 605, 606, 608, 613, 614, 615, 617, 619, 627, 628, 633, 640, 641, 644, 645, 649, 652, 657, 658, 662, 663, 664, 666, 672, 673, 676, 677, 678, 681, 685, 690, 696, 698, 706, 707, 712, 716, 720, 721, 722, 723, 724, 729, 731, 732, 735, 736, 739, 742, 743, 750, 751, 753, 757, 758, 762, 769, 770, 771, 777, 782, 783, 793, 794, 796, 799, 801, 804, 807, 816, 820, 821, 826, 827, 828, 830, 832, 836, 859, 864, 865, 867, 868, 872, 873, 877, 880, 881, 883, 884, 885, 889]
[13, 16, 20, 23, 31, 35, 38, 40, 60, 74, 81, 85, 94, 97, 107, 110, 119, 120, 123, 128, 133, 136, 148, 154, 156, 162, 175, 186, 187, 188, 199, 200, 202, 203, 205, 213, 217, 229, 232, 240, 243, 244, 259, 282, 290, 307, 314, 315, 319, 321, 324, 336, 341, 344, 348, 349, 360, 382, 389, 403, 405, 422, 425, 433, 437, 441, 461, 465, 471, 477, 490, 511, 515, 516, 517, 525, 526, 528, 531, 542, 550, 558, 586, 599, 613, 616, 627, 643, 647, 660, 677, 682, 697, 700, 702, 707, 715, 723, 727, 748, 755, 768, 770, 772, 780, 782, 795, 796, 810, 814, 816, 821, 827, 832, 838, 845, 849, 855, 856, 876, 880, 882]

[0, 1, 9, 11, 15, 17, 24, 26, 27, 29, 31, 39, 40, 41, 42, 43, 45, 46, 51, 53, 56, 59, 62, 63, 68, 70, 72, 77, 79, 93, 96, 97, 98, 99, 108, 109, 111, 114, 117, 124, 125, 131, 134, 136, 139, 140, 141, 142, 143, 153, 159, 161, 165, 169, 170, 171, 177, 178, 179, 185, 189, 190, 195, 206, 210, 211, 213, 214, 215, 216, 219, 225, 228, 229, 230, 233, 236, 239, 241, 247, 248, 249, 250, 252, 256, 263, 265, 270, 274, 275, 277, 280, 283, 284, 285, 287, 288, 289, 290, 292, 297, 300, 301, 304, 306, 308, 310, 311, 312, 313, 318, 320, 324, 326, 329, 331, 334, 337, 338, 341, 346, 349, 358, 359, 360, 362, 363, 365, 367, 369, 370, 372, 373, 376, 381, 382, 388, 393, 394, 396, 398, 399, 403, 405, 407, 408, 409, 410, 411, 413, 421, 424, 431, 432, 433, 434, 435, 444, 447, 459, 460, 462, 463, 469, 471, 474, 477, 479, 484, 485, 491, 492, 493, 495, 500, 501, 502, 504, 508, 514, 523, 527, 529, 530, 532, 536, 537, 539, 542, 545, 548, 550, 555, 556, 559, 561, 562, 563, 571, 572, 573, 577, 578, 581, 583, 584, 589, 590, 593, 600, 604, 605, 606, 608, 612, 613, 614, 615, 616, 617, 619, 620, 624, 627, 628, 629, 633, 640, 641, 644, 645, 649, 652, 653, 657, 658, 659, 662, 663, 664, 666, 672, 673, 676, 677, 678, 681, 685, 690, 696, 698, 705, 706, 707, 712, 716, 720, 721, 722, 723, 724, 729, 731, 732, 735, 736, 739, 742, 743, 747, 750, 751, 753, 757, 758, 762, 769, 770, 771, 777, 782, 783, 793, 794, 796, 799, 801, 804, 807, 811, 812, 814, 816, 820, 821, 826, 827, 828, 830, 832, 835, 836, 840, 851, 856, 859, 861, 863, 864, 865, 867, 868, 869, 870, 872, 873, 877, 879, 880, 881, 883, 884, 885, 889]
[13, 16, 20, 23, 31, 35, 38, 40, 60, 74, 81, 85, 94, 97, 107, 110, 119, 120, 123, 128, 133, 136, 148, 154, 156, 162, 175, 186, 187, 188, 199, 200, 202, 203, 205, 213, 217, 229, 232, 240, 243, 244, 259, 282, 290, 307, 314, 315, 319, 321, 324, 336, 341, 344, 348, 349, 360, 382, 389, 403, 405, 422, 425, 433, 437, 441, 461, 465, 471, 477, 490, 511, 515, 516, 517, 525, 526, 528, 531, 542, 550, 558, 586, 599, 613, 616, 627, 643, 647, 660, 677, 682, 697, 700, 702, 707, 715, 723, 727, 748, 755, 768, 770, 772, 780, 782, 795, 796, 810, 814, 816, 821, 827, 832, 838, 845, 849, 855, 856, 876, 880, 882]

[0, 1, 9, 10, 11, 15, 17, 24, 26, 27, 29, 31, 37, 39, 40, 41, 42, 43, 45, 46, 47, 51, 53, 56, 59, 62, 63, 68, 69, 70, 71, 72, 76, 77, 79, 83, 93, 96, 97, 98, 99, 103, 108, 109, 111, 114, 115, 117, 124, 125, 131, 134, 136, 139, 140, 141, 142, 143, 150, 151, 152, 153, 159, 161, 162, 163, 164, 165, 167, 169, 170, 171, 172, 173, 177, 178, 179, 185, 186, 189, 190, 195, 206, 209, 210, 211, 213, 214, 215, 216, 219, 225, 228, 229, 230, 233, 236, 237, 238, 239, 241, 247, 248, 249, 250, 251, 252, 253, 256, 263, 265, 269, 270, 274, 275, 277, 280, 283, 284, 285, 287, 288, 289, 290, 292, 297, 298, 300, 301, 302, 304, 306, 308, 310, 311, 312, 313, 318, 319, 320, 324, 326, 327, 329, 330, 331, 334, 337, 338, 339, 341, 346, 349, 358, 359, 360, 362, 363, 365, 367, 369, 370, 372, 373, 376, 381, 382, 388, 392, 393, 394, 396, 398, 399, 402, 403, 405, 407, 408, 409, 410, 411, 412, 413, 419, 420, 421, 423, 424, 431, 432, 433, 434, 435, 440, 444, 445, 447, 459, 460, 461, 462, 463, 469, 471, 474, 477, 479, 484, 485, 490, 491, 492, 493, 495, 498, 500, 501, 502, 504, 508, 514, 516, 519, 521, 523, 525, 527, 529, 530, 532, 533, 536, 537, 539, 542, 545, 548, 550, 552, 555, 556, 559, 561, 562, 563, 564, 571, 572, 573, 577, 578, 581, 583, 584, 589, 590, 593, 594, 597, 600, 604, 605, 606, 608, 612, 613, 614, 615, 616, 617, 619, 620, 622, 624, 627, 628, 629, 633, 635, 640, 641, 644, 645, 649, 652, 653, 654, 655, 657, 658, 659, 660, 662, 663, 664, 666, 672, 673, 676, 677, 678, 681, 683, 685, 690, 696, 698, 700, 701, 705, 706, 707, 710, 712, 713, 716, 718, 720, 721, 722, 723, 724, 725, 729, 731, 732, 735, 736, 739, 742, 743, 747, 749, 750, 751, 753, 757, 758, 762, 768, 769, 770, 771, 772, 777, 778, 782, 783, 785, 790, 793, 794, 796, 797, 799, 801, 804, 807, 810, 811, 812, 814, 816, 818, 820, 821, 826, 827, 828, 830, 832, 833, 835, 836, 840, 842, 848, 851, 856, 859, 861, 863, 864, 865, 867, 868, 869, 870, 872, 873, 877, 879, 880, 881, 883, 884, 885, 889]
[13, 16, 20, 23, 31, 35, 38, 40, 60, 74, 81, 85, 94, 97, 107, 110, 119, 120, 123, 128, 133, 136, 148, 154, 156, 162, 175, 186, 187, 188, 199, 200, 202, 203, 205, 213, 217, 229, 232, 240, 243, 244, 259, 282, 290, 307, 314, 315, 319, 321, 324, 336, 341, 344, 348, 349, 360, 382, 389, 403, 405, 422, 425, 433, 437, 441, 461, 465, 471, 477, 490, 511, 515, 516, 517, 525, 526, 528, 531, 542, 550, 558, 586, 599, 613, 616, 627, 643, 647, 660, 677, 682, 697, 700, 702, 707, 715, 723, 727, 748, 755, 768, 770, 772, 780, 782, 795, 796, 810, 814, 816, 821, 827, 832, 838, 845, 849, 855, 856, 876, 880, 882]

[0, 1, 2, 5, 7, 9, 10, 11, 15, 17, 21, 24, 26, 27, 29, 31, 34, 37, 39, 40, 41, 42, 43, 45, 46, 47, 51, 53, 56, 57, 59, 62, 63, 68, 69, 70, 71, 72, 73, 75, 76, 77, 79, 83, 85, 90, 93, 96, 97, 98, 99, 101, 103, 107, 108, 109, 111, 114, 115, 116, 117, 118, 120, 124, 125, 131, 134, 136, 139, 140, 141, 142, 143, 150, 151, 152, 153, 158, 159, 161, 162, 163, 164, 165, 167, 169, 170, 171, 172, 173, 177, 178, 179, 183, 185, 186, 187, 189, 190, 195, 196, 201, 206, 209, 210, 211, 212, 213, 214, 215, 216, 219, 225, 228, 229, 230, 233, 236, 237, 238, 239, 241, 247, 248, 249, 250, 251, 252, 253, 256, 263, 265, 269, 270, 272, 273, 274, 275, 277, 280, 283, 284, 285, 286, 287, 288, 289, 290, 292, 297, 298, 300, 301, 302, 304, 306, 308, 310, 311, 312, 313, 318, 319, 320, 323, 324, 326, 327, 328, 329, 330, 331, 334, 337, 338, 339, 341, 346, 349, 358, 359, 360, 362, 363, 365, 367, 369, 370, 372, 373, 374, 376, 381, 382, 385, 388, 392, 393, 394, 396, 398, 399, 400, 402, 403, 405, 407, 408, 409, 410, 411, 412, 413, 418, 419, 420, 421, 423, 424, 425, 431, 432, 433, 434, 435, 436, 437, 440, 441, 444, 445, 447, 448, 452, 459, 460, 461, 462, 463, 469, 470, 471, 474, 477, 478, 479, 481, 483, 484, 485, 486, 487, 490, 491, 492, 493, 495, 496, 498, 500, 501, 502, 504, 505, 508, 511, 514, 516, 517, 518, 519, 521, 523, 524, 525, 527, 529, 530, 532, 533, 536, 537, 539, 542, 544, 545, 548, 550, 552, 555, 556, 559, 561, 562, 563, 564, 571, 572, 573, 577, 578, 581, 583, 584, 589, 590, 593, 594, 597, 598, 600, 602, 604, 605, 606, 608, 612, 613, 614, 615, 616, 617, 619, 620, 622, 623, 624, 627, 628, 629, 633, 635, 640, 641, 642, 644, 645, 649, 652, 653, 654, 655, 657, 658, 659, 660, 661, 662, 663, 664, 666, 672, 673, 676, 677, 678, 679, 681, 683, 685, 690, 696, 698, 699, 700, 701, 703, 705, 706, 707, 710, 712, 713, 716, 718, 720, 721, 722, 723, 724, 725, 729, 731, 732, 735, 736, 739, 742, 743, 747, 748, 749, 750, 751, 753, 757, 758, 760, 762, 763, 765, 766, 768, 769, 770, 771, 772, 777, 778, 782, 783, 785, 786, 787, 788, 790, 793, 794, 795, 796, 797, 799, 800, 801, 804, 806, 807, 810, 811, 812, 814, 816, 818, 820, 821, 822, 826, 827, 828, 830, 832, 833, 834, 835, 836, 839, 840, 842, 848, 849, 850, 851, 856, 859, 861, 862, 863, 864, 865, 867, 868, 869, 870, 872, 873, 877, 878, 879, 880, 881, 883, 884, 885, 889]
[13, 16, 20, 23, 31, 35, 38, 40, 60, 74, 81, 85, 94, 97, 107, 110, 119, 120, 123, 128, 133, 136, 148, 154, 156, 162, 175, 186, 187, 188, 199, 200, 202, 203, 205, 213, 217, 229, 232, 240, 243, 244, 259, 282, 290, 307, 314, 315, 319, 321, 324, 336, 341, 344, 348, 349, 360, 382, 389, 403, 405, 422, 425, 433, 437, 441, 461, 465, 471, 477, 490, 511, 515, 516, 517, 525, 526, 528, 531, 542, 550, 558, 586, 599, 613, 616, 627, 643, 647, 660, 677, 682, 697, 700, 702, 707, 715, 723, 727, 748, 755, 768, 770, 772, 780, 782, 795, 796, 810, 814, 816, 821, 827, 832, 838, 845, 849, 855, 856, 876, 880, 882]

[0, 1, 2, 3, 5, 7, 8, 9, 10, 11, 15, 17, 21, 23, 24, 26, 27, 29, 31, 32, 34, 37, 39, 40, 41, 42, 43, 44, 45, 46, 47, 51, 53, 56, 57, 59, 60, 62, 63, 68, 69, 70, 71, 72, 73, 75, 76, 77, 78, 79, 83, 85, 88, 89, 90, 93, 96, 97, 98, 99, 100, 101, 103, 104, 107, 108, 109, 111, 114, 115, 116, 117, 118, 120, 122, 124, 125, 126, 129, 131, 134, 136, 139, 140, 141, 142, 143, 149, 150, 151, 152, 153, 154, 158, 159, 161, 162, 163, 164, 165, 167, 169, 170, 171, 172, 173, 176, 177, 178, 179, 183, 185, 186, 187, 189, 190, 195, 196, 197, 199, 201, 204, 206, 209, 210, 211, 212, 213, 214, 215, 216, 219, 222, 225, 226, 228, 229, 230, 232, 233, 235, 236, 237, 238, 239, 241, 242, 246, 247, 248, 249, 250, 251, 252, 253, 256, 261, 263, 265, 269, 270, 271, 272, 273, 274, 275, 277, 280, 281, 283, 284, 285, 286, 287, 288, 289, 290, 292, 297, 298, 300, 301, 302, 304, 305, 306, 308, 310, 311, 312, 313, 318, 319, 320, 323, 324, 325, 326, 327, 328, 329, 330, 331, 333, 334, 336, 337, 338, 339, 341, 342, 343, 346, 349, 353, 358, 359, 360, 361, 362, 363, 365, 367, 369, 370, 372, 373, 374, 376, 381, 382, 384, 385, 388, 389, 392, 393, 394, 396, 398, 399, 400, 402, 403, 405, 406, 407, 408, 409, 410, 411, 412, 413, 418, 419, 420, 421, 423, 424, 425, 426, 427, 431, 432, 433, 434, 435, 436, 437, 439, 440, 441, 442, 444, 445, 447, 448, 449, 450, 451, 452, 456, 459, 460, 461, 462, 463, 469, 470, 471, 474, 475, 476, 477, 478, 479, 481, 483, 484, 485, 486, 487, 490, 491, 492, 493, 495, 496, 497, 498, 499, 500, 501, 502, 504, 505, 508, 510, 511, 514, 516, 517, 518, 519, 521, 523, 524, 525, 526, 527, 528, 529, 530, 532, 533, 536, 537, 539, 541, 542, 543, 544, 545, 548, 549, 550, 552, 555, 556, 559, 561, 562, 563, 564, 571, 572, 573, 577, 578, 581, 583, 584, 585, 587, 588, 589, 590, 591, 592, 593, 594, 597, 598, 600, 602, 604, 605, 606, 608, 609, 612, 613, 614, 615, 616, 617, 618, 619, 620, 622, 623, 624, 627, 628, 629, 633, 635, 640, 641, 642, 644, 645, 648, 649, 651, 652, 653, 654, 655, 657, 658, 659, 660, 661, 662, 663, 664, 666, 672, 673, 674, 676, 677, 678, 679, 681, 683, 685, 690, 691, 696, 698, 699, 700, 701, 702, 703, 705, 706, 707, 710, 712, 713, 716, 718, 720, 721, 722, 723, 724, 725, 729, 731, 732, 734, 735, 736, 739, 742, 743, 745, 747, 748, 749, 750, 751, 752, 753, 754, 756, 757, 758, 760, 762, 763, 765, 766, 768, 769, 770, 771, 772, 777, 778, 782, 783, 785, 786, 787, 788, 790, 793, 794, 795, 796, 797, 799, 800, 801, 804, 806, 807, 808, 810, 811, 812, 814, 816, 818, 820, 821, 822, 826, 827, 828, 830, 832, 833, 834, 835, 836, 839, 840, 842, 844, 848, 849, 850, 851, 852, 856, 859, 861, 862, 863, 864, 865, 867, 868, 869, 870, 871, 872, 873, 877, 878, 879, 880, 881, 883, 884, 885, 889]
[13, 16, 20, 23, 31, 35, 38, 40, 60, 74, 81, 85, 94, 97, 107, 110, 119, 120, 123, 128, 133, 136, 148, 154, 156, 162, 175, 186, 187, 188, 199, 200, 202, 203, 205, 213, 217, 229, 232, 240, 243, 244, 259, 282, 290, 307, 314, 315, 319, 321, 324, 336, 341, 344, 348, 349, 360, 382, 389, 403, 405, 422, 425, 433, 437, 441, 461, 465, 471, 477, 490, 511, 515, 516, 517, 525, 526, 528, 531, 542, 550, 558, 586, 599, 613, 616, 627, 643, 647, 660, 677, 682, 697, 700, 702, 707, 715, 723, 727, 748, 755, 768, 770, 772, 780, 782, 795, 796, 810, 814, 816, 821, 827, 832, 838, 845, 849, 855, 856, 876, 880, 882]

[0, 1, 2, 3, 5, 7, 8, 9, 10, 11, 14, 15, 17, 20, 21, 23, 24, 26, 27, 28, 29, 31, 32, 34, 35, 37, 39, 40, 41, 42, 43, 44, 45, 46, 47, 51, 53, 56, 57, 59, 60, 61, 62, 63, 67, 68, 69, 70, 71, 72, 73, 75, 76, 77, 78, 79, 83, 85, 88, 89, 90, 92, 93, 96, 97, 98, 99, 100, 101, 103, 104, 106, 107, 108, 109, 110, 111, 112, 114, 115, 116, 117, 118, 119, 120, 122, 124, 125, 126, 129, 130, 131, 134, 136, 139, 140, 141, 142, 143, 145, 149, 150, 151, 152, 153, 154, 158, 159, 161, 162, 163, 164, 165, 166, 167, 169, 170, 171, 172, 173, 174, 175, 176, 177, 178, 179, 180, 183, 185, 186, 187, 189, 190, 194, 195, 196, 197, 199, 201, 204, 206, 208, 209, 210, 211, 212, 213, 214, 215, 216, 219, 220, 222, 225, 226, 228, 229, 230, 232, 233, 234, 235, 236, 237, 238, 239, 240, 241, 242, 246, 247, 248, 249, 250, 251, 252, 253, 256, 257, 261, 263, 265, 269, 270, 271, 272, 273, 274, 275, 277, 279, 280, 281, 282, 283, 284, 285, 286, 287, 288, 289, 290, 292, 295, 296, 297, 298, 299, 300, 301, 302, 303, 304, 305, 306, 308, 310, 311, 312, 313, 314, 315, 317, 318, 319, 320, 323, 324, 325, 326, 327, 328, 329, 330, 331, 332, 333, 334, 336, 337, 338, 339, 341, 342, 343, 346, 349, 353, 358, 359, 360, 361, 362, 363, 364, 365, 366, 367, 368, 369, 370, 372, 373, 374, 376, 377, 378, 380, 381, 382, 384, 385, 388, 389, 391, 392, 393, 394, 396, 397, 398, 399, 400, 401, 402, 403, 405, 406, 407, 408, 409, 410, 411, 412, 413, 417, 418, 419, 420, 421, 423, 424, 425, 426, 427, 431, 432, 433, 434, 435, 436, 437, 439, 440, 441, 442, 444, 445, 446, 447, 448, 449, 450, 451, 452, 453, 454, 456, 459, 460, 461, 462, 463, 466, 468, 469, 470, 471, 474, 475, 476, 477, 478, 479, 480, 481, 483, 484, 485, 486, 487, 488, 490, 491, 492, 493, 494, 495, 496, 497, 498, 499, 500, 501, 502, 504, 505, 508, 510, 511, 512, 514, 516, 517, 518, 519, 520, 521, 522, 523, 524, 525, 526, 527, 528, 529, 530, 532, 533, 536, 537, 538, 539, 541, 542, 543, 544, 545, 547, 548, 549, 550, 552, 555, 556, 559, 561, 562, 563, 564, 566, 567, 571, 572, 573, 577, 578, 580, 581, 583, 584, 585, 586, 587, 588, 589, 590, 591, 592, 593, 594, 597, 598, 600, 602, 603, 604, 605, 606, 608, 609, 612, 613, 614, 615, 616, 617, 618, 619, 620, 622, 623, 624, 627, 628, 629, 632, 633, 634, 635, 636, 640, 641, 642, 644, 645, 648, 649, 651, 652, 653, 654, 655, 657, 658, 659, 660, 661, 662, 663, 664, 666, 671, 672, 673, 674, 675, 676, 677, 678, 679, 681, 683, 685, 690, 691, 692, 693, 696, 698, 699, 700, 701, 702, 703, 705, 706, 707, 710, 712, 713, 716, 718, 719, 720, 721, 722, 723, 724, 725, 726, 727, 729, 731, 732, 733, 734, 735, 736, 737, 739, 742, 743, 745, 747, 748, 749, 750, 751, 752, 753, 754, 756, 757, 758, 759, 760, 762, 763, 765, 766, 768, 769, 770, 771, 772, 775, 777, 778, 779, 782, 783, 785, 786, 787, 788, 790, 793, 794, 795, 796, 797, 799, 800, 801, 802, 803, 804, 805, 806, 807, 808, 810, 811, 812, 814, 816, 818, 820, 821, 822, 826, 827, 828, 830, 832, 833, 834, 835, 836, 839, 840, 842, 844, 848, 849, 850, 851, 852, 854, 856, 859, 861, 862, 863, 864, 865, 867, 868, 869, 870, 871, 872, 873, 876, 877, 878, 879, 880, 881, 883, 884, 885, 886, 889]
[13, 16, 20, 23, 31, 35, 38, 40, 60, 74, 81, 85, 94, 97, 107, 110, 119, 120, 123, 128, 133, 136, 148, 154, 156, 162, 175, 186, 187, 188, 199, 200, 202, 203, 205, 213, 217, 229, 232, 240, 243, 244, 259, 282, 290, 307, 314, 315, 319, 321, 324, 336, 341, 344, 348, 349, 360, 382, 389, 403, 405, 422, 425, 433, 437, 441, 461, 465, 471, 477, 490, 511, 515, 516, 517, 525, 526, 528, 531, 542, 550, 558, 586, 599, 613, 616, 627, 643, 647, 660, 677, 682, 697, 700, 702, 707, 715, 723, 727, 748, 755, 768, 770, 772, 780, 782, 795, 796, 810, 814, 816, 821, 827, 832, 838, 845, 849, 855, 856, 876, 880, 882]

[0, 1, 2, 3, 5, 7, 8, 9, 10, 11, 12, 14, 15, 17, 19, 20, 21, 23, 24, 25, 26, 27, 28, 29, 31, 32, 33, 34, 35, 36, 37, 39, 40, 41, 42, 43, 44, 45, 46, 47, 48, 51, 53, 54, 56, 57, 59, 60, 61, 62, 63, 65, 66, 67, 68, 69, 70, 71, 72, 73, 74, 75, 76, 77, 78, 79, 83, 84, 85, 88, 89, 90, 92, 93, 96, 97, 98, 99, 100, 101, 103, 104, 106, 107, 108, 109, 110, 111, 112, 114, 115, 116, 117, 118, 119, 120, 122, 124, 125, 126, 129, 130, 131, 134, 136, 139, 140, 141, 142, 143, 145, 148, 149, 150, 151, 152, 153, 154, 157, 158, 159, 161, 162, 163, 164, 165, 166, 167, 169, 170, 171, 172, 173, 174, 175, 176, 177, 178, 179, 180, 183, 185, 186, 187, 189, 190, 191, 194, 195, 196, 197, 198, 199, 201, 203, 204, 205, 206, 208, 209, 210, 211, 212, 213, 214, 215, 216, 219, 220, 222, 224, 225, 226, 228, 229, 230, 231, 232, 233, 234, 235, 236, 237, 238, 239, 240, 241, 242, 245, 246, 247, 248, 249, 250, 251, 252, 253, 255, 256, 257, 258, 261, 263, 264, 265, 266, 269, 270, 271, 272, 273, 274, 275, 277, 278, 279, 280, 281, 282, 283, 284, 285, 286, 287, 288, 289, 290, 291, 292, 295, 296, 297, 298, 299, 300, 301, 302, 303, 304, 305, 306, 307, 308, 310, 311, 312, 313, 314, 315, 317, 318, 319, 320, 323, 324, 325, 326, 327, 328, 329, 330, 331, 332, 333, 334, 335, 336, 337, 338, 339, 341, 342, 343, 346, 347, 349, 351, 353, 354, 356, 358, 359, 360, 361, 362, 363, 364, 365, 366, 367, 368, 369, 370, 372, 373, 374, 376, 377, 378, 380, 381, 382, 383, 384, 385, 386, 388, 389, 391, 392, 393, 394, 395, 396, 397, 398, 399, 400, 401, 402, 403, 404, 405, 406, 407, 408, 409, 410, 411, 412, 413, 415, 417, 418, 419, 420, 421, 423, 424, 425, 426, 427, 431, 432, 433, 434, 435, 436, 437, 439, 440, 441, 442, 444, 445, 446, 447, 448, 449, 450, 451, 452, 453, 454, 456, 459, 460, 461, 462, 463, 466, 468, 469, 470, 471, 473, 474, 475, 476, 477, 478, 479, 480, 481, 483, 484, 485, 486, 487, 488, 489, 490, 491, 492, 493, 494, 495, 496, 497, 498, 499, 500, 501, 502, 504, 505, 506, 508, 509, 510, 511, 512, 514, 516, 517, 518, 519, 520, 521, 522, 523, 524, 525, 526, 527, 528, 529, 530, 532, 533, 534, 536, 537, 538, 539, 541, 542, 543, 544, 545, 547, 548, 549, 550, 551, 552, 553, 554, 555, 556, 559, 561, 562, 563, 564, 566, 567, 571, 572, 573, 574, 577, 578, 580, 581, 583, 584, 585, 586, 587, 588, 589, 590, 591, 592, 593, 594, 595, 597, 598, 600, 602, 603, 604, 605, 606, 608, 609, 610, 612, 613, 614, 615, 616, 617, 618, 619, 620, 622, 623, 624, 625, 627, 628, 629, 630, 631, 632, 633, 634, 635, 636, 640, 641, 642, 644, 645, 647, 648, 649, 651, 652, 653, 654, 655, 656, 657, 658, 659, 660, 661, 662, 663, 664, 666, 668, 669, 671, 672, 673, 674, 675, 676, 677, 678, 679, 681, 683, 684, 685, 688, 690, 691, 692, 693, 694, 696, 697, 698, 699, 700, 701, 702, 703, 705, 706, 707, 710, 712, 713, 714, 716, 717, 718, 719, 720, 721, 722, 723, 724, 725, 726, 727, 729, 731, 732, 733, 734, 735, 736, 737, 739, 742, 743, 744, 745, 746, 747, 748, 749, 750, 751, 752, 753, 754, 756, 757, 758, 759, 760, 761, 762, 763, 765, 766, 768, 769, 770, 771, 772, 775, 777, 778, 779, 782, 783, 785, 786, 787, 788, 790, 793, 794, 795, 796, 797, 798, 799, 800, 801, 802, 803, 804, 805, 806, 807, 808, 809, 810, 811, 812, 814, 816, 818, 819, 820, 821, 822, 826, 827, 828, 830, 832, 833, 834, 835, 836, 838, 839, 840, 841, 842, 844, 845, 846, 848, 849, 850, 851, 852, 854, 856, 859, 861, 862, 863, 864, 865, 867, 868, 869, 870, 871, 872, 873, 875, 876, 877, 878, 879, 880, 881, 882, 883, 884, 885, 886, 887, 888, 889]
[13, 16, 20, 23, 31, 35, 38, 40, 60, 74, 81, 85, 94, 97, 107, 110, 119, 120, 123, 128, 133, 136, 148, 154, 156, 162, 175, 186, 187, 188, 199, 200, 202, 203, 205, 213, 217, 229, 232, 240, 243, 244, 259, 282, 290, 307, 314, 315, 319, 321, 324, 336, 341, 344, 348, 349, 360, 382, 389, 403, 405, 422, 425, 433, 437, 441, 461, 465, 471, 477, 490, 511, 515, 516, 517, 525, 526, 528, 531, 542, 550, 558, 586, 599, 613, 616, 627, 643, 647, 660, 677, 682, 697, 700, 702, 707, 715, 723, 727, 748, 755, 768, 770, 772, 780, 782, 795, 796, 810, 814, 816, 821, 827, 832, 838, 845, 849, 855, 856, 876, 880, 882]

[0, 1, 2, 3, 5, 7, 8, 9, 10, 11, 12, 13, 14, 15, 17, 18, 19, 20, 21, 22, 23, 24, 25, 26, 27, 28, 29, 31, 32, 33, 34, 35, 36, 37, 39, 40, 41, 42, 43, 44, 45, 46, 47, 48, 49, 51, 52, 53, 54, 55, 56, 57, 59, 60, 61, 62, 63, 65, 66, 67, 68, 69, 70, 71, 72, 73, 74, 75, 76, 77, 78, 79, 81, 82, 83, 84, 85, 88, 89, 90, 91, 92, 93, 96, 97, 98, 99, 100, 101, 102, 103, 104, 106, 107, 108, 109, 110, 111, 112, 113, 114, 115, 116, 117, 118, 119, 120, 122, 124, 125, 126, 127, 129, 130, 131, 132, 133, 134, 135, 136, 137, 139, 140, 141, 142, 143, 144, 145, 147, 148, 149, 150, 151, 152, 153, 154, 157, 158, 159, 160, 161, 162, 163, 164, 165, 166, 167, 168, 169, 170, 171, 172, 173, 174, 175, 176, 177, 178, 179, 180, 182, 183, 185, 186, 187, 188, 189, 190, 191, 192, 193, 194, 195, 196, 197, 198, 199, 201, 203, 204, 205, 206, 208, 209, 210, 211, 212, 213, 214, 215, 216, 219, 220, 221, 222, 224, 225, 226, 228, 229, 230, 231, 232, 233, 234, 235, 236, 237, 238, 239, 240, 241, 242, 245, 246, 247, 248, 249, 250, 251, 252, 253, 255, 256, 257, 258, 259, 261, 262, 263, 264, 265, 266, 267, 269, 270, 271, 272, 273, 274, 275, 276, 277, 278, 279, 280, 281, 282, 283, 284, 285, 286, 287, 288, 289, 290, 291, 292, 293, 294, 295, 296, 297, 298, 299, 300, 301, 302, 303, 304, 305, 306, 307, 308, 310, 311, 312, 313, 314, 315, 316, 317, 318, 319, 320, 321, 323, 324, 325, 326, 327, 328, 329, 330, 331, 332, 333, 334, 335, 336, 337, 338, 339, 341, 342, 343, 345, 346, 347, 349, 350, 351, 352, 353, 354, 356, 358, 359, 360, 361, 362, 363, 364, 365, 366, 367, 368, 369, 370, 372, 373, 374, 376, 377, 378, 379, 380, 381, 382, 383, 384, 385, 386, 388, 389, 390, 391, 392, 393, 394, 395, 396, 397, 398, 399, 400, 401, 402, 403, 404, 405, 406, 407, 408, 409, 410, 411, 412, 413, 415, 416, 417, 418, 419, 420, 421, 422, 423, 424, 425, 426, 427, 429, 431, 432, 433, 434, 435, 436, 437, 439, 440, 441, 442, 444, 445, 446, 447, 448, 449, 450, 451, 452, 453, 454, 456, 457, 459, 460, 461, 462, 463, 466, 468, 469, 470, 471, 472, 473, 474, 475, 476, 477, 478, 479, 480, 481, 482, 483, 484, 485, 486, 487, 488, 489, 490, 491, 492, 493, 494, 495, 496, 497, 498, 499, 500, 501, 502, 504, 505, 506, 507, 508, 509, 510, 511, 512, 513, 514, 515, 516, 517, 518, 519, 520, 521, 522, 523, 524, 525, 526, 527, 528, 529, 530, 531, 532, 533, 534, 535, 536, 537, 538, 539, 540, 541, 542, 543, 544, 545, 547, 548, 549, 550, 551, 552, 553, 554, 555, 556, 559, 560, 561, 562, 563, 564, 566, 567, 570, 571, 572, 573, 574, 575, 577, 578, 579, 580, 581, 583, 584, 585, 586, 587, 588, 589, 590, 591, 592, 593, 594, 595, 596, 597, 598, 600, 601, 602, 603, 604, 605, 606, 608, 609, 610, 612, 613, 614, 615, 616, 617, 618, 619, 620, 621, 622, 623, 624, 625, 626, 627, 628, 629, 630, 631, 632, 633, 634, 635, 636, 640, 641, 642, 644, 645, 646, 647, 648, 649, 650, 651, 652, 653, 654, 655, 656, 657, 658, 659, 660, 661, 662, 663, 664, 666, 667, 668, 669, 671, 672, 673, 674, 675, 676, 677, 678, 679, 681, 683, 684, 685, 687, 688, 690, 691, 692, 693, 694, 695, 696, 697, 698, 699, 700, 701, 702, 703, 704, 705, 706, 707, 708, 710, 712, 713, 714, 716, 717, 718, 719, 720, 721, 722, 723, 724, 725, 726, 727, 729, 731, 732, 733, 734, 735, 736, 737, 739, 742, 743, 744, 745, 746, 747, 748, 749, 750, 751, 752, 753, 754, 756, 757, 758, 759, 760, 761, 762, 763, 765, 766, 768, 769, 770, 771, 772, 773, 775, 776, 777, 778, 779, 782, 783, 785, 786, 787, 788, 790, 792, 793, 794, 795, 796, 797, 798, 799, 800, 801, 802, 803, 804, 805, 806, 807, 808, 809, 810, 811, 812, 814, 815, 816, 818, 819, 820, 821, 822, 825, 826, 827, 828, 829, 830, 832, 833, 834, 835, 836, 838, 839, 840, 841, 842, 844, 845, 846, 848, 849, 850, 851, 852, 853, 854, 856, 858, 859, 860, 861, 862, 863, 864, 865, 866, 867, 868, 869, 870, 871, 872, 873, 875, 876, 877, 878, 879, 880, 881, 882, 883, 884, 885, 886, 887, 888, 889]
[13, 16, 20, 23, 31, 35, 38, 40, 60, 74, 81, 85, 94, 97, 107, 110, 119, 120, 123, 128, 133, 136, 148, 154, 156, 162, 175, 186, 187, 188, 199, 200, 202, 203, 205, 213, 217, 229, 232, 240, 243, 244, 259, 282, 290, 307, 314, 315, 319, 321, 324, 336, 341, 344, 348, 349, 360, 382, 389, 403, 405, 422, 425, 433, 437, 441, 461, 465, 471, 477, 490, 511, 515, 516, 517, 525, 526, 528, 531, 542, 550, 558, 586, 599, 613, 616, 627, 643, 647, 660, 677, 682, 697, 700, 702, 707, 715, 723, 727, 748, 755, 768, 770, 772, 780, 782, 795, 796, 810, 814, 816, 821, 827, 832, 838, 845, 849, 855, 856, 876, 880, 882]

