[0, 3, 37, 110, 131, 171, 210, 322, 334, 351, 359, 398, 425, 461, 477, 511, 520, 592, 657, 754, 824, 834]
[148, 173, 262, 280, 310, 333, 339, 376, 464, 484, 521, 553, 630, 667, 681, 695, 730, 788, 794, 821, 828, 877]

[0, 3, 37, 110, 131, 171, 210, 322, 334, 351, 359, 398, 425, 461, 477, 511, 520, 592, 657, 754, 824, 834]
[1, 8, 13, 34, 44, 45, 60, 64, 71, 76, 81, 102, 106, 111, 114, 127, 132, 137, 144, 148, 151, 173, 176, 193, 194, 197, 209, 214, 224, 229, 235, 243, 246, 249, 261, 262, 272, 273, 278, 280, 288, 296, 309, 310, 319, 320, 328, 333, 337, 339, 356, 357, 362, 363, 364, 367, 368, 376, 377, 379, 403, 419, 421, 426, 427, 433, 454, 464, 470, 472, 481, 484, 487, 496, 516, 519, 521, 531, 534, 541, 547, 553, 573, 588, 590, 599, 605, 615, 616, 617, 628, 630, 639, 645, 647, 667, 681, 683, 691, 695, 730, 742, 748, 759, 761, 788, 794, 796, 805, 808, 816, 821, 825, 828, 835, 839, 842, 847, 858, 866, 877, 888]

[0, 3, 4, 18, 22, 37, 41, 43, 45, 47, 55, 56, 74, 110, 119, 126, 128, 131, 137, 145, 170, 171, 176, 210, 211, 214, 231, 237, 245, 246, 270, 271, 294, 305, 311, 322, 323, 334, 336, 347, 351, 359, 395, 398, 400, 425, 430, 436, 438, 442, 445, 454, 457, 461, 465, 477, 481, 489, 497, 511, 520, 524, 526, 556, 558, 565, 580, 592, 596, 632, 634, 657, 661, 672, 686, 713, 717, 719, 722, 723, 736, 739, 742, 753, 754, 755, 761, 778, 791, 795, 801, 807, 824, 834, 836, 847, 864]
[1, 8, 13, 34, 44, 45, 60, 64, 71, 76, 81, 102, 106, 111, 114, 127, 132, 137, 144, 148, 151, 173, 176, 193, 194, 197, 209, 214, 224, 229, 235, 243, 246, 249, 261, 262, 272, 273, 278, 280, 288, 296, 309, 310, 319, 320, 328, 333, 337, 339, 356, 357, 362, 363, 364, 367, 368, 376, 377, 379, 403, 419, 421, 426, 427, 433, 454, 464, 470, 472, 481, 484, 487, 496, 516, 519, 521, 531, 534, 541, 547, 553, 573, 588, 590, 599, 605, 615, 616, 617, 628, 630, 639, 645, 647, 667, 681, 683, 691, 695, 730, 742, 748, 759, 761, 788, 794, 796, 805, 808, 816, 821, 825, 828, 835, 839, 842, 847, 858, 866, 877, 888]

[0, 3, 4, 8, 11, 18, 22, 25, 37, 41, 43, 45, 47, 49, 55, 56, 61, 74, 79, 91, 110, 119, 126, 128, 131, 137, 145, 148, 152, 159, 167, 170, 171, 173, 176, 188, 198, 202, 205, 210, 211, 214, 215, 231, 235, 237, 245, 246, 260, 265, 270, 271, 294, 296, 305, 311, 315, 322, 323, 334, 336, 347, 351, 359, 360, 368, 371, 372, 384, 395, 398, 400, 403, 411, 414, 415, 421, 422, 425, 430, 436, 438, 442, 445, 454, 457, 460, 461, 465, 470, 477, 481, 489, 497, 498, 510, 511, 520, 522, 524, 526, 535, 537, 556, 557, 558, 560, 563, 565, 570, 580, 585, 589, 592, 596, 603, 607, 608, 621, 632, 634, 635, 638, 648, 657, 661, 670, 672, 676, 681, 686, 687, 690, 695, 713, 717, 719, 721, 722, 723, 724, 729, 736, 739, 742, 753, 754, 755, 756, 761, 764, 770, 778, 791, 795, 801, 803, 804, 806, 807, 816, 820, 821, 824, 829, 833, 834, 836, 847, 855, 864, 866]
[1, 8, 13, 34, 44, 45, 60, 64, 71, 76, 81, 102, 106, 111, 114, 127, 132, 137, 144, 148, 151, 173, 176, 193, 194, 197, 209, 214, 224, 229, 235, 243, 246, 249, 261, 262, 272, 273, 278, 280, 288, 296, 309, 310, 319, 320, 328, 333, 337, 339, 356, 357, 362, 363, 364, 367, 368, 376, 377, 379, 403, 419, 421, 426, 427, 433, 454, 464, 470, 472, 481, 484, 487, 496, 516, 519, 521, 531, 534, 541, 547, 553, 573, 588, 590, 599, 605, 615, 616, 617, 628, 630, 639, 645, 647, 667, 681, 683, 691, 695, 730, 742, 748, 759, 761, 788, 794, 796, 805, 808, 816, 821, 825, 828, 835, 839, 842, 847, 858, 866, 877, 888]

[0, 1, 2, 3, 4, 8, 11, 18, 19, 22, 25, 37, 41, 43, 45, 47, 49, 51, 55, 56, 58, 61, 74, 79, 91, 94, 110, 111, 119, 123, 126, 127, 128, 131, 133, 135, 137, 139, 142, 143, 145, 148, 152, 159, 162, 167, 170, 171, 173, 176, 179, 187, 188, 198, 202, 205, 209, 210, 211, 214, 215, 217, 228, 231, 233, 235, 237, 245, 246, 247, 250, 260, 264, 265, 270, 271, 272, 279, 294, 296, 297, 305, 311, 315, 320, 322, 323, 332, 334, 336, 347, 351, 353, 359, 360, 368, 371, 372, 376, 384, 390, 393, 395, 398, 400, 403, 411, 414, 415, 421, 422, 425, 430, 431, 433, 436, 437, 438, 442, 445, 447, 454, 457, 459, 460, 461, 462, 465, 470, 477, 478, 481, 483, 489, 497, 498, 500, 510, 511, 520, 522, 524, 525, 526, 533, 535, 537, 538, 540, 556, 557, 558, 560, 563, 564, 565, 570, 572, 576, 580, 585, 589, 590, 592, 596, 603, 607, 608, 621, 632, 634, 635, 638, 642, 648, 650, 657, 661, 667, 670, 671, 672, 674, 676, 681, 686, 687, 688, 690, 694, 695, 700, 711, 712, 713, 717, 719, 721, 722, 723, 724, 729, 732, 733, 736, 739, 742, 751, 753, 754, 755, 756, 761, 764, 767, 770, 778, 780, 785, 791, 795, 801, 803, 804, 805, 806, 807, 816, 817, 820, 821, 824, 829, 833, 834, 836, 837, 838, 842, 847, 855, 861, 864, 866, 875, 879, 880]
[1, 8, 13, 34, 44, 45, 60, 64, 71, 76, 81, 102, 106, 111, 114, 127, 132, 137, 144, 148, 151, 173, 176, 193, 194, 197, 209, 214, 224, 229, 235, 243, 246, 249, 261, 262, 272, 273, 278, 280, 288, 296, 309, 310, 319, 320, 328, 333, 337, 339, 356, 357, 362, 363, 364, 367, 368, 376, 377, 379, 403, 419, 421, 426, 427, 433, 454, 464, 470, 472, 481, 484, 487, 496, 516, 519, 521, 531, 534, 541, 547, 553, 573, 588, 590, 599, 605, 615, 616, 617, 628, 630, 639, 645, 647, 667, 681, 683, 691, 695, 730, 742, 748, 759, 761, 788, 794, 796, 805, 808, 816, 821, 825, 828, 835, 839, 842, 847, 858, 866, 877, 888]

[0, 1, 2, 3, 4, 6, 8, 11, 18, 19, 22, 25, 37, 41, 43, 45, 47, 49, 51, 55, 56, 57, 58, 61, 71, 74, 79, 91, 94, 99, 100, 102, 110, 111, 119, 123, 126, 127, 128, 131, 133, 135, 137, 139, 142, 143, 145, 148, 151, 152, 153, 159, 162, 166, 167, 170, 171, 172, 173, 176, 178, 179, 185, 187, 188, 191, 196, 197, 198, 202, 205, 208, 209, 210, 211, 214, 215, 217, 223, 228, 231, 232, 233, 235, 237, 239, 245, 246, 247, 250, 255, 260, 264, 265, 270, 271, 272, 275, 279, 281, 284, 287, 294, 295, 296, 297, 302, 305, 311, 313, 315, 318, 320, 322, 323, 328, 332, 334, 336, 347, 350, 351, 353, 358, 359, 360, 362, 368, 371, 372, 376, 384, 386, 387, 390, 393, 395, 398, 400, 401, 403, 411, 412, 413, 414, 415, 417, 421, 422, 424, 425, 430, 431, 433, 436, 437, 438, 442, 445, 447, 449, 454, 457, 458, 459, 460, 461, 462, 463, 465, 470, 473, 476, 477, 478, 481, 483, 485, 486, 489, 491, 496, 497, 498, 500, 501, 502, 510, 511, 513, 520, 522, 524, 525, 526, 533, 535, 537, 538, 540, 556, 557, 558, 560, 563, 564, 565, 567, 570, 572, 576, 579, 580, 585, 589, 590, 592, 596, 603, 607, 608, 609, 621, 631, 632, 634, 635, 638, 642, 648, 649, 650, 655, 657, 659, 661, 667, 670, 671, 672, 674, 676, 679, 681, 686, 687, 688, 690, 694, 695, 700, 708, 711, 712, 713, 717, 719, 721, 722, 723, 724, 729, 732, 733, 736, 739, 742, 745, 746, 747, 750, 751, 753, 754, 755, 756, 761, 764, 767, 770, 771, 778, 780, 785, 791, 795, 801, 803, 804, 805, 806, 807, 815, 816, 817, 820, 821, 823, 824, 828, 829, 833, 834, 836, 837, 838, 842, 843, 845, 846, 847, 854, 855, 861, 864, 866, 867, 875, 876, 878, 879, 880]
[1, 8, 13, 34, 44, 45, 60, 64, 71, 76, 81, 102, 106, 111, 114, 127, 132, 137, 144, 148, 151, 173, 176, 193, 194, 197, 209, 214, 224, 229, 235, 243, 246, 249, 261, 262, 272, 273, 278, 280, 288, 296, 309, 310, 319, 320, 328, 333, 337, 339, 356, 357, 362, 363, 364, 367, 368, 376, 377, 379, 403, 419, 421, 426, 427, 433, 454, 464, 470, 472, 481, 484, 487, 496, 516, 519, 521, 531, 534, 541, 547, 553, 573, 588, 590, 599, 605, 615, 616, 617, 628, 630, 639, 645, 647, 667, 681, 683, 691, 695, 730, 742, 748, 759, 761, 788, 794, 796, 805, 808, 816, 821, 825, 828, 835, 839, 842, 847, 858, 866, 877, 888]

[0, 1, 2, 3, 4, 6, 8, 11, 18, 19, 22, 25, 27, 30, 37, 40, 41, 43, 45, 47, 49, 50, 51, 55, 56, 57, 58, 61, 66, 71, 73, 74, 79, 91, 94, 99, 100, 102, 110, 111, 112, 116, 119, 123, 126, 127, 128, 130, 131, 133, 134, 135, 137, 138, 139, 142, 143, 145, 146, 148, 150, 151, 152, 153, 159, 161, 162, 166, 167, 170, 171, 172, 173, 174, 175, 176, 178, 179, 180, 185, 187, 188, 191, 196, 197, 198, 202, 203, 205, 206, 208, 209, 210, 211, 214, 215, 216, 217, 223, 227, 228, 229, 231, 232, 233, 235, 237, 239, 244, 245, 246, 247, 250, 251, 255, 260, 264, 265, 270, 271, 272, 275, 277, 279, 281, 284, 287, 289, 292, 294, 295, 296, 297, 302, 305, 308, 311, 313, 314, 315, 318, 320, 322, 323, 324, 325, 328, 331, 332, 333, 334, 336, 337, 346, 347, 350, 351, 353, 354, 356, 358, 359, 360, 362, 366, 368, 371, 372, 376, 381, 384, 386, 387, 390, 393, 394, 395, 398, 400, 401, 403, 408, 409, 411, 412, 413, 414, 415, 417, 421, 422, 424, 425, 427, 430, 431, 433, 436, 437, 438, 442, 445, 447, 449, 452, 454, 456, 457, 458, 459, 460, 461, 462, 463, 464, 465, 470, 471, 473, 475, 476, 477, 478, 481, 483, 485, 486, 489, 490, 491, 496, 497, 498, 500, 501, 502, 506, 510, 511, 513, 520, 521, 522, 524, 525, 526, 530, 533, 535, 537, 538, 540, 549, 555, 556, 557, 558, 560, 563, 564, 565, 567, 570, 572, 576, 579, 580, 581, 585, 589, 590, 592, 596, 599, 600, 603, 604, 607, 608, 609, 621, 631, 632, 634, 635, 638, 641, 642, 647, 648, 649, 650, 655, 657, 659, 661, 667, 670, 671, 672, 674, 676, 679, 681, 685, 686, 687, 688, 690, 694, 695, 700, 701, 703, 708, 711, 712, 713, 716, 717, 718, 719, 721, 722, 723, 724, 729, 730, 732, 733, 736, 739, 742, 745, 746, 747, 750, 751, 752, 753, 754, 755, 756, 761, 764, 767, 769, 770, 771, 778, 779, 780, 785, 791, 795, 801, 803, 804, 805, 806, 807, 811, 815, 816, 817, 820, 821, 823, 824, 827, 828, 829, 833, 834, 836, 837, 838, 842, 843, 845, 846, 847, 854, 855, 857, 858, 860, 861, 864, 866, 867, 869, 875, 876, 878, 879, 880, 885, 889]
[1, 8, 13, 34, 44, 45, 60, 64, 71, 76, 81, 102, 106, 111, 114, 127, 132, 137, 144, 148, 151, 173, 176, 193, 194, 197, 209, 214, 224, 229, 235, 243, 246, 249, 261, 262, 272, 273, 278, 280, 288, 296, 309, 310, 319, 320, 328, 333, 337, 339, 356, 357, 362, 363, 364, 367, 368, 376, 377, 379, 403, 419, 421, 426, 427, 433, 454, 464, 470, 472, 481, 484, 487, 496, 516, 519, 521, 531, 534, 541, 547, 553, 573, 588, 590, 599, 605, 615, 616, 617, 628, 630, 639, 645, 647, 667, 681, 683, 691, 695, 730, 742, 748, 759, 761, 788, 794, 796, 805, 808, 816, 821, 825, 828, 835, 839, 842, 847, 858, 866, 877, 888]

[0, 1, 2, 3, 4, 6, 7, 8, 11, 17, 18, 19, 21, 22, 25, 27, 30, 31, 37, 40, 41, 42, 43, 44, 45, 47, 49, 50, 51, 55, 56, 57, 58, 61, 66, 67, 71, 73, 74, 79, 81, 89, 91, 92, 94, 99, 100, 102, 109, 110, 111, 112, 116, 117, 118, 119, 120, 123, 126, 127, 128, 130, 131, 133, 134, 135, 137, 138, 139, 140, 141, 142, 143, 145, 146, 147, 148, 150, 151, 152, 153, 159, 161, 162, 166, 167, 169, 170, 171, 172, 173, 174, 175, 176, 178, 179, 180, 185, 187, 188, 191, 193, 196, 197, 198, 202, 203, 204, 205, 206, 208, 209, 210, 211, 212, 214, 215, 216, 217, 223, 226, 227, 228, 229, 231, 232, 233, 235, 237, 239, 244, 245, 246, 247, 250, 251, 255, 260, 264, 265, 268, 270, 271, 272, 273, 275, 277, 279, 281, 284, 287, 289, 292, 294, 295, 296, 297, 302, 305, 308, 311, 313, 314, 315, 317, 318, 320, 322, 323, 324, 325, 328, 330, 331, 332, 333, 334, 336, 337, 342, 346, 347, 350, 351, 353, 354, 356, 358, 359, 360, 362, 366, 368, 369, 371, 372, 376, 379, 381, 384, 386, 387, 390, 393, 394, 395, 398, 400, 401, 403, 406, 408, 409, 410, 411, 412, 413, 414, 415, 417, 418, 421, 422, 424, 425, 427, 430, 431, 433, 436, 437, 438, 441, 442, 444, 445, 447, 449, 450, 452, 454, 456, 457, 458, 459, 460, 461, 462, 463, 464, 465, 470, 471, 473, 475, 476, 477, 478, 481, 483, 484, 485, 486, 489, 490, 491, 492, 496, 497, 498, 499, 500, 501, 502, 504, 506, 510, 511, 512, 513, 514, 520, 521, 522, 524, 525, 526, 528, 530, 533, 535, 537, 538, 540, 543, 549, 552, 555, 556, 557, 558, 560, 563, 564, 565, 567, 570, 571, 572, 576, 578, 579, 580, 581, 585, 586, 589, 590, 592, 594, 595, 596, 597, 599, 600, 601, 603, 604, 607, 608, 609, 612, 619, 621, 625, 631, 632, 634, 635, 637, 638, 639, 641, 642, 643, 645, 647, 648, 649, 650, 655, 657, 659, 661, 666, 667, 670, 671, 672, 674, 676, 677, 679, 681, 683, 685, 686, 687, 688, 690, 694, 695, 700, 701, 703, 707, 708, 709, 711, 712, 713, 716, 717, 718, 719, 721, 722, 723, 724, 727, 729, 730, 732, 733, 736, 739, 742, 745, 746, 747, 750, 751, 752, 753, 754, 755, 756, 758, 761, 762, 764, 767, 768, 769, 770, 771, 774, 778, 779, 780, 781, 785, 789, 791, 795, 799, 801, 803, 804, 805, 806, 807, 810, 811, 812, 813, 815, 816, 817, 820, 821, 823, 824, 827, 828, 829, 833, 834, 836, 837, 838, 842, 843, 845, 846, 847, 854, 855, 857, 858, 860, 861, 864, 866, 867, 869, 875, 876, 878, 879, 880, 881, 885, 889]
[1, 8, 13, 34, 44, 45, 60, 64, 71, 76, 81, 102, 106, 111, 114, 127, 132, 137, 144, 148, 151, 173, 176, 193, 194, 197, 209, 214, 224, 229, 235, 243, 246, 249, 261, 262, 272, 273, 278, 280, 288, 296, 309, 310, 319, 320, 328, 333, 337, 339, 356, 357, 362, 363, 364, 367, 368, 376, 377, 379, 403, 419, 421, 426, 427, 433, 454, 464, 470, 472, 481, 484, 487, 496, 516, 519, 521, 531, 534, 541, 547, 553, 573, 588, 590, 599, 605, 615, 616, 617, 628, 630, 639, 645, 647, 667, 681, 683, 691, 695, 730, 742, 748, 759, 761, 788, 794, 796, 805, 808, 816, 821, 825, 828, 835, 839, 842, 847, 858, 866, 877, 888]

[0, 1, 2, 3, 4, 6, 7, 8, 11, 17, 18, 19, 21, 22, 25, 27, 30, 31, 37, 38, 40, 41, 42, 43, 44, 45, 47, 49, 50, 51, 55, 56, 57, 58, 60, 61, 63, 66, 67, 68, 70, 71, 73, 74, 79, 81, 89, 91, 92, 93, 94, 99, 100, 102, 104, 107, 109, 110, 111, 112, 116, 117, 118, 119, 120, 123, 125, 126, 127, 128, 130, 131, 132, 133, 134, 135, 136, 137, 138, 139, 140, 141, 142, 143, 145, 146, 147, 148, 150, 151, 152, 153, 157, 159, 161, 162, 163, 164, 166, 167, 169, 170, 171, 172, 173, 174, 175, 176, 178, 179, 180, 184, 185, 187, 188, 190, 191, 193, 196, 197, 198, 199, 202, 203, 204, 205, 206, 208, 209, 210, 211, 212, 214, 215, 216, 217, 220, 223, 225, 226, 227, 228, 229, 231, 232, 233, 235, 237, 239, 244, 245, 246, 247, 248, 250, 251, 252, 253, 254, 255, 260, 264, 265, 268, 270, 271, 272, 273, 275, 277, 279, 281, 284, 285, 287, 289, 291, 292, 294, 295, 296, 297, 299, 302, 305, 307, 308, 309, 311, 313, 314, 315, 317, 318, 320, 322, 323, 324, 325, 328, 330, 331, 332, 333, 334, 336, 337, 339, 342, 346, 347, 350, 351, 353, 354, 356, 358, 359, 360, 362, 366, 368, 369, 371, 372, 376, 378, 379, 381, 384, 386, 387, 390, 391, 393, 394, 395, 397, 398, 400, 401, 403, 406, 408, 409, 410, 411, 412, 413, 414, 415, 417, 418, 421, 422, 424, 425, 427, 430, 431, 433, 436, 437, 438, 441, 442, 443, 444, 445, 447, 449, 450, 451, 452, 454, 455, 456, 457, 458, 459, 460, 461, 462, 463, 464, 465, 470, 471, 472, 473, 475, 476, 477, 478, 481, 482, 483, 484, 485, 486, 488, 489, 490, 491, 492, 494, 496, 497, 498, 499, 500, 501, 502, 504, 506, 510, 511, 512, 513, 514, 516, 520, 521, 522, 524, 525, 526, 528, 530, 533, 534, 535, 537, 538, 540, 543, 548, 549, 552, 555, 556, 557, 558, 559, 560, 563, 564, 565, 567, 570, 571, 572, 576, 577, 578, 579, 580, 581, 585, 586, 589, 590, 591, 592, 594, 595, 596, 597, 598, 599, 600, 601, 603, 604, 606, 607, 608, 609, 610, 612, 619, 621, 625, 626, 627, 631, 632, 634, 635, 637, 638, 639, 641, 642, 643, 644, 645, 647, 648, 649, 650, 652, 655, 657, 659, 661, 666, 667, 668, 669, 670, 671, 672, 674, 675, 676, 677, 679, 681, 683, 685, 686, 687, 688, 690, 693, 694, 695, 696, 699, 700, 701, 702, 703, 707, 708, 709, 711, 712, 713, 716, 717, 718, 719, 721, 722, 723, 724, 727, 728, 729, 730, 732, 733, 736, 739, 740, 742, 745, 746, 747, 749, 750, 751, 752, 753, 754, 755, 756, 757, 758, 759, 760, 761, 762, 764, 767, 768, 769, 770, 771, 774, 776, 777, 778, 779, 780, 781, 782, 784, 785, 788, 789, 791, 792, 794, 795, 799, 801, 803, 804, 805, 806, 807, 810, 811, 812, 813, 814, 815, 816, 817, 820, 821, 822, 823, 824, 827, 828, 829, 832, 833, 834, 836, 837, 838, 840, 842, 843, 845, 846, 847, 848, 854, 855, 857, 858, 859, 860, 861, 863, 864, 865, 866, 867, 869, 875, 876, 878, 879, 880, 881, 885, 888, 889]
[1, 8, 13, 34, 44, 45, 60, 64, 71, 76, 81, 102, 106, 111, 114, 127, 132, 137, 144, 148, 151, 173, 176, 193, 194, 197, 209, 214, 224, 229, 235, 243, 246, 249, 261, 262, 272, 273, 278, 280, 288, 296, 309, 310, 319, 320, 328, 333, 337, 339, 356, 357, 362, 363, 364, 367, 368, 376, 377, 379, 403, 419, 421, 426, 427, 433, 454, 464, 470, 472, 481, 484, 487, 496, 516, 519, 521, 531, 534, 541, 547, 553, 573, 588, 590, 599, 605, 615, 616, 617, 628, 630, 639, 645, 647, 667, 681, 683, 691, 695, 730, 742, 748, 759, 761, 788, 794, 796, 805, 808, 816, 821, 825, 828, 835, 839, 842, 847, 858, 866, 877, 888]

[0, 1, 2, 3, 4, 6, 7, 8, 11, 12, 17, 18, 19, 21, 22, 25, 27, 28, 30, 31, 35, 36, 37, 38, 39, 40, 41, 42, 43, 44, 45, 46, 47, 48, 49, 50, 51, 54, 55, 56, 57, 58, 60, 61, 62, 63, 66, 67, 68, 70, 71, 72, 73, 74, 79, 81, 82, 83, 89, 91, 92, 93, 94, 99, 100, 102, 104, 107, 109, 110, 111, 112, 116, 117, 118, 119, 120, 123, 125, 126, 127, 128, 129, 130, 131, 132, 133, 134, 135, 136, 137, 138, 139, 140, 141, 142, 143, 145, 146, 147, 148, 150, 151, 152, 153, 157, 159, 160, 161, 162, 163, 164, 166, 167, 168, 169, 170, 171, 172, 173, 174, 175, 176, 178, 179, 180, 183, 184, 185, 187, 188, 190, 191, 193, 194, 196, 197, 198, 199, 202, 203, 204, 205, 206, 207, 208, 209, 210, 211, 212, 213, 214, 215, 216, 217, 218, 219, 220, 221, 223, 224, 225, 226, 227, 228, 229, 231, 232, 233, 235, 237, 238, 239, 240, 243, 244, 245, 246, 247, 248, 250, 251, 252, 253, 254, 255, 260, 261, 262, 263, 264, 265, 268, 270, 271, 272, 273, 275, 277, 278, 279, 281, 283, 284, 285, 287, 289, 291, 292, 293, 294, 295, 296, 297, 299, 302, 303, 305, 307, 308, 309, 311, 313, 314, 315, 317, 318, 320, 322, 323, 324, 325, 327, 328, 330, 331, 332, 333, 334, 336, 337, 339, 342, 346, 347, 350, 351, 352, 353, 354, 356, 357, 358, 359, 360, 361, 362, 366, 368, 369, 370, 371, 372, 373, 375, 376, 378, 379, 380, 381, 384, 386, 387, 390, 391, 393, 394, 395, 397, 398, 400, 401, 403, 406, 408, 409, 410, 411, 412, 413, 414, 415, 417, 418, 421, 422, 424, 425, 427, 430, 431, 433, 436, 437, 438, 439, 440, 441, 442, 443, 444, 445, 447, 449, 450, 451, 452, 454, 455, 456, 457, 458, 459, 460, 461, 462, 463, 464, 465, 470, 471, 472, 473, 475, 476, 477, 478, 479, 480, 481, 482, 483, 484, 485, 486, 488, 489, 490, 491, 492, 494, 496, 497, 498, 499, 500, 501, 502, 504, 506, 510, 511, 512, 513, 514, 516, 517, 519, 520, 521, 522, 523, 524, 525, 526, 528, 529, 530, 531, 532, 533, 534, 535, 537, 538, 539, 540, 541, 542, 543, 544, 548, 549, 552, 553, 555, 556, 557, 558, 559, 560, 561, 563, 564, 565, 566, 567, 569, 570, 571, 572, 576, 577, 578, 579, 580, 581, 582, 585, 586, 589, 590, 591, 592, 594, 595, 596, 597, 598, 599, 600, 601, 603, 604, 606, 607, 608, 609, 610, 612, 615, 617, 619, 620, 621, 625, 626, 627, 631, 632, 634, 635, 637, 638, 639, 641, 642, 643, 644, 645, 646, 647, 648, 649, 650, 652, 655, 656, 657, 659, 661, 666, 667, 668, 669, 670, 671, 672, 674, 675, 676, 677, 679, 681, 683, 685, 686, 687, 688, 690, 691, 693, 694, 695, 696, 697, 698, 699, 700, 701, 702, 703, 707, 708, 709, 711, 712, 713, 714, 716, 717, 718, 719, 721, 722, 723, 724, 727, 728, 729, 730, 732, 733, 736, 739, 740, 742, 744, 745, 746, 747, 748, 749, 750, 751, 752, 753, 754, 755, 756, 757, 758, 759, 760, 761, 762, 764, 767, 768, 769, 770, 771, 773, 774, 776, 777, 778, 779, 780, 781, 782, 784, 785, 787, 788, 789, 791, 792, 794, 795, 799, 801, 803, 804, 805, 806, 807, 810, 811, 812, 813, 814, 815, 816, 817, 818, 820, 821, 822, 823, 824, 827, 828, 829, 832, 833, 834, 836, 837, 838, 840, 842, 843, 845, 846, 847, 848, 854, 855, 857, 858, 859, 860, 861, 862, 863, 864, 865, 866, 867, 869, 873, 875, 876, 878, 879, 880, 881, 884, 885, 888, 889]
[1, 8, 13, 34, 44, 45, 60, 64, 71, 76, 81, 102, 106, 111, 114, 127, 132, 137, 144, 148, 151, 173, 176, 193, 194, 197, 209, 214, 224, 229, 235, 243, 246, 249, 261, 262, 272, 273, 278, 280, 288, 296, 309, 310, 319, 320, 328, 333, 337, 339, 356, 357, 362, 363, 364, 367, 368, 376, 377, 379, 403, 419, 421, 426, 427, 433, 454, 464, 470, 472, 481, 484, 487, 496, 516, 519, 521, 531, 534, 541, 547, 553, 573, 588, 590, 599, 605, 615, 616, 617, 628, 630, 639, 645, 647, 667, 681, 683, 691, 695, 730, 742, 748, 759, 761, 788, 794, 796, 805, 808, 816, 821, 825, 828, 835, 839, 842, 847, 858, 866, 877, 888]

[0, 1, 2, 3, 4, 6, 7, 8, 9, 10, 11, 12, 15, 16, 17, 18, 19, 21, 22, 24, 25, 27, 28, 30, 31, 32, 33, 35, 36, 37, 38, 39, 40, 41, 42, 43, 44, 45, 46, 47, 48, 49, 50, 51, 54, 55, 56, 57, 58, 60, 61, 62, 63, 64, 66, 67, 68, 70, 71, 72, 73, 74, 76, 79, 81, 82, 83, 87, 88, 89, 91, 92, 93, 94, 97, 99, 100, 101, 102, 104, 107, 109, 110, 111, 112, 116, 117, 118, 119, 120, 123, 125, 126, 127, 128, 129, 130, 131, 132, 133, 134, 135, 136, 137, 138, 139, 140, 141, 142, 143, 144, 145, 146, 147, 148, 150, 151, 152, 153, 154, 156, 157, 159, 160, 161, 162, 163, 164, 165, 166, 167, 168, 169, 170, 171, 172, 173, 174, 175, 176, 178, 179, 180, 183, 184, 185, 187, 188, 190, 191, 193, 194, 196, 197, 198, 199, 202, 203, 204, 205, 206, 207, 208, 209, 210, 211, 212, 213, 214, 215, 216, 217, 218, 219, 220, 221, 223, 224, 225, 226, 227, 228, 229, 230, 231, 232, 233, 235, 237, 238, 239, 240, 241, 243, 244, 245, 246, 247, 248, 250, 251, 252, 253, 254, 255, 258, 260, 261, 262, 263, 264, 265, 268, 269, 270, 271, 272, 273, 275, 276, 277, 278, 279, 281, 282, 283, 284, 285, 287, 289, 291, 292, 293, 294, 295, 296, 297, 298, 299, 302, 303, 305, 306, 307, 308, 309, 310, 311, 312, 313, 314, 315, 317, 318, 319, 320, 322, 323, 324, 325, 326, 327, 328, 329, 330, 331, 332, 333, 334, 335, 336, 337, 338, 339, 342, 343, 346, 347, 350, 351, 352, 353, 354, 356, 357, 358, 359, 360, 361, 362, 363, 366, 368, 369, 370, 371, 372, 373, 375, 376, 378, 379, 380, 381, 382, 384, 386, 387, 388, 390, 391, 392, 393, 394, 395, 397, 398, 400, 401, 403, 406, 408, 409, 410, 411, 412, 413, 414, 415, 417, 418, 421, 422, 424, 425, 426, 427, 430, 431, 433, 434, 436, 437, 438, 439, 440, 441, 442, 443, 444, 445, 446, 447, 448, 449, 450, 451, 452, 454, 455, 456, 457, 458, 459, 460, 461, 462, 463, 464, 465, 470, 471, 472, 473, 475, 476, 477, 478, 479, 480, 481, 482, 483, 484, 485, 486, 488, 489, 490, 491, 492, 493, 494, 495, 496, 497, 498, 499, 500, 501, 502, 503, 504, 506, 510, 511, 512, 513, 514, 516, 517, 519, 520, 521, 522, 523, 524, 525, 526, 528, 529, 530, 531, 532, 533, 534, 535, 537, 538, 539, 540, 541, 542, 543, 544, 546, 547, 548, 549, 551, 552, 553, 555, 556, 557, 558, 559, 560, 561, 562, 563, 564, 565, 566, 567, 568, 569, 570, 571, 572, 573, 574, 576, 577, 578, 579, 580, 581, 582, 585, 586, 589, 590, 591, 592, 594, 595, 596, 597, 598, 599, 600, 601, 603, 604, 606, 607, 608, 609, 610, 612, 615, 616, 617, 618, 619, 620, 621, 622, 624, 625, 626, 627, 629, 630, 631, 632, 633, 634, 635, 637, 638, 639, 641, 642, 643, 644, 645, 646, 647, 648, 649, 650, 652, 655, 656, 657, 659, 661, 662, 664, 666, 667, 668, 669, 670, 671, 672, 674, 675, 676, 677, 678, 679, 681, 683, 685, 686, 687, 688, 690, 691, 693, 694, 695, 696, 697, 698, 699, 700, 701, 702, 703, 704, 705, 706, 707, 708, 709, 711, 712, 713, 714, 716, 717, 718, 719, 721, 722, 723, 724, 726, 727, 728, 729, 730, 732, 733, 736, 739, 740, 742, 744, 745, 746, 747, 748, 749, 750, 751, 752, 753, 754, 755, 756, 757, 758, 759, 760, 761, 762, 764, 767, 768, 769, 770, 771, 773, 774, 775, 776, 777, 778, 779, 780, 781, 782, 784, 785, 787, 788, 789, 791, 792, 793, 794, 795, 796, 798, 799, 800, 801, 803, 804, 805, 806, 807, 810, 811, 812, 813, 814, 815, 816, 817, 818, 819, 820, 821, 822, 823, 824, 826, 827, 828, 829, 830, 832, 833, 834, 836, 837, 838, 839, 840, 841, 842, 843, 845, 846, 847, 848, 849, 852, 854, 855, 857, 858, 859, 860, 861, 862, 863, 864, 865, 866, 867, 868, 869, 873, 875, 876, 878, 879, 880, 881, 884, 885, 888, 889]
[1, 8, 13, 34, 44, 45, 60, 64, 71, 76, 81, 102, 106, 111, 114, 127, 132, 137, 144, 148, 151, 173, 176, 193, 194, 197, 209, 214, 224, 229, 235, 243, 246, 249, 261, 262, 272, 273, 278, 280, 288, 296, 309, 310, 319, 320, 328, 333, 337, 339, 356, 357, 362, 363, 364, 367, 368, 376, 377, 379, 403, 419, 421, 426, 427, 433, 454, 464, 470, 472, 481, 484, 487, 496, 516, 519, 521, 531, 534, 541, 547, 553, 573, 588, 590, 599, 605, 615, 616, 617, 628, 630, 639, 645, 647, 667, 681, 683, 691, 695, 730, 742, 748, 759, 761, 788, 794, 796, 805, 808, 816, 821, 825, 828, 835, 839, 842, 847, 858, 866, 877, 888]

[0, 1, 2, 3, 4, 6, 7, 8, 9, 10, 11, 12, 13, 15, 16, 17, 18, 19, 21, 22, 24, 25, 26, 27, 28, 30, 31, 32, 33, 35, 36, 37, 38, 39, 40, 41, 42, 43, 44, 45, 46, 47, 48, 49, 50, 51, 52, 54, 55, 56, 57, 58, 60, 61, 62, 63, 64, 66, 67, 68, 70, 71, 72, 73, 74, 75, 76, 78, 79, 81, 82, 83, 84, 86, 87, 88, 89, 91, 92, 93, 94, 95, 97, 98, 99, 100, 101, 102, 104, 105, 106, 107, 109, 110, 111, 112, 113, 116, 117, 118, 119, 120, 121, 123, 125, 126, 127, 128, 129, 130, 131, 132, 133, 134, 135, 136, 137, 138, 139, 140, 141, 142, 143, 144, 145, 146, 147, 148, 149, 150, 151, 152, 153, 154, 156, 157, 159, 160, 161, 162, 163, 164, 165, 166, 167, 168, 169, 170, 171, 172, 173, 174, 175, 176, 178, 179, 180, 181, 183, 184, 185, 187, 188, 189, 190, 191, 192, 193, 194, 196, 197, 198, 199, 200, 202, 203, 204, 205, 206, 207, 208, 209, 210, 211, 212, 213, 214, 215, 216, 217, 218, 219, 220, 221, 222, 223, 224, 225, 226, 227, 228, 229, 230, 231, 232, 233, 234, 235, 237, 238, 239, 240, 241, 243, 244, 245, 246, 247, 248, 250, 251, 252, 253, 254, 255, 258, 260, 261, 262, 263, 264, 265, 267, 268, 269, 270, 271, 272, 273, 275, 276, 277, 278, 279, 281, 282, 283, 284, 285, 286, 287, 289, 290, 291, 292, 293, 294, 295, 296, 297, 298, 299, 302, 303, 305, 306, 307, 308, 309, 310, 311, 312, 313, 314, 315, 316, 317, 318, 319, 320, 322, 323, 324, 325, 326, 327, 328, 329, 330, 331, 332, 333, 334, 335, 336, 337, 338, 339, 341, 342, 343, 344, 345, 346, 347, 350, 351, 352, 353, 354, 355, 356, 357, 358, 359, 360, 361, 362, 363, 364, 365, 366, 367, 368, 369, 370, 371, 372, 373, 375, 376, 378, 379, 380, 381, 382, 383, 384, 385, 386, 387, 388, 389, 390, 391, 392, 393, 394, 395, 397, 398, 400, 401, 402, 403, 406, 408, 409, 410, 411, 412, 413, 414, 415, 417, 418, 419, 420, 421, 422, 424, 425, 426, 427, 428, 430, 431, 433, 434, 436, 437, 438, 439, 440, 441, 442, 443, 444, 445, 446, 447, 448, 449, 450, 451, 452, 454, 455, 456, 457, 458, 459, 460, 461, 462, 463, 464, 465, 469, 470, 471, 472, 473, 475, 476, 477, 478, 479, 480, 481, 482, 483, 484, 485, 486, 487, 488, 489, 490, 491, 492, 493, 494, 495, 496, 497, 498, 499, 500, 501, 502, 503, 504, 506, 509, 510, 511, 512, 513, 514, 515, 516, 517, 519, 520, 521, 522, 523, 524, 525, 526, 528, 529, 530, 531, 532, 533, 534, 535, 537, 538, 539, 540, 541, 542, 543, 544, 546, 547, 548, 549, 550, 551, 552, 553, 554, 555, 556, 557, 558, 559, 560, 561, 562, 563, 564, 565, 566, 567, 568, 569, 570, 571, 572, 573, 574, 575, 576, 577, 578, 579, 580, 581, 582, 585, 586, 588, 589, 590, 591, 592, 594, 595, 596, 597, 598, 599, 600, 601, 603, 604, 605, 606, 607, 608, 609, 610, 611, 612, 613, 615, 616, 617, 618, 619, 620, 621, 622, 624, 625, 626, 627, 629, 630, 631, 632, 633, 634, 635, 636, 637, 638, 639, 640, 641, 642, 643, 644, 645, 646, 647, 648, 649, 650, 651, 652, 654, 655, 656, 657, 659, 660, 661, 662, 663, 664, 666, 667, 668, 669, 670, 671, 672, 674, 675, 676, 677, 678, 679, 680, 681, 683, 685, 686, 687, 688, 689, 690, 691, 692, 693, 694, 695, 696, 697, 698, 699, 700, 701, 702, 703, 704, 705, 706, 707, 708, 709, 710, 711, 712, 713, 714, 716, 717, 718, 719, 721, 722, 723, 724, 726, 727, 728, 729, 730, 731, 732, 733, 735, 736, 737, 738, 739, 740, 742, 744, 745, 746, 747, 748, 749, 750, 751, 752, 753, 754, 755, 756, 757, 758, 759, 760, 761, 762, 763, 764, 765, 767, 768, 769, 770, 771, 773, 774, 775, 776, 777, 778, 779, 780, 781, 782, 783, 784, 785, 787, 788, 789, 791, 792, 793, 794, 795, 796, 797, 798, 799, 800, 801, 802, 803, 804, 805, 806, 807, 808, 809, 810, 811, 812, 813, 814, 815, 816, 817, 818, 819, 820, 821, 822, 823, 824, 826, 827, 828, 829, 830, 831, 832, 833, 834, 835, 836, 837, 838, 839, 840, 841, 842, 843, 845, 846, 847, 848, 849, 852, 854, 855, 856, 857, 858, 859, 860, 861, 862, 863, 864, 865, 866, 867, 868, 869, 873, 875, 876, 878, 879, 880, 881, 882, 884, 885, 887, 888, 889]
[1, 8, 13, 34, 44, 45, 60, 64, 71, 76, 81, 102, 106, 111, 114, 127, 132, 137, 144, 148, 151, 173, 176, 193, 194, 197, 209, 214, 224, 229, 235, 243, 246, 249, 261, 262, 272, 273, 278, 280, 288, 296, 309, 310, 319, 320, 328, 333, 337, 339, 356, 357, 362, 363, 364, 367, 368, 376, 377, 379, 403, 419, 421, 426, 427, 433, 454, 464, 470, 472, 481, 484, 487, 496, 516, 519, 521, 531, 534, 541, 547, 553, 573, 588, 590, 599, 605, 615, 616, 617, 628, 630, 639, 645, 647, 667, 681, 683, 691, 695, 730, 742, 748, 759, 761, 788, 794, 796, 805, 808, 816, 821, 825, 828, 835, 839, 842, 847, 858, 866, 877, 888]

