[21, 26, 53, 62, 101, 109, 196, 205, 267, 268, 273, 387, 523, 587, 589, 651, 700, 715, 756, 780, 788, 857]
[74, 138, 156, 184, 225, 241, 297, 370, 465, 496, 510, 545, 547, 558, 602, 635, 656, 691, 766, 809, 840, 862]

[21, 26, 53, 62, 101, 109, 196, 205, 267, 268, 273, 387, 523, 587, 589, 651, 700, 715, 756, 780, 788, 857]
[5, 34, 37, 72, 74, 77, 81, 94, 105, 129, 137, 138, 145, 148, 149, 152, 154, 155, 156, 162, 180, 184, 186, 195, 209, 213, 225, 229, 230, 237, 240, 241, 257, 258, 266, 274, 281, 297, 303, 309, 310, 315, 323, 325, 333, 341, 342, 356, 370, 378, 383, 394, 398, 401, 405, 408, 410, 439, 442, 459, 464, 465, 492, 496, 510, 512, 518, 521, 527, 545, 546, 547, 558, 559, 565, 566, 573, 590, 594, 596, 602, 608, 627, 630, 635, 636, 653, 656, 657, 659, 669, 691, 697, 721, 722, 727, 730, 733, 757, 761, 766, 785, 786, 791, 795, 799, 802, 807, 809, 811, 837, 840, 841, 845, 850, 862, 871, 872, 873, 882, 883, 888]

[5, 6, 9, 21, 26, 33, 42, 43, 53, 62, 96, 101, 109, 112, 125, 147, 166, 174, 182, 183, 187, 196, 205, 207, 225, 230, 245, 249, 251, 256, 257, 264, 267, 268, 273, 277, 286, 299, 311, 331, 365, 373, 376, 380, 386, 387, 415, 423, 436, 441, 454, 457, 459, 467, 486, 501, 523, 543, 546, 547, 559, 587, 588, 589, 591, 597, 619, 629, 646, 651, 684, 685, 687, 700, 715, 716, 722, 733, 735, 738, 745, 756, 767, 769, 772, 780, 787, 788, 794, 807, 847, 848, 849, 857, 864, 877, 889]
[5, 34, 37, 72, 74, 77, 81, 94, 105, 129, 137, 138, 145, 148, 149, 152, 154, 155, 156, 162, 180, 184, 186, 195, 209, 213, 225, 229, 230, 237, 240, 241, 257, 258, 266, 274, 281, 297, 303, 309, 310, 315, 323, 325, 333, 341, 342, 356, 370, 378, 383, 394, 398, 401, 405, 408, 410, 439, 442, 459, 464, 465, 492, 496, 510, 512, 518, 521, 527, 545, 546, 547, 558, 559, 565, 566, 573, 590, 594, 596, 602, 608, 627, 630, 635, 636, 653, 656, 657, 659, 669, 691, 697, 721, 722, 727, 730, 733, 757, 761, 766, 785, 786, 791, 795, 799, 802, 807, 809, 811, 837, 840, 841, 845, 850, 862, 871, 872, 873, 882, 883, 888]

[3, 4, 5, 6, 9, 11, 15, 21, 24, 26, 33, 42, 43, 44, 48, 49, 53, 56, 59, 62, 84, 96, 101, 109, 112, 125, 131, 132, 135, 144, 147, 151, 160, 166, 174, 175, 176, 178, 182, 183, 187, 188, 196, 197, 198, 205, 207, 225, 229, 230, 243, 245, 249, 251, 256, 257, 264, 267, 268, 269, 273, 277, 280, 285, 286, 287, 294, 299, 306, 311, 312, 331, 346, 349, 359, 365, 371, 373, 375, 376, 380, 386, 387, 405, 413, 415, 423, 426, 436, 441, 443, 454, 457, 459, 467, 473, 476, 486, 493, 501, 506, 523, 524, 529, 533, 543, 546, 547, 559, 565, 571, 587, 588, 589, 591, 597, 599, 601, 605, 619, 623, 629, 633, 637, 640, 642, 645, 646, 651, 684, 685, 687, 699, 700, 701, 715, 716, 722, 725, 733, 735, 738, 745, 748, 755, 756, 759, 767, 769, 772, 780, 787, 788, 794, 801, 803, 807, 814, 821, 827, 829, 847, 848, 849, 857, 864, 867, 871, 873, 876, 877, 889]
[5, 34, 37, 72, 74, 77, 81, 94, 105, 129, 137, 138, 145, 148, 149, 152, 154, 155, 156, 162, 180, 184, 186, 195, 209, 213, 225, 229, 230, 237, 240, 241, 257, 258, 266, 274, 281, 297, 303, 309, 310, 315, 323, 325, 333, 341, 342, 356, 370, 378, 383, 394, 398, 401, 405, 408, 410, 439, 442, 459, 464, 465, 492, 496, 510, 512, 518, 521, 527, 545, 546, 547, 558, 559, 565, 566, 573, 590, 594, 596, 602, 608, 627, 630, 635, 636, 653, 656, 657, 659, 669, 691, 697, 721, 722, 727, 730, 733, 757, 761, 766, 785, 786, 791, 795, 799, 802, 807, 809, 811, 837, 840, 841, 845, 850, 862, 871, 872, 873, 882, 883, 888]

[3, 4, 5, 6, 9, 11, 14, 15, 21, 24, 26, 33, 34, 35, 42, 43, 44, 48, 49, 53, 56, 59, 62, 64, 68, 81, 84, 96, 101, 109, 112, 125, 131, 132, 135, 142, 144, 145, 147, 151, 154, 160, 166, 167, 171, 174, 175, 176, 178, 181, 182, 183, 187, 188, 189, 193, 196, 197, 198, 205, 207, 225, 229, 230, 237, 243, 245, 249, 250, 251, 256, 257, 258, 260, 262, 264, 267, 268, 269, 273, 276, 277, 280, 285, 286, 287, 294, 299, 306, 308, 309, 311, 312, 319, 331, 346, 349, 353, 356, 357, 359, 361, 365, 367, 370, 371, 373, 375, 376, 380, 386, 387, 391, 401, 405, 413, 415, 417, 419, 423, 424, 426, 427, 429, 435, 436, 438, 439, 441, 442, 443, 445, 452, 454, 457, 459, 467, 471, 473, 476, 480, 484, 486, 489, 492, 493, 500, 501, 506, 515, 523, 524, 526, 529, 531, 533, 543, 546, 547, 559, 562, 565, 571, 583, 587, 588, 589, 591, 597, 599, 601, 605, 619, 620, 621, 623, 627, 629, 633, 636, 637, 640, 642, 643, 645, 646, 651, 673, 684, 685, 687, 690, 693, 699, 700, 701, 710, 711, 715, 716, 722, 725, 733, 735, 738, 745, 748, 755, 756, 759, 767, 768, 769, 772, 775, 779, 780, 781, 784, 787, 788, 794, 801, 802, 803, 807, 813, 814, 821, 827, 828, 829, 838, 847, 848, 849, 857, 858, 859, 864, 867, 871, 873, 876, 877, 887, 889]
[5, 34, 37, 72, 74, 77, 81, 94, 105, 129, 137, 138, 145, 148, 149, 152, 154, 155, 156, 162, 180, 184, 186, 195, 209, 213, 225, 229, 230, 237, 240, 241, 257, 258, 266, 274, 281, 297, 303, 309, 310, 315, 323, 325, 333, 341, 342, 356, 370, 378, 383, 394, 398, 401, 405, 408, 410, 439, 442, 459, 464, 465, 492, 496, 510, 512, 518, 521, 527, 545, 546, 547, 558, 559, 565, 566, 573, 590, 594, 596, 602, 608, 627, 630, 635, 636, 653, 656, 657, 659, 669, 691, 697, 721, 722, 727, 730, 733, 757, 761, 766, 785, 786, 791, 795, 799, 802, 807, 809, 811, 837, 840, 841, 845, 850, 862, 871, 872, 873, 882, 883, 888]

[3, 4, 5, 6, 7, 9, 11, 14, 15, 19, 21, 22, 24, 25, 26, 33, 34, 35, 42, 43, 44, 48, 49, 50, 53, 56, 59, 60, 62, 64, 68, 81, 84, 85, 96, 101, 109, 110, 112, 125, 127, 130, 131, 132, 135, 142, 144, 145, 147, 148, 151, 152, 154, 160, 163, 165, 166, 167, 171, 174, 175, 176, 178, 181, 182, 183, 187, 188, 189, 193, 196, 197, 198, 199, 204, 205, 207, 214, 223, 225, 229, 230, 236, 237, 243, 245, 249, 250, 251, 256, 257, 258, 260, 262, 264, 267, 268, 269, 273, 276, 277, 280, 285, 286, 287, 294, 298, 299, 306, 308, 309, 311, 312, 319, 320, 331, 338, 340, 345, 346, 349, 350, 353, 356, 357, 359, 361, 365, 367, 370, 371, 373, 375, 376, 380, 386, 387, 391, 397, 401, 405, 413, 415, 416, 417, 419, 423, 424, 426, 427, 428, 429, 430, 434, 435, 436, 438, 439, 441, 442, 443, 445, 452, 454, 456, 457, 459, 466, 467, 471, 473, 476, 478, 480, 484, 486, 487, 489, 492, 493, 500, 501, 504, 506, 507, 511, 515, 523, 524, 526, 529, 531, 533, 534, 543, 546, 547, 551, 557, 558, 559, 561, 562, 563, 565, 567, 570, 571, 577, 583, 587, 588, 589, 591, 597, 598, 599, 600, 601, 602, 605, 619, 620, 621, 623, 625, 627, 629, 632, 633, 634, 636, 637, 640, 642, 643, 645, 646, 648, 649, 651, 658, 661, 668, 671, 673, 684, 685, 687, 690, 693, 699, 700, 701, 710, 711, 715, 716, 717, 719, 722, 725, 733, 734, 735, 738, 745, 748, 755, 756, 759, 762, 767, 768, 769, 772, 775, 778, 779, 780, 781, 782, 784, 785, 787, 788, 794, 798, 800, 801, 802, 803, 807, 811, 812, 813, 814, 821, 827, 828, 829, 830, 834, 838, 847, 848, 849, 853, 857, 858, 859, 861, 863, 864, 867, 871, 873, 876, 877, 881, 887, 889]
[5, 34, 37, 72, 74, 77, 81, 94, 105, 129, 137, 138, 145, 148, 149, 152, 154, 155, 156, 162, 180, 184, 186, 195, 209, 213, 225, 229, 230, 237, 240, 241, 257, 258, 266, 274, 281, 297, 303, 309, 310, 315, 323, 325, 333, 341, 342, 356, 370, 378, 383, 394, 398, 401, 405, 408, 410, 439, 442, 459, 464, 465, 492, 496, 510, 512, 518, 521, 527, 545, 546, 547, 558, 559, 565, 566, 573, 590, 594, 596, 602, 608, 627, 630, 635, 636, 653, 656, 657, 659, 669, 691, 697, 721, 722, 727, 730, 733, 757, 761, 766, 785, 786, 791, 795, 799, 802, 807, 809, 811, 837, 840, 841, 845, 850, 862, 871, 872, 873, 882, 883, 888]

[0, 3, 4, 5, 6, 7, 9, 11, 14, 15, 19, 21, 22, 24, 25, 26, 30, 33, 34, 35, 38, 42, 43, 44, 48, 49, 50, 52, 53, 56, 59, 60, 62, 64, 65, 66, 68, 81, 83, 84, 85, 93, 96, 97, 99, 101, 108, 109, 110, 112, 118, 123, 125, 127, 130, 131, 132, 135, 139, 142, 144, 145, 147, 148, 151, 152, 154, 160, 163, 164, 165, 166, 167, 171, 172, 174, 175, 176, 178, 181, 182, 183, 187, 188, 189, 193, 195, 196, 197, 198, 199, 202, 204, 205, 207, 214, 219, 223, 225, 227, 229, 230, 231, 236, 237, 243, 245, 247, 249, 250, 251, 252, 256, 257, 258, 260, 262, 264, 266, 267, 268, 269, 273, 276, 277, 280, 285, 286, 287, 294, 298, 299, 302, 306, 308, 309, 311, 312, 319, 320, 331, 333, 337, 338, 339, 340, 345, 346, 347, 349, 350, 353, 355, 356, 357, 359, 361, 365, 367, 370, 371, 373, 375, 376, 380, 381, 385, 386, 387, 391, 395, 397, 399, 401, 405, 413, 415, 416, 417, 419, 422, 423, 424, 426, 427, 428, 429, 430, 434, 435, 436, 438, 439, 441, 442, 443, 445, 447, 452, 454, 456, 457, 459, 466, 467, 471, 473, 476, 477, 478, 480, 481, 484, 486, 487, 489, 492, 493, 500, 501, 504, 506, 507, 511, 515, 522, 523, 524, 526, 529, 531, 533, 534, 537, 540, 543, 546, 547, 548, 551, 552, 554, 557, 558, 559, 561, 562, 563, 565, 566, 567, 570, 571, 575, 577, 583, 587, 588, 589, 590, 591, 596, 597, 598, 599, 600, 601, 602, 605, 616, 619, 620, 621, 623, 625, 627, 629, 632, 633, 634, 636, 637, 640, 642, 643, 645, 646, 648, 649, 650, 651, 656, 658, 661, 667, 668, 671, 673, 674, 675, 677, 684, 685, 686, 687, 690, 693, 694, 699, 700, 701, 702, 710, 711, 715, 716, 717, 719, 721, 722, 725, 729, 733, 734, 735, 737, 738, 740, 745, 748, 752, 754, 755, 756, 757, 759, 760, 762, 767, 768, 769, 771, 772, 773, 775, 778, 779, 780, 781, 782, 784, 785, 787, 788, 794, 798, 800, 801, 802, 803, 807, 810, 811, 812, 813, 814, 821, 827, 828, 829, 830, 834, 838, 844, 846, 847, 848, 849, 853, 855, 857, 858, 859, 861, 863, 864, 867, 870, 871, 873, 876, 877, 879, 880, 881, 887, 889]
[5, 34, 37, 72, 74, 77, 81, 94, 105, 129, 137, 138, 145, 148, 149, 152, 154, 155, 156, 162, 180, 184, 186, 195, 209, 213, 225, 229, 230, 237, 240, 241, 257, 258, 266, 274, 281, 297, 303, 309, 310, 315, 323, 325, 333, 341, 342, 356, 370, 378, 383, 394, 398, 401, 405, 408, 410, 439, 442, 459, 464, 465, 492, 496, 510, 512, 518, 521, 527, 545, 546, 547, 558, 559, 565, 566, 573, 590, 594, 596, 602, 608, 627, 630, 635, 636, 653, 656, 657, 659, 669, 691, 697, 721, 722, 727, 730, 733, 757, 761, 766, 785, 786, 791, 795, 799, 802, 807, 809, 811, 837, 840, 841, 845, 850, 862, 871, 872, 873, 882, 883, 888]

[0, 3, 4, 5, 6, 7, 9, 11, 14, 15, 17, 19, 21, 22, 24, 25, 26, 27, 30, 31, 33, 34, 35, 38, 42, 43, 44, 48, 49, 50, 52, 53, 54, 56, 59, 60, 62, 64, 65, 66, 68, 80, 81, 83, 84, 85, 89, 93, 94, 96, 97, 99, 101, 108, 109, 110, 112, 115, 118, 123, 125, 127, 128, 130, 131, 132, 135, 139, 142, 144, 145, 147, 148, 151, 152, 154, 156, 160, 163, 164, 165, 166, 167, 169, 171, 172, 174, 175, 176, 178, 181, 182, 183, 184, 187, 188, 189, 191, 193, 195, 196, 197, 198, 199, 202, 203, 204, 205, 207, 208, 214, 219, 223, 225, 227, 228, 229, 230, 231, 236, 237, 240, 243, 245, 247, 248, 249, 250, 251, 252, 253, 255, 256, 257, 258, 260, 261, 262, 263, 264, 266, 267, 268, 269, 273, 274, 276, 277, 280, 285, 286, 287, 291, 293, 294, 298, 299, 300, 302, 306, 308, 309, 310, 311, 312, 313, 319, 320, 321, 330, 331, 333, 336, 337, 338, 339, 340, 341, 342, 345, 346, 347, 349, 350, 353, 355, 356, 357, 359, 361, 365, 366, 367, 370, 371, 373, 375, 376, 380, 381, 385, 386, 387, 388, 391, 395, 397, 399, 401, 403, 405, 413, 415, 416, 417, 419, 422, 423, 424, 426, 427, 428, 429, 430, 431, 432, 434, 435, 436, 438, 439, 440, 441, 442, 443, 445, 447, 451, 452, 454, 456, 457, 459, 466, 467, 468, 471, 473, 476, 477, 478, 480, 481, 484, 485, 486, 487, 488, 489, 492, 493, 498, 500, 501, 504, 505, 506, 507, 508, 509, 511, 515, 518, 520, 522, 523, 524, 526, 527, 528, 529, 531, 533, 534, 537, 540, 543, 546, 547, 548, 550, 551, 552, 554, 557, 558, 559, 561, 562, 563, 565, 566, 567, 570, 571, 575, 577, 578, 582, 583, 587, 588, 589, 590, 591, 596, 597, 598, 599, 600, 601, 602, 604, 605, 608, 616, 619, 620, 621, 622, 623, 625, 627, 629, 632, 633, 634, 636, 637, 640, 641, 642, 643, 645, 646, 648, 649, 650, 651, 655, 656, 658, 661, 664, 666, 667, 668, 669, 670, 671, 673, 674, 675, 677, 682, 684, 685, 686, 687, 689, 690, 693, 694, 698, 699, 700, 701, 702, 710, 711, 715, 716, 717, 719, 720, 721, 722, 725, 729, 730, 733, 734, 735, 737, 738, 740, 745, 748, 752, 754, 755, 756, 757, 759, 760, 762, 766, 767, 768, 769, 770, 771, 772, 773, 775, 778, 779, 780, 781, 782, 784, 785, 787, 788, 794, 798, 800, 801, 802, 803, 804, 807, 808, 810, 811, 812, 813, 814, 821, 827, 828, 829, 830, 834, 838, 843, 844, 846, 847, 848, 849, 851, 853, 855, 857, 858, 859, 861, 863, 864, 867, 868, 870, 871, 873, 876, 877, 879, 880, 881, 887, 889]
[5, 34, 37, 72, 74, 77, 81, 94, 105, 129, 137, 138, 145, 148, 149, 152, 154, 155, 156, 162, 180, 184, 186, 195, 209, 213, 225, 229, 230, 237, 240, 241, 257, 258, 266, 274, 281, 297, 303, 309, 310, 315, 323, 325, 333, 341, 342, 356, 370, 378, 383, 394, 398, 401, 405, 408, 410, 439, 442, 459, 464, 465, 492, 496, 510, 512, 518, 521, 527, 545, 546, 547, 558, 559, 565, 566, 573, 590, 594, 596, 602, 608, 627, 630, 635, 636, 653, 656, 657, 659, 669, 691, 697, 721, 722, 727, 730, 733, 757, 761, 766, 785, 786, 791, 795, 799, 802, 807, 809, 811, 837, 840, 841, 845, 850, 862, 871, 872, 873, 882, 883, 888]

[0, 3, 4, 5, 6, 7, 9, 10, 11, 12, 14, 15, 17, 19, 21, 22, 24, 25, 26, 27, 30, 31, 33, 34, 35, 37, 38, 42, 43, 44, 46, 48, 49, 50, 52, 53, 54, 56, 59, 60, 62, 64, 65, 66, 68, 73, 80, 81, 83, 84, 85, 89, 93, 94, 96, 97, 99, 101, 102, 105, 108, 109, 110, 112, 115, 118, 119, 121, 123, 125, 127, 128, 130, 131, 132, 133, 135, 139, 142, 144, 145, 147, 148, 151, 152, 154, 156, 158, 160, 163, 164, 165, 166, 167, 169, 171, 172, 174, 175, 176, 178, 181, 182, 183, 184, 187, 188, 189, 191, 193, 195, 196, 197, 198, 199, 202, 203, 204, 205, 206, 207, 208, 214, 215, 219, 223, 225, 226, 227, 228, 229, 230, 231, 236, 237, 240, 241, 243, 245, 247, 248, 249, 250, 251, 252, 253, 255, 256, 257, 258, 260, 261, 262, 263, 264, 265, 266, 267, 268, 269, 272, 273, 274, 276, 277, 280, 282, 285, 286, 287, 291, 292, 293, 294, 298, 299, 300, 301, 302, 303, 305, 306, 308, 309, 310, 311, 312, 313, 314, 319, 320, 321, 324, 330, 331, 333, 336, 337, 338, 339, 340, 341, 342, 343, 345, 346, 347, 349, 350, 353, 354, 355, 356, 357, 359, 361, 365, 366, 367, 368, 369, 370, 371, 373, 374, 375, 376, 380, 381, 382, 385, 386, 387, 388, 391, 392, 395, 397, 399, 400, 401, 403, 404, 405, 406, 410, 413, 415, 416, 417, 419, 422, 423, 424, 426, 427, 428, 429, 430, 431, 432, 434, 435, 436, 437, 438, 439, 440, 441, 442, 443, 445, 447, 448, 451, 452, 454, 456, 457, 458, 459, 462, 465, 466, 467, 468, 471, 473, 476, 477, 478, 480, 481, 484, 485, 486, 487, 488, 489, 490, 492, 493, 498, 499, 500, 501, 504, 505, 506, 507, 508, 509, 511, 515, 518, 520, 522, 523, 524, 526, 527, 528, 529, 531, 533, 534, 537, 540, 543, 546, 547, 548, 549, 550, 551, 552, 554, 555, 557, 558, 559, 560, 561, 562, 563, 565, 566, 567, 570, 571, 575, 576, 577, 578, 579, 580, 582, 583, 587, 588, 589, 590, 591, 596, 597, 598, 599, 600, 601, 602, 604, 605, 607, 608, 612, 616, 617, 619, 620, 621, 622, 623, 624, 625, 627, 629, 632, 633, 634, 636, 637, 639, 640, 641, 642, 643, 645, 646, 648, 649, 650, 651, 653, 655, 656, 657, 658, 661, 663, 664, 666, 667, 668, 669, 670, 671, 673, 674, 675, 677, 679, 682, 684, 685, 686, 687, 689, 690, 693, 694, 696, 698, 699, 700, 701, 702, 704, 710, 711, 712, 715, 716, 717, 719, 720, 721, 722, 725, 729, 730, 733, 734, 735, 737, 738, 740, 745, 748, 752, 754, 755, 756, 757, 759, 760, 762, 764, 766, 767, 768, 769, 770, 771, 772, 773, 775, 778, 779, 780, 781, 782, 783, 784, 785, 787, 788, 793, 794, 797, 798, 799, 800, 801, 802, 803, 804, 807, 808, 810, 811, 812, 813, 814, 821, 825, 827, 828, 829, 830, 833, 834, 835, 838, 839, 843, 844, 846, 847, 848, 849, 850, 851, 852, 853, 854, 855, 857, 858, 859, 861, 862, 863, 864, 865, 866, 867, 868, 870, 871, 873, 876, 877, 879, 880, 881, 887, 889]
[5, 34, 37, 72, 74, 77, 81, 94, 105, 129, 137, 138, 145, 148, 149, 152, 154, 155, 156, 162, 180, 184, 186, 195, 209, 213, 225, 229, 230, 237, 240, 241, 257, 258, 266, 274, 281, 297, 303, 309, 310, 315, 323, 325, 333, 341, 342, 356, 370, 378, 383, 394, 398, 401, 405, 408, 410, 439, 442, 459, 464, 465, 492, 496, 510, 512, 518, 521, 527, 545, 546, 547, 558, 559, 565, 566, 573, 590, 594, 596, 602, 608, 627, 630, 635, 636, 653, 656, 657, 659, 669, 691, 697, 721, 722, 727, 730, 733, 757, 761, 766, 785, 786, 791, 795, 799, 802, 807, 809, 811, 837, 840, 841, 845, 850, 862, 871, 872, 873, 882, 883, 888]

[0, 2, 3, 4, 5, 6, 7, 9, 10, 11, 12, 14, 15, 17, 19, 21, 22, 24, 25, 26, 27, 30, 31, 33, 34, 35, 36, 37, 38, 42, 43, 44, 46, 48, 49, 50, 52, 53, 54, 56, 57, 59, 60, 61, 62, 64, 65, 66, 68, 73, 80, 81, 83, 84, 85, 89, 90, 93, 94, 96, 97, 99, 100, 101, 102, 103, 105, 108, 109, 110, 112, 113, 115, 117, 118, 119, 121, 123, 125, 127, 128, 130, 131, 132, 133, 135, 139, 142, 144, 145, 147, 148, 150, 151, 152, 154, 156, 158, 159, 160, 163, 164, 165, 166, 167, 168, 169, 170, 171, 172, 174, 175, 176, 178, 181, 182, 183, 184, 185, 187, 188, 189, 191, 193, 195, 196, 197, 198, 199, 202, 203, 204, 205, 206, 207, 208, 209, 210, 214, 215, 216, 219, 221, 223, 225, 226, 227, 228, 229, 230, 231, 234, 236, 237, 238, 240, 241, 243, 245, 247, 248, 249, 250, 251, 252, 253, 255, 256, 257, 258, 259, 260, 261, 262, 263, 264, 265, 266, 267, 268, 269, 271, 272, 273, 274, 276, 277, 279, 280, 281, 282, 285, 286, 287, 289, 290, 291, 292, 293, 294, 298, 299, 300, 301, 302, 303, 305, 306, 308, 309, 310, 311, 312, 313, 314, 317, 319, 320, 321, 322, 324, 330, 331, 333, 335, 336, 337, 338, 339, 340, 341, 342, 343, 344, 345, 346, 347, 349, 350, 351, 352, 353, 354, 355, 356, 357, 359, 361, 365, 366, 367, 368, 369, 370, 371, 373, 374, 375, 376, 378, 380, 381, 382, 385, 386, 387, 388, 391, 392, 394, 395, 397, 399, 400, 401, 403, 404, 405, 406, 410, 411, 413, 415, 416, 417, 419, 422, 423, 424, 425, 426, 427, 428, 429, 430, 431, 432, 433, 434, 435, 436, 437, 438, 439, 440, 441, 442, 443, 445, 447, 448, 451, 452, 454, 456, 457, 458, 459, 462, 465, 466, 467, 468, 471, 473, 474, 475, 476, 477, 478, 480, 481, 483, 484, 485, 486, 487, 488, 489, 490, 492, 493, 498, 499, 500, 501, 504, 505, 506, 507, 508, 509, 511, 512, 515, 518, 519, 520, 522, 523, 524, 526, 527, 528, 529, 531, 533, 534, 537, 540, 543, 546, 547, 548, 549, 550, 551, 552, 554, 555, 557, 558, 559, 560, 561, 562, 563, 565, 566, 567, 570, 571, 572, 574, 575, 576, 577, 578, 579, 580, 582, 583, 585, 587, 588, 589, 590, 591, 592, 596, 597, 598, 599, 600, 601, 602, 604, 605, 607, 608, 609, 611, 612, 616, 617, 619, 620, 621, 622, 623, 624, 625, 627, 629, 630, 631, 632, 633, 634, 636, 637, 639, 640, 641, 642, 643, 645, 646, 647, 648, 649, 650, 651, 653, 654, 655, 656, 657, 658, 660, 661, 663, 664, 666, 667, 668, 669, 670, 671, 673, 674, 675, 677, 679, 680, 682, 684, 685, 686, 687, 689, 690, 693, 694, 696, 697, 698, 699, 700, 701, 702, 704, 705, 707, 710, 711, 712, 715, 716, 717, 719, 720, 721, 722, 723, 725, 726, 728, 729, 730, 733, 734, 735, 737, 738, 739, 740, 744, 745, 748, 750, 751, 752, 754, 755, 756, 757, 759, 760, 762, 764, 766, 767, 768, 769, 770, 771, 772, 773, 775, 778, 779, 780, 781, 782, 783, 784, 785, 787, 788, 791, 793, 794, 795, 797, 798, 799, 800, 801, 802, 803, 804, 807, 808, 809, 810, 811, 812, 813, 814, 821, 825, 826, 827, 828, 829, 830, 831, 833, 834, 835, 837, 838, 839, 840, 842, 843, 844, 845, 846, 847, 848, 849, 850, 851, 852, 853, 854, 855, 857, 858, 859, 861, 862, 863, 864, 865, 866, 867, 868, 870, 871, 873, 876, 877, 878, 879, 880, 881, 886, 887, 889]
[5, 34, 37, 72, 74, 77, 81, 94, 105, 129, 137, 138, 145, 148, 149, 152, 154, 155, 156, 162, 180, 184, 186, 195, 209, 213, 225, 229, 230, 237, 240, 241, 257, 258, 266, 274, 281, 297, 303, 309, 310, 315, 323, 325, 333, 341, 342, 356, 370, 378, 383, 394, 398, 401, 405, 408, 410, 439, 442, 459, 464, 465, 492, 496, 510, 512, 518, 521, 527, 545, 546, 547, 558, 559, 565, 566, 573, 590, 594, 596, 602, 608, 627, 630, 635, 636, 653, 656, 657, 659, 669, 691, 697, 721, 722, 727, 730, 733, 757, 761, 766, 785, 786, 791, 795, 799, 802, 807, 809, 811, 837, 840, 841, 845, 850, 862, 871, 872, 873, 882, 883, 888]

[0, 1, 2, 3, 4, 5, 6, 7, 8, 9, 10, 11, 12, 14, 15, 17, 19, 21, 22, 24, 25, 26, 27, 30, 31, 33, 34, 35, 36, 37, 38, 40, 42, 43, 44, 45, 46, 48, 49, 50, 52, 53, 54, 56, 57, 58, 59, 60, 61, 62, 64, 65, 66, 68, 73, 77, 80, 81, 83, 84, 85, 88, 89, 90, 93, 94, 96, 97, 98, 99, 100, 101, 102, 103, 104, 105, 106, 108, 109, 110, 112, 113, 115, 116, 117, 118, 119, 121, 123, 125, 127, 128, 130, 131, 132, 133, 135, 137, 139, 140, 142, 144, 145, 147, 148, 150, 151, 152, 153, 154, 155, 156, 158, 159, 160, 161, 163, 164, 165, 166, 167, 168, 169, 170, 171, 172, 174, 175, 176, 178, 179, 181, 182, 183, 184, 185, 187, 188, 189, 190, 191, 192, 193, 195, 196, 197, 198, 199, 201, 202, 203, 204, 205, 206, 207, 208, 209, 210, 212, 214, 215, 216, 217, 219, 221, 223, 225, 226, 227, 228, 229, 230, 231, 232, 234, 236, 237, 238, 240, 241, 243, 244, 245, 247, 248, 249, 250, 251, 252, 253, 255, 256, 257, 258, 259, 260, 261, 262, 263, 264, 265, 266, 267, 268, 269, 271, 272, 273, 274, 276, 277, 279, 280, 281, 282, 285, 286, 287, 289, 290, 291, 292, 293, 294, 295, 298, 299, 300, 301, 302, 303, 305, 306, 307, 308, 309, 310, 311, 312, 313, 314, 317, 318, 319, 320, 321, 322, 323, 324, 325, 326, 327, 330, 331, 333, 335, 336, 337, 338, 339, 340, 341, 342, 343, 344, 345, 346, 347, 349, 350, 351, 352, 353, 354, 355, 356, 357, 359, 361, 364, 365, 366, 367, 368, 369, 370, 371, 372, 373, 374, 375, 376, 377, 378, 380, 381, 382, 385, 386, 387, 388, 391, 392, 394, 395, 396, 397, 399, 400, 401, 403, 404, 405, 406, 407, 410, 411, 412, 413, 414, 415, 416, 417, 419, 420, 422, 423, 424, 425, 426, 427, 428, 429, 430, 431, 432, 433, 434, 435, 436, 437, 438, 439, 440, 441, 442, 443, 445, 447, 448, 449, 451, 452, 454, 455, 456, 457, 458, 459, 462, 463, 465, 466, 467, 468, 469, 471, 473, 474, 475, 476, 477, 478, 479, 480, 481, 483, 484, 485, 486, 487, 488, 489, 490, 492, 493, 498, 499, 500, 501, 504, 505, 506, 507, 508, 509, 511, 512, 513, 515, 517, 518, 519, 520, 521, 522, 523, 524, 526, 527, 528, 529, 530, 531, 533, 534, 535, 536, 537, 538, 540, 541, 542, 543, 544, 546, 547, 548, 549, 550, 551, 552, 554, 555, 557, 558, 559, 560, 561, 562, 563, 564, 565, 566, 567, 568, 570, 571, 572, 574, 575, 576, 577, 578, 579, 580, 581, 582, 583, 584, 585, 587, 588, 589, 590, 591, 592, 596, 597, 598, 599, 600, 601, 602, 603, 604, 605, 606, 607, 608, 609, 611, 612, 614, 616, 617, 619, 620, 621, 622, 623, 624, 625, 627, 629, 630, 631, 632, 633, 634, 635, 636, 637, 639, 640, 641, 642, 643, 644, 645, 646, 647, 648, 649, 650, 651, 652, 653, 654, 655, 656, 657, 658, 660, 661, 663, 664, 665, 666, 667, 668, 669, 670, 671, 673, 674, 675, 677, 678, 679, 680, 681, 682, 683, 684, 685, 686, 687, 689, 690, 693, 694, 696, 697, 698, 699, 700, 701, 702, 704, 705, 707, 710, 711, 712, 715, 716, 717, 719, 720, 721, 722, 723, 725, 726, 727, 728, 729, 730, 731, 732, 733, 734, 735, 736, 737, 738, 739, 740, 744, 745, 747, 748, 750, 751, 752, 754, 755, 756, 757, 759, 760, 762, 763, 764, 766, 767, 768, 769, 770, 771, 772, 773, 775, 776, 778, 779, 780, 781, 782, 783, 784, 785, 787, 788, 791, 792, 793, 794, 795, 796, 797, 798, 799, 800, 801, 802, 803, 804, 806, 807, 808, 809, 810, 811, 812, 813, 814, 815, 820, 821, 822, 825, 826, 827, 828, 829, 830, 831, 833, 834, 835, 837, 838, 839, 840, 841, 842, 843, 844, 845, 846, 847, 848, 849, 850, 851, 852, 853, 854, 855, 857, 858, 859, 860, 861, 862, 863, 864, 865, 866, 867, 868, 870, 871, 873, 875, 876, 877, 878, 879, 880, 881, 883, 886, 887, 889]
[5, 34, 37, 72, 74, 77, 81, 94, 105, 129, 137, 138, 145, 148, 149, 152, 154, 155, 156, 162, 180, 184, 186, 195, 209, 213, 225, 229, 230, 237, 240, 241, 257, 258, 266, 274, 281, 297, 303, 309, 310, 315, 323, 325, 333, 341, 342, 356, 370, 378, 383, 394, 398, 401, 405, 408, 410, 439, 442, 459, 464, 465, 492, 496, 510, 512, 518, 521, 527, 545, 546, 547, 558, 559, 565, 566, 573, 590, 594, 596, 602, 608, 627, 630, 635, 636, 653, 656, 657, 659, 669, 691, 697, 721, 722, 727, 730, 733, 757, 761, 766, 785, 786, 791, 795, 799, 802, 807, 809, 811, 837, 840, 841, 845, 850, 862, 871, 872, 873, 882, 883, 888]

[0, 1, 2, 3, 4, 5, 6, 7, 8, 9, 10, 11, 12, 14, 15, 16, 17, 19, 21, 22, 24, 25, 26, 27, 30, 31, 32, 33, 34, 35, 36, 37, 38, 39, 40, 41, 42, 43, 44, 45, 46, 48, 49, 50, 51, 52, 53, 54, 56, 57, 58, 59, 60, 61, 62, 64, 65, 66, 68, 69, 71, 72, 73, 76, 77, 80, 81, 82, 83, 84, 85, 88, 89, 90, 91, 92, 93, 94, 95, 96, 97, 98, 99, 100, 101, 102, 103, 104, 105, 106, 108, 109, 110, 112, 113, 114, 115, 116, 117, 118, 119, 121, 123, 124, 125, 127, 128, 130, 131, 132, 133, 135, 137, 138, 139, 140, 142, 144, 145, 147, 148, 150, 151, 152, 153, 154, 155, 156, 158, 159, 160, 161, 162, 163, 164, 165, 166, 167, 168, 169, 170, 171, 172, 174, 175, 176, 178, 179, 181, 182, 183, 184, 185, 187, 188, 189, 190, 191, 192, 193, 195, 196, 197, 198, 199, 200, 201, 202, 203, 204, 205, 206, 207, 208, 209, 210, 212, 214, 215, 216, 217, 219, 221, 222, 223, 225, 226, 227, 228, 229, 230, 231, 232, 234, 236, 237, 238, 239, 240, 241, 243, 244, 245, 246, 247, 248, 249, 250, 251, 252, 253, 255, 256, 257, 258, 259, 260, 261, 262, 263, 264, 265, 266, 267, 268, 269, 270, 271, 272, 273, 274, 275, 276, 277, 278, 279, 280, 281, 282, 283, 284, 285, 286, 287, 289, 290, 291, 292, 293, 294, 295, 297, 298, 299, 300, 301, 302, 303, 304, 305, 306, 307, 308, 309, 310, 311, 312, 313, 314, 315, 317, 318, 319, 320, 321, 322, 323, 324, 325, 326, 327, 328, 330, 331, 332, 333, 334, 335, 336, 337, 338, 339, 340, 341, 342, 343, 344, 345, 346, 347, 349, 350, 351, 352, 353, 354, 355, 356, 357, 359, 360, 361, 364, 365, 366, 367, 368, 369, 370, 371, 372, 373, 374, 375, 376, 377, 378, 380, 381, 382, 384, 385, 386, 387, 388, 389, 391, 392, 393, 394, 395, 396, 397, 398, 399, 400, 401, 402, 403, 404, 405, 406, 407, 408, 409, 410, 411, 412, 413, 414, 415, 416, 417, 419, 420, 421, 422, 423, 424, 425, 426, 427, 428, 429, 430, 431, 432, 433, 434, 435, 436, 437, 438, 439, 440, 441, 442, 443, 444, 445, 447, 448, 449, 451, 452, 454, 455, 456, 457, 458, 459, 460, 461, 462, 463, 464, 465, 466, 467, 468, 469, 471, 472, 473, 474, 475, 476, 477, 478, 479, 480, 481, 482, 483, 484, 485, 486, 487, 488, 489, 490, 491, 492, 493, 494, 496, 498, 499, 500, 501, 502, 503, 504, 505, 506, 507, 508, 509, 511, 512, 513, 515, 517, 518, 519, 520, 521, 522, 523, 524, 526, 527, 528, 529, 530, 531, 533, 534, 535, 536, 537, 538, 539, 540, 541, 542, 543, 544, 545, 546, 547, 548, 549, 550, 551, 552, 553, 554, 555, 556, 557, 558, 559, 560, 561, 562, 563, 564, 565, 566, 567, 568, 569, 570, 571, 572, 574, 575, 576, 577, 578, 579, 580, 581, 582, 583, 584, 585, 587, 588, 589, 590, 591, 592, 595, 596, 597, 598, 599, 600, 601, 602, 603, 604, 605, 606, 607, 608, 609, 611, 612, 614, 615, 616, 617, 618, 619, 620, 621, 622, 623, 624, 625, 626, 627, 628, 629, 630, 631, 632, 633, 634, 635, 636, 637, 639, 640, 641, 642, 643, 644, 645, 646, 647, 648, 649, 650, 651, 652, 653, 654, 655, 656, 657, 658, 660, 661, 662, 663, 664, 665, 666, 667, 668, 669, 670, 671, 672, 673, 674, 675, 677, 678, 679, 680, 681, 682, 683, 684, 685, 686, 687, 689, 690, 693, 694, 696, 697, 698, 699, 700, 701, 702, 704, 705, 707, 709, 710, 711, 712, 714, 715, 716, 717, 719, 720, 721, 722, 723, 724, 725, 726, 727, 728, 729, 730, 731, 732, 733, 734, 735, 736, 737, 738, 739, 740, 743, 744, 745, 747, 748, 749, 750, 751, 752, 754, 755, 756, 757, 759, 760, 762, 763, 764, 766, 767, 768, 769, 770, 771, 772, 773, 775, 776, 778, 779, 780, 781, 782, 783, 784, 785, 787, 788, 790, 791, 792, 793, 794, 795, 796, 797, 798, 799, 800, 801, 802, 803, 804, 806, 807, 808, 809, 810, 811, 812, 813, 814, 815, 816, 818, 819, 820, 821, 822, 823, 825, 826, 827, 828, 829, 830, 831, 832, 833, 834, 835, 836, 837, 838, 839, 840, 841, 842, 843, 844, 845, 846, 847, 848, 849, 850, 851, 852, 853, 854, 855, 857, 858, 859, 860, 861, 862, 863, 864, 865, 866, 867, 868, 870, 871, 872, 873, 875, 876, 877, 878, 879, 880, 881, 883, 886, 887, 888, 889]
[5, 34, 37, 72, 74, 77, 81, 94, 105, 129, 137, 138, 145, 148, 149, 152, 154, 155, 156, 162, 180, 184, 186, 195, 209, 213, 225, 229, 230, 237, 240, 241, 257, 258, 266, 274, 281, 297, 303, 309, 310, 315, 323, 325, 333, 341, 342, 356, 370, 378, 383, 394, 398, 401, 405, 408, 410, 439, 442, 459, 464, 465, 492, 496, 510, 512, 518, 521, 527, 545, 546, 547, 558, 559, 565, 566, 573, 590, 594, 596, 602, 608, 627, 630, 635, 636, 653, 656, 657, 659, 669, 691, 697, 721, 722, 727, 730, 733, 757, 761, 766, 785, 786, 791, 795, 799, 802, 807, 809, 811, 837, 840, 841, 845, 850, 862, 871, 872, 873, 882, 883, 888]

