[4, 8, 26, 28, 60, 89, 129, 301, 520, 538, 541, 561, 567, 585, 719, 752, 777, 785, 798, 816, 827, 888]
[49, 121, 140, 179, 234, 335, 379, 385, 446, 453, 499, 579, 590, 597, 630, 680, 736, 775, 780, 837, 853, 855]

[4, 8, 26, 28, 60, 89, 129, 301, 520, 538, 541, 561, 567, 585, 719, 752, 777, 785, 798, 816, 827, 888]
[9, 30, 35, 45, 49, 51, 74, 75, 76, 84, 86, 94, 110, 121, 140, 154, 159, 168, 169, 179, 201, 202, 234, 242, 247, 260, 271, 273, 274, 275, 321, 325, 335, 349, 350, 363, 378, 379, 380, 385, 390, 391, 393, 400, 401, 402, 404, 410, 414, 420, 430, 431, 433, 441, 446, 452, 453, 456, 459, 464, 468, 472, 476, 478, 484, 492, 499, 508, 512, 516, 528, 529, 545, 568, 576, 578, 579, 583, 590, 597, 607, 612, 623, 628, 630, 632, 635, 651, 674, 677, 680, 681, 691, 697, 698, 723, 736, 751, 755, 760, 766, 769, 771, 775, 780, 793, 796, 797, 801, 809, 820, 829, 837, 839, 850, 853, 855, 860, 870, 872, 877, 887]

[1, 4, 8, 19, 26, 28, 33, 43, 50, 60, 75, 89, 94, 98, 113, 119, 127, 129, 138, 145, 147, 151, 154, 160, 174, 197, 210, 214, 235, 252, 264, 271, 282, 284, 300, 301, 329, 348, 368, 386, 388, 390, 395, 396, 397, 408, 411, 428, 442, 465, 468, 495, 500, 502, 514, 520, 530, 538, 541, 542, 561, 562, 563, 567, 585, 587, 598, 603, 662, 677, 680, 689, 694, 695, 700, 719, 723, 733, 736, 741, 749, 752, 772, 777, 785, 797, 798, 799, 814, 816, 827, 828, 858, 859, 863, 877, 888]
[9, 30, 35, 45, 49, 51, 74, 75, 76, 84, 86, 94, 110, 121, 140, 154, 159, 168, 169, 179, 201, 202, 234, 242, 247, 260, 271, 273, 274, 275, 321, 325, 335, 349, 350, 363, 378, 379, 380, 385, 390, 391, 393, 400, 401, 402, 404, 410, 414, 420, 430, 431, 433, 441, 446, 452, 453, 456, 459, 464, 468, 472, 476, 478, 484, 492, 499, 508, 512, 516, 528, 529, 545, 568, 576, 578, 579, 583, 590, 597, 607, 612, 623, 628, 630, 632, 635, 651, 674, 677, 680, 681, 691, 697, 698, 723, 736, 751, 755, 760, 766, 769, 771, 775, 780, 793, 796, 797, 801, 809, 820, 829, 837, 839, 850, 853, 855, 860, 870, 872, 877, 887]

[1, 4, 8, 11, 19, 26, 28, 29, 33, 43, 49, 50, 58, 60, 72, 75, 82, 83, 89, 94, 98, 108, 113, 119, 123, 125, 127, 129, 138, 145, 147, 151, 154, 160, 161, 164, 169, 174, 197, 210, 214, 226, 235, 252, 254, 257, 264, 271, 282, 284, 291, 295, 298, 300, 301, 315, 319, 321, 329, 338, 342, 344, 348, 357, 359, 368, 369, 371, 378, 380, 386, 388, 390, 393, 395, 396, 397, 406, 407, 408, 409, 411, 428, 442, 448, 452, 464, 465, 467, 468, 495, 500, 502, 506, 508, 514, 519, 520, 522, 530, 535, 537, 538, 541, 542, 561, 562, 563, 567, 584, 585, 587, 598, 603, 609, 621, 628, 640, 646, 647, 660, 662, 664, 667, 677, 680, 684, 689, 694, 695, 697, 700, 701, 708, 709, 713, 714, 718, 719, 723, 733, 736, 740, 741, 749, 751, 752, 759, 760, 765, 772, 777, 785, 797, 798, 799, 814, 815, 816, 827, 828, 836, 842, 849, 851, 858, 859, 863, 877, 879, 886, 888]
[9, 30, 35, 45, 49, 51, 74, 75, 76, 84, 86, 94, 110, 121, 140, 154, 159, 168, 169, 179, 201, 202, 234, 242, 247, 260, 271, 273, 274, 275, 321, 325, 335, 349, 350, 363, 378, 379, 380, 385, 390, 391, 393, 400, 401, 402, 404, 410, 414, 420, 430, 431, 433, 441, 446, 452, 453, 456, 459, 464, 468, 472, 476, 478, 484, 492, 499, 508, 512, 516, 528, 529, 545, 568, 576, 578, 579, 583, 590, 597, 607, 612, 623, 628, 630, 632, 635, 651, 674, 677, 680, 681, 691, 697, 698, 723, 736, 751, 755, 760, 766, 769, 771, 775, 780, 793, 796, 797, 801, 809, 820, 829, 837, 839, 850, 853, 855, 860, 870, 872, 877, 887]

[0, 1, 4, 5, 8, 11, 19, 25, 26, 28, 29, 33, 39, 43, 47, 48, 49, 50, 58, 60, 67, 71, 72, 75, 82, 83, 85, 88, 89, 92, 94, 98, 108, 113, 119, 123, 125, 127, 129, 130, 138, 144, 145, 147, 148, 151, 154, 155, 159, 160, 161, 164, 167, 169, 174, 183, 185, 189, 193, 197, 203, 205, 210, 214, 226, 233, 234, 235, 238, 246, 250, 252, 254, 257, 264, 271, 272, 282, 284, 291, 295, 298, 300, 301, 315, 319, 321, 329, 336, 337, 338, 340, 342, 344, 346, 348, 351, 352, 357, 359, 368, 369, 370, 371, 377, 378, 380, 381, 386, 388, 389, 390, 393, 395, 396, 397, 398, 406, 407, 408, 409, 411, 428, 429, 431, 433, 442, 443, 446, 448, 452, 457, 463, 464, 465, 466, 467, 468, 472, 478, 480, 486, 495, 500, 502, 506, 508, 514, 519, 520, 522, 530, 533, 535, 537, 538, 541, 542, 544, 554, 561, 562, 563, 567, 569, 584, 585, 586, 587, 596, 598, 603, 608, 609, 614, 621, 628, 635, 637, 640, 646, 647, 660, 662, 664, 667, 677, 680, 684, 689, 694, 695, 697, 700, 701, 708, 709, 713, 714, 718, 719, 720, 723, 733, 736, 740, 741, 747, 749, 751, 752, 759, 760, 765, 772, 777, 778, 785, 791, 797, 798, 799, 811, 814, 815, 816, 817, 827, 828, 833, 836, 839, 842, 844, 846, 849, 851, 858, 859, 863, 866, 877, 879, 883, 884, 886, 888]
[9, 30, 35, 45, 49, 51, 74, 75, 76, 84, 86, 94, 110, 121, 140, 154, 159, 168, 169, 179, 201, 202, 234, 242, 247, 260, 271, 273, 274, 275, 321, 325, 335, 349, 350, 363, 378, 379, 380, 385, 390, 391, 393, 400, 401, 402, 404, 410, 414, 420, 430, 431, 433, 441, 446, 452, 453, 456, 459, 464, 468, 472, 476, 478, 484, 492, 499, 508, 512, 516, 528, 529, 545, 568, 576, 578, 579, 583, 590, 597, 607, 612, 623, 628, 630, 632, 635, 651, 674, 677, 680, 681, 691, 697, 698, 723, 736, 751, 755, 760, 766, 769, 771, 775, 780, 793, 796, 797, 801, 809, 820, 829, 837, 839, 850, 853, 855, 860, 870, 872, 877, 887]

[0, 1, 4, 5, 8, 11, 14, 16, 18, 19, 25, 26, 28, 29, 33, 38, 39, 43, 44, 46, 47, 48, 49, 50, 57, 58, 60, 64, 67, 71, 72, 75, 81, 82, 83, 85, 87, 88, 89, 92, 94, 98, 104, 108, 113, 119, 123, 125, 127, 129, 130, 131, 138, 144, 145, 147, 148, 149, 151, 154, 155, 159, 160, 161, 163, 164, 166, 167, 169, 174, 178, 183, 185, 188, 189, 193, 196, 197, 203, 205, 210, 214, 218, 226, 233, 234, 235, 238, 246, 250, 251, 252, 254, 257, 264, 271, 272, 276, 282, 283, 284, 289, 290, 291, 294, 295, 296, 298, 300, 301, 305, 313, 315, 319, 321, 329, 330, 336, 337, 338, 340, 342, 344, 346, 348, 350, 351, 352, 353, 355, 357, 359, 368, 369, 370, 371, 377, 378, 380, 381, 386, 388, 389, 390, 393, 395, 396, 397, 398, 406, 407, 408, 409, 411, 417, 422, 426, 428, 429, 430, 431, 433, 439, 442, 443, 446, 448, 452, 457, 461, 463, 464, 465, 466, 467, 468, 472, 478, 480, 481, 482, 483, 486, 488, 495, 500, 502, 506, 508, 514, 517, 519, 520, 522, 524, 530, 533, 535, 537, 538, 539, 541, 542, 544, 545, 551, 552, 554, 561, 562, 563, 567, 569, 581, 584, 585, 586, 587, 595, 596, 598, 599, 603, 604, 606, 608, 609, 611, 614, 617, 621, 628, 635, 637, 639, 640, 646, 647, 648, 660, 662, 663, 664, 665, 667, 677, 678, 680, 683, 684, 688, 689, 694, 695, 697, 700, 701, 708, 709, 713, 714, 718, 719, 720, 723, 727, 728, 731, 733, 736, 739, 740, 741, 747, 748, 749, 751, 752, 753, 757, 759, 760, 765, 772, 777, 778, 785, 789, 791, 797, 798, 799, 800, 811, 814, 815, 816, 817, 818, 819, 821, 827, 828, 833, 836, 839, 842, 844, 846, 849, 851, 858, 859, 863, 866, 877, 879, 881, 883, 884, 886, 888]
[9, 30, 35, 45, 49, 51, 74, 75, 76, 84, 86, 94, 110, 121, 140, 154, 159, 168, 169, 179, 201, 202, 234, 242, 247, 260, 271, 273, 274, 275, 321, 325, 335, 349, 350, 363, 378, 379, 380, 385, 390, 391, 393, 400, 401, 402, 404, 410, 414, 420, 430, 431, 433, 441, 446, 452, 453, 456, 459, 464, 468, 472, 476, 478, 484, 492, 499, 508, 512, 516, 528, 529, 545, 568, 576, 578, 579, 583, 590, 597, 607, 612, 623, 628, 630, 632, 635, 651, 674, 677, 680, 681, 691, 697, 698, 723, 736, 751, 755, 760, 766, 769, 771, 775, 780, 793, 796, 797, 801, 809, 820, 829, 837, 839, 850, 853, 855, 860, 870, 872, 877, 887]

[0, 1, 4, 5, 6, 8, 11, 14, 15, 16, 18, 19, 25, 26, 28, 29, 33, 36, 38, 39, 43, 44, 46, 47, 48, 49, 50, 54, 56, 57, 58, 60, 64, 67, 68, 71, 72, 75, 76, 81, 82, 83, 85, 87, 88, 89, 90, 92, 94, 95, 98, 104, 108, 113, 117, 119, 121, 122, 123, 125, 127, 129, 130, 131, 132, 136, 138, 144, 145, 146, 147, 148, 149, 151, 154, 155, 159, 160, 161, 163, 164, 166, 167, 169, 174, 178, 180, 181, 183, 185, 188, 189, 190, 192, 193, 196, 197, 199, 203, 204, 205, 210, 214, 218, 226, 231, 233, 234, 235, 237, 238, 246, 250, 251, 252, 254, 257, 258, 264, 271, 272, 276, 282, 283, 284, 289, 290, 291, 292, 294, 295, 296, 298, 300, 301, 305, 311, 313, 315, 319, 321, 329, 330, 336, 337, 338, 340, 342, 344, 346, 348, 350, 351, 352, 353, 354, 355, 357, 359, 362, 366, 367, 368, 369, 370, 371, 377, 378, 380, 381, 382, 386, 388, 389, 390, 391, 393, 395, 396, 397, 398, 406, 407, 408, 409, 411, 416, 417, 422, 426, 428, 429, 430, 431, 433, 439, 441, 442, 443, 446, 448, 452, 455, 457, 460, 461, 462, 463, 464, 465, 466, 467, 468, 472, 477, 478, 480, 481, 482, 483, 485, 486, 488, 495, 498, 500, 502, 506, 508, 513, 514, 517, 519, 520, 522, 524, 526, 528, 530, 533, 535, 537, 538, 539, 541, 542, 544, 545, 549, 551, 552, 554, 561, 562, 563, 567, 569, 574, 575, 580, 581, 584, 585, 586, 587, 591, 595, 596, 597, 598, 599, 600, 603, 604, 606, 608, 609, 611, 613, 614, 617, 619, 621, 628, 635, 637, 639, 640, 641, 642, 643, 646, 647, 648, 654, 660, 662, 663, 664, 665, 667, 677, 678, 679, 680, 683, 684, 688, 689, 694, 695, 696, 697, 700, 701, 704, 706, 708, 709, 712, 713, 714, 716, 717, 718, 719, 720, 723, 727, 728, 731, 733, 736, 739, 740, 741, 742, 745, 747, 748, 749, 750, 751, 752, 753, 757, 759, 760, 765, 768, 772, 773, 775, 777, 778, 785, 789, 790, 791, 797, 798, 799, 800, 808, 810, 811, 814, 815, 816, 817, 818, 819, 821, 827, 828, 833, 836, 839, 842, 843, 844, 846, 849, 851, 858, 859, 863, 866, 870, 871, 877, 879, 881, 883, 884, 886, 888]
[9, 30, 35, 45, 49, 51, 74, 75, 76, 84, 86, 94, 110, 121, 140, 154, 159, 168, 169, 179, 201, 202, 234, 242, 247, 260, 271, 273, 274, 275, 321, 325, 335, 349, 350, 363, 378, 379, 380, 385, 390, 391, 393, 400, 401, 402, 404, 410, 414, 420, 430, 431, 433, 441, 446, 452, 453, 456, 459, 464, 468, 472, 476, 478, 484, 492, 499, 508, 512, 516, 528, 529, 545, 568, 576, 578, 579, 583, 590, 597, 607, 612, 623, 628, 630, 632, 635, 651, 674, 677, 680, 681, 691, 697, 698, 723, 736, 751, 755, 760, 766, 769, 771, 775, 780, 793, 796, 797, 801, 809, 820, 829, 837, 839, 850, 853, 855, 860, 870, 872, 877, 887]

[0, 1, 4, 5, 6, 8, 11, 14, 15, 16, 18, 19, 24, 25, 26, 28, 29, 33, 35, 36, 38, 39, 43, 44, 46, 47, 48, 49, 50, 54, 56, 57, 58, 60, 62, 63, 64, 67, 68, 71, 72, 75, 76, 78, 80, 81, 82, 83, 85, 87, 88, 89, 90, 92, 94, 95, 98, 101, 104, 108, 113, 114, 116, 117, 119, 121, 122, 123, 125, 127, 129, 130, 131, 132, 136, 137, 138, 144, 145, 146, 147, 148, 149, 151, 152, 154, 155, 159, 160, 161, 163, 164, 166, 167, 169, 174, 178, 180, 181, 183, 185, 188, 189, 190, 192, 193, 196, 197, 199, 203, 204, 205, 210, 212, 214, 218, 226, 229, 231, 233, 234, 235, 236, 237, 238, 245, 246, 250, 251, 252, 254, 257, 258, 264, 271, 272, 276, 277, 282, 283, 284, 286, 287, 289, 290, 291, 292, 294, 295, 296, 297, 298, 299, 300, 301, 305, 307, 310, 311, 313, 315, 318, 319, 321, 327, 328, 329, 330, 333, 334, 336, 337, 338, 340, 342, 344, 346, 348, 350, 351, 352, 353, 354, 355, 357, 359, 362, 366, 367, 368, 369, 370, 371, 377, 378, 379, 380, 381, 382, 386, 388, 389, 390, 391, 392, 393, 394, 395, 396, 397, 398, 406, 407, 408, 409, 411, 415, 416, 417, 422, 426, 428, 429, 430, 431, 433, 437, 438, 439, 440, 441, 442, 443, 446, 448, 452, 455, 457, 460, 461, 462, 463, 464, 465, 466, 467, 468, 472, 474, 476, 477, 478, 480, 481, 482, 483, 485, 486, 488, 490, 495, 498, 499, 500, 502, 506, 508, 510, 513, 514, 517, 519, 520, 522, 524, 526, 528, 530, 531, 533, 535, 536, 537, 538, 539, 540, 541, 542, 544, 545, 549, 551, 552, 554, 558, 560, 561, 562, 563, 567, 569, 573, 574, 575, 580, 581, 584, 585, 586, 587, 591, 592, 595, 596, 597, 598, 599, 600, 603, 604, 606, 607, 608, 609, 610, 611, 613, 614, 617, 619, 621, 628, 631, 633, 634, 635, 637, 639, 640, 641, 642, 643, 646, 647, 648, 650, 651, 654, 655, 656, 660, 662, 663, 664, 665, 667, 668, 672, 673, 677, 678, 679, 680, 681, 683, 684, 688, 689, 690, 694, 695, 696, 697, 700, 701, 704, 706, 707, 708, 709, 712, 713, 714, 716, 717, 718, 719, 720, 722, 723, 724, 727, 728, 731, 733, 736, 739, 740, 741, 742, 745, 747, 748, 749, 750, 751, 752, 753, 757, 759, 760, 763, 765, 768, 772, 773, 774, 775, 777, 778, 780, 784, 785, 789, 790, 791, 796, 797, 798, 799, 800, 805, 808, 810, 811, 814, 815, 816, 817, 818, 819, 821, 827, 828, 833, 836, 839, 842, 843, 844, 846, 849, 851, 852, 854, 858, 859, 860, 863, 866, 869, 870, 871, 876, 877, 879, 880, 881, 883, 884, 886, 888]
[9, 30, 35, 45, 49, 51, 74, 75, 76, 84, 86, 94, 110, 121, 140, 154, 159, 168, 169, 179, 201, 202, 234, 242, 247, 260, 271, 273, 274, 275, 321, 325, 335, 349, 350, 363, 378, 379, 380, 385, 390, 391, 393, 400, 401, 402, 404, 410, 414, 420, 430, 431, 433, 441, 446, 452, 453, 456, 459, 464, 468, 472, 476, 478, 484, 492, 499, 508, 512, 516, 528, 529, 545, 568, 576, 578, 579, 583, 590, 597, 607, 612, 623, 628, 630, 632, 635, 651, 674, 677, 680, 681, 691, 697, 698, 723, 736, 751, 755, 760, 766, 769, 771, 775, 780, 793, 796, 797, 801, 809, 820, 829, 837, 839, 850, 853, 855, 860, 870, 872, 877, 887]

[0, 1, 4, 5, 6, 8, 11, 12, 13, 14, 15, 16, 18, 19, 22, 24, 25, 26, 28, 29, 33, 35, 36, 38, 39, 41, 43, 44, 46, 47, 48, 49, 50, 52, 54, 56, 57, 58, 60, 62, 63, 64, 67, 68, 71, 72, 75, 76, 78, 80, 81, 82, 83, 85, 87, 88, 89, 90, 91, 92, 94, 95, 98, 99, 101, 104, 105, 108, 111, 113, 114, 115, 116, 117, 118, 119, 121, 122, 123, 125, 127, 129, 130, 131, 132, 136, 137, 138, 144, 145, 146, 147, 148, 149, 150, 151, 152, 154, 155, 159, 160, 161, 163, 164, 166, 167, 169, 171, 174, 175, 178, 179, 180, 181, 182, 183, 185, 188, 189, 190, 192, 193, 196, 197, 199, 203, 204, 205, 210, 212, 214, 217, 218, 219, 226, 227, 229, 231, 233, 234, 235, 236, 237, 238, 239, 240, 245, 246, 249, 250, 251, 252, 254, 257, 258, 259, 261, 264, 271, 272, 276, 277, 278, 280, 282, 283, 284, 286, 287, 289, 290, 291, 292, 294, 295, 296, 297, 298, 299, 300, 301, 303, 305, 306, 307, 310, 311, 313, 315, 318, 319, 321, 324, 327, 328, 329, 330, 333, 334, 335, 336, 337, 338, 340, 342, 344, 346, 348, 350, 351, 352, 353, 354, 355, 357, 359, 361, 362, 365, 366, 367, 368, 369, 370, 371, 377, 378, 379, 380, 381, 382, 384, 386, 387, 388, 389, 390, 391, 392, 393, 394, 395, 396, 397, 398, 400, 406, 407, 408, 409, 411, 412, 415, 416, 417, 420, 422, 426, 428, 429, 430, 431, 433, 434, 437, 438, 439, 440, 441, 442, 443, 446, 448, 452, 455, 457, 458, 460, 461, 462, 463, 464, 465, 466, 467, 468, 472, 473, 474, 476, 477, 478, 480, 481, 482, 483, 485, 486, 488, 490, 494, 495, 498, 499, 500, 501, 502, 506, 508, 510, 513, 514, 515, 517, 519, 520, 522, 523, 524, 526, 528, 530, 531, 533, 534, 535, 536, 537, 538, 539, 540, 541, 542, 544, 545, 549, 550, 551, 552, 554, 558, 560, 561, 562, 563, 567, 569, 571, 573, 574, 575, 580, 581, 582, 584, 585, 586, 587, 589, 590, 591, 592, 595, 596, 597, 598, 599, 600, 602, 603, 604, 605, 606, 607, 608, 609, 610, 611, 613, 614, 617, 619, 620, 621, 625, 628, 629, 631, 633, 634, 635, 637, 638, 639, 640, 641, 642, 643, 646, 647, 648, 650, 651, 654, 655, 656, 657, 660, 662, 663, 664, 665, 667, 668, 671, 672, 673, 675, 677, 678, 679, 680, 681, 683, 684, 688, 689, 690, 691, 693, 694, 695, 696, 697, 699, 700, 701, 704, 705, 706, 707, 708, 709, 712, 713, 714, 715, 716, 717, 718, 719, 720, 721, 722, 723, 724, 727, 728, 731, 733, 736, 739, 740, 741, 742, 745, 747, 748, 749, 750, 751, 752, 753, 757, 759, 760, 763, 765, 768, 772, 773, 774, 775, 777, 778, 780, 784, 785, 787, 789, 790, 791, 793, 794, 796, 797, 798, 799, 800, 803, 805, 806, 808, 810, 811, 814, 815, 816, 817, 818, 819, 821, 827, 828, 829, 833, 836, 839, 842, 843, 844, 846, 847, 849, 850, 851, 852, 854, 858, 859, 860, 863, 866, 869, 870, 871, 874, 875, 876, 877, 879, 880, 881, 883, 884, 886, 888]
[9, 30, 35, 45, 49, 51, 74, 75, 76, 84, 86, 94, 110, 121, 140, 154, 159, 168, 169, 179, 201, 202, 234, 242, 247, 260, 271, 273, 274, 275, 321, 325, 335, 349, 350, 363, 378, 379, 380, 385, 390, 391, 393, 400, 401, 402, 404, 410, 414, 420, 430, 431, 433, 441, 446, 452, 453, 456, 459, 464, 468, 472, 476, 478, 484, 492, 499, 508, 512, 516, 528, 529, 545, 568, 576, 578, 579, 583, 590, 597, 607, 612, 623, 628, 630, 632, 635, 651, 674, 677, 680, 681, 691, 697, 698, 723, 736, 751, 755, 760, 766, 769, 771, 775, 780, 793, 796, 797, 801, 809, 820, 829, 837, 839, 850, 853, 855, 860, 870, 872, 877, 887]

[0, 1, 4, 5, 6, 8, 10, 11, 12, 13, 14, 15, 16, 18, 19, 22, 23, 24, 25, 26, 27, 28, 29, 30, 33, 34, 35, 36, 37, 38, 39, 41, 42, 43, 44, 46, 47, 48, 49, 50, 52, 54, 55, 56, 57, 58, 60, 62, 63, 64, 67, 68, 71, 72, 73, 75, 76, 78, 80, 81, 82, 83, 85, 86, 87, 88, 89, 90, 91, 92, 94, 95, 98, 99, 101, 104, 105, 107, 108, 111, 113, 114, 115, 116, 117, 118, 119, 121, 122, 123, 125, 127, 129, 130, 131, 132, 136, 137, 138, 139, 143, 144, 145, 146, 147, 148, 149, 150, 151, 152, 154, 155, 156, 158, 159, 160, 161, 163, 164, 166, 167, 168, 169, 171, 174, 175, 178, 179, 180, 181, 182, 183, 184, 185, 188, 189, 190, 192, 193, 195, 196, 197, 199, 201, 203, 204, 205, 210, 212, 214, 215, 217, 218, 219, 221, 222, 226, 227, 229, 231, 232, 233, 234, 235, 236, 237, 238, 239, 240, 241, 245, 246, 249, 250, 251, 252, 254, 257, 258, 259, 261, 264, 266, 269, 271, 272, 273, 276, 277, 278, 280, 282, 283, 284, 286, 287, 289, 290, 291, 292, 294, 295, 296, 297, 298, 299, 300, 301, 303, 305, 306, 307, 308, 310, 311, 312, 313, 315, 316, 317, 318, 319, 321, 322, 324, 327, 328, 329, 330, 332, 333, 334, 335, 336, 337, 338, 340, 342, 344, 345, 346, 348, 350, 351, 352, 353, 354, 355, 357, 359, 361, 362, 365, 366, 367, 368, 369, 370, 371, 377, 378, 379, 380, 381, 382, 384, 386, 387, 388, 389, 390, 391, 392, 393, 394, 395, 396, 397, 398, 399, 400, 404, 406, 407, 408, 409, 411, 412, 415, 416, 417, 420, 421, 422, 426, 427, 428, 429, 430, 431, 433, 434, 435, 437, 438, 439, 440, 441, 442, 443, 446, 448, 450, 452, 455, 456, 457, 458, 460, 461, 462, 463, 464, 465, 466, 467, 468, 470, 471, 472, 473, 474, 475, 476, 477, 478, 480, 481, 482, 483, 485, 486, 487, 488, 490, 492, 494, 495, 498, 499, 500, 501, 502, 505, 506, 508, 510, 513, 514, 515, 516, 517, 519, 520, 521, 522, 523, 524, 525, 526, 528, 530, 531, 533, 534, 535, 536, 537, 538, 539, 540, 541, 542, 543, 544, 545, 549, 550, 551, 552, 553, 554, 558, 560, 561, 562, 563, 565, 567, 569, 571, 573, 574, 575, 576, 580, 581, 582, 584, 585, 586, 587, 589, 590, 591, 592, 595, 596, 597, 598, 599, 600, 602, 603, 604, 605, 606, 607, 608, 609, 610, 611, 613, 614, 617, 619, 620, 621, 622, 625, 627, 628, 629, 630, 631, 633, 634, 635, 636, 637, 638, 639, 640, 641, 642, 643, 646, 647, 648, 649, 650, 651, 654, 655, 656, 657, 660, 662, 663, 664, 665, 666, 667, 668, 671, 672, 673, 675, 677, 678, 679, 680, 681, 683, 684, 685, 688, 689, 690, 691, 693, 694, 695, 696, 697, 699, 700, 701, 704, 705, 706, 707, 708, 709, 710, 712, 713, 714, 715, 716, 717, 718, 719, 720, 721, 722, 723, 724, 725, 727, 728, 731, 732, 733, 736, 738, 739, 740, 741, 742, 744, 745, 747, 748, 749, 750, 751, 752, 753, 756, 757, 759, 760, 763, 765, 768, 770, 772, 773, 774, 775, 776, 777, 778, 780, 782, 784, 785, 787, 789, 790, 791, 793, 794, 796, 797, 798, 799, 800, 802, 803, 804, 805, 806, 808, 810, 811, 812, 813, 814, 815, 816, 817, 818, 819, 820, 821, 823, 827, 828, 829, 830, 833, 836, 839, 842, 843, 844, 846, 847, 849, 850, 851, 852, 854, 858, 859, 860, 863, 866, 869, 870, 871, 872, 873, 874, 875, 876, 877, 879, 880, 881, 883, 884, 886, 888]
[9, 30, 35, 45, 49, 51, 74, 75, 76, 84, 86, 94, 110, 121, 140, 154, 159, 168, 169, 179, 201, 202, 234, 242, 247, 260, 271, 273, 274, 275, 321, 325, 335, 349, 350, 363, 378, 379, 380, 385, 390, 391, 393, 400, 401, 402, 404, 410, 414, 420, 430, 431, 433, 441, 446, 452, 453, 456, 459, 464, 468, 472, 476, 478, 484, 492, 499, 508, 512, 516, 528, 529, 545, 568, 576, 578, 579, 583, 590, 597, 607, 612, 623, 628, 630, 632, 635, 651, 674, 677, 680, 681, 691, 697, 698, 723, 736, 751, 755, 760, 766, 769, 771, 775, 780, 793, 796, 797, 801, 809, 820, 829, 837, 839, 850, 853, 855, 860, 870, 872, 877, 887]

[0, 1, 3, 4, 5, 6, 7, 8, 10, 11, 12, 13, 14, 15, 16, 17, 18, 19, 20, 21, 22, 23, 24, 25, 26, 27, 28, 29, 30, 31, 33, 34, 35, 36, 37, 38, 39, 41, 42, 43, 44, 46, 47, 48, 49, 50, 52, 54, 55, 56, 57, 58, 60, 62, 63, 64, 66, 67, 68, 69, 71, 72, 73, 75, 76, 78, 80, 81, 82, 83, 85, 86, 87, 88, 89, 90, 91, 92, 93, 94, 95, 97, 98, 99, 101, 102, 104, 105, 107, 108, 109, 111, 113, 114, 115, 116, 117, 118, 119, 121, 122, 123, 124, 125, 127, 129, 130, 131, 132, 136, 137, 138, 139, 143, 144, 145, 146, 147, 148, 149, 150, 151, 152, 154, 155, 156, 158, 159, 160, 161, 162, 163, 164, 166, 167, 168, 169, 171, 173, 174, 175, 178, 179, 180, 181, 182, 183, 184, 185, 187, 188, 189, 190, 192, 193, 194, 195, 196, 197, 199, 201, 203, 204, 205, 206, 210, 211, 212, 214, 215, 217, 218, 219, 220, 221, 222, 226, 227, 228, 229, 231, 232, 233, 234, 235, 236, 237, 238, 239, 240, 241, 242, 245, 246, 247, 249, 250, 251, 252, 253, 254, 256, 257, 258, 259, 261, 263, 264, 265, 266, 267, 269, 271, 272, 273, 275, 276, 277, 278, 280, 282, 283, 284, 285, 286, 287, 289, 290, 291, 292, 293, 294, 295, 296, 297, 298, 299, 300, 301, 303, 304, 305, 306, 307, 308, 309, 310, 311, 312, 313, 315, 316, 317, 318, 319, 321, 322, 324, 327, 328, 329, 330, 332, 333, 334, 335, 336, 337, 338, 340, 342, 344, 345, 346, 347, 348, 350, 351, 352, 353, 354, 355, 357, 358, 359, 361, 362, 365, 366, 367, 368, 369, 370, 371, 372, 375, 376, 377, 378, 379, 380, 381, 382, 383, 384, 385, 386, 387, 388, 389, 390, 391, 392, 393, 394, 395, 396, 397, 398, 399, 400, 404, 406, 407, 408, 409, 411, 412, 415, 416, 417, 420, 421, 422, 425, 426, 427, 428, 429, 430, 431, 433, 434, 435, 437, 438, 439, 440, 441, 442, 443, 446, 447, 448, 450, 452, 454, 455, 456, 457, 458, 460, 461, 462, 463, 464, 465, 466, 467, 468, 470, 471, 472, 473, 474, 475, 476, 477, 478, 480, 481, 482, 483, 485, 486, 487, 488, 490, 492, 493, 494, 495, 496, 498, 499, 500, 501, 502, 503, 505, 506, 508, 509, 510, 511, 513, 514, 515, 516, 517, 519, 520, 521, 522, 523, 524, 525, 526, 528, 529, 530, 531, 533, 534, 535, 536, 537, 538, 539, 540, 541, 542, 543, 544, 545, 547, 549, 550, 551, 552, 553, 554, 555, 556, 558, 560, 561, 562, 563, 565, 567, 569, 571, 572, 573, 574, 575, 576, 578, 579, 580, 581, 582, 583, 584, 585, 586, 587, 589, 590, 591, 592, 595, 596, 597, 598, 599, 600, 602, 603, 604, 605, 606, 607, 608, 609, 610, 611, 613, 614, 617, 619, 620, 621, 622, 625, 626, 627, 628, 629, 630, 631, 633, 634, 635, 636, 637, 638, 639, 640, 641, 642, 643, 644, 645, 646, 647, 648, 649, 650, 651, 653, 654, 655, 656, 657, 658, 659, 660, 662, 663, 664, 665, 666, 667, 668, 671, 672, 673, 675, 677, 678, 679, 680, 681, 682, 683, 684, 685, 688, 689, 690, 691, 693, 694, 695, 696, 697, 698, 699, 700, 701, 704, 705, 706, 707, 708, 709, 710, 712, 713, 714, 715, 716, 717, 718, 719, 720, 721, 722, 723, 724, 725, 727, 728, 729, 731, 732, 733, 734, 736, 737, 738, 739, 740, 741, 742, 744, 745, 746, 747, 748, 749, 750, 751, 752, 753, 756, 757, 759, 760, 763, 765, 768, 770, 772, 773, 774, 775, 776, 777, 778, 779, 780, 782, 784, 785, 787, 789, 790, 791, 793, 794, 795, 796, 797, 798, 799, 800, 802, 803, 804, 805, 806, 807, 808, 810, 811, 812, 813, 814, 815, 816, 817, 818, 819, 820, 821, 823, 827, 828, 829, 830, 833, 836, 838, 839, 842, 843, 844, 845, 846, 847, 849, 850, 851, 852, 853, 854, 858, 859, 860, 863, 866, 868, 869, 870, 871, 872, 873, 874, 875, 876, 877, 879, 880, 881, 883, 884, 886, 888]
[9, 30, 35, 45, 49, 51, 74, 75, 76, 84, 86, 94, 110, 121, 140, 154, 159, 168, 169, 179, 201, 202, 234, 242, 247, 260, 271, 273, 274, 275, 321, 325, 335, 349, 350, 363, 378, 379, 380, 385, 390, 391, 393, 400, 401, 402, 404, 410, 414, 420, 430, 431, 433, 441, 446, 452, 453, 456, 459, 464, 468, 472, 476, 478, 484, 492, 499, 508, 512, 516, 528, 529, 545, 568, 576, 578, 579, 583, 590, 597, 607, 612, 623, 628, 630, 632, 635, 651, 674, 677, 680, 681, 691, 697, 698, 723, 736, 751, 755, 760, 766, 769, 771, 775, 780, 793, 796, 797, 801, 809, 820, 829, 837, 839, 850, 853, 855, 860, 870, 872, 877, 887]

[0, 1, 2, 3, 4, 5, 6, 7, 8, 9, 10, 11, 12, 13, 14, 15, 16, 17, 18, 19, 20, 21, 22, 23, 24, 25, 26, 27, 28, 29, 30, 31, 33, 34, 35, 36, 37, 38, 39, 40, 41, 42, 43, 44, 45, 46, 47, 48, 49, 50, 51, 52, 53, 54, 55, 56, 57, 58, 60, 62, 63, 64, 66, 67, 68, 69, 71, 72, 73, 74, 75, 76, 78, 79, 80, 81, 82, 83, 85, 86, 87, 88, 89, 90, 91, 92, 93, 94, 95, 97, 98, 99, 101, 102, 103, 104, 105, 106, 107, 108, 109, 111, 113, 114, 115, 116, 117, 118, 119, 120, 121, 122, 123, 124, 125, 127, 128, 129, 130, 131, 132, 135, 136, 137, 138, 139, 142, 143, 144, 145, 146, 147, 148, 149, 150, 151, 152, 153, 154, 155, 156, 158, 159, 160, 161, 162, 163, 164, 166, 167, 168, 169, 171, 173, 174, 175, 176, 178, 179, 180, 181, 182, 183, 184, 185, 186, 187, 188, 189, 190, 191, 192, 193, 194, 195, 196, 197, 199, 201, 202, 203, 204, 205, 206, 208, 210, 211, 212, 214, 215, 217, 218, 219, 220, 221, 222, 224, 225, 226, 227, 228, 229, 231, 232, 233, 234, 235, 236, 237, 238, 239, 240, 241, 242, 245, 246, 247, 249, 250, 251, 252, 253, 254, 255, 256, 257, 258, 259, 261, 262, 263, 264, 265, 266, 267, 269, 270, 271, 272, 273, 274, 275, 276, 277, 278, 280, 281, 282, 283, 284, 285, 286, 287, 288, 289, 290, 291, 292, 293, 294, 295, 296, 297, 298, 299, 300, 301, 302, 303, 304, 305, 306, 307, 308, 309, 310, 311, 312, 313, 314, 315, 316, 317, 318, 319, 320, 321, 322, 324, 327, 328, 329, 330, 332, 333, 334, 335, 336, 337, 338, 340, 341, 342, 343, 344, 345, 346, 347, 348, 349, 350, 351, 352, 353, 354, 355, 356, 357, 358, 359, 361, 362, 365, 366, 367, 368, 369, 370, 371, 372, 375, 376, 377, 378, 379, 380, 381, 382, 383, 384, 385, 386, 387, 388, 389, 390, 391, 392, 393, 394, 395, 396, 397, 398, 399, 400, 404, 406, 407, 408, 409, 411, 412, 413, 415, 416, 417, 418, 420, 421, 422, 424, 425, 426, 427, 428, 429, 430, 431, 432, 433, 434, 435, 436, 437, 438, 439, 440, 441, 442, 443, 446, 447, 448, 449, 450, 452, 454, 455, 456, 457, 458, 460, 461, 462, 463, 464, 465, 466, 467, 468, 470, 471, 472, 473, 474, 475, 476, 477, 478, 479, 480, 481, 482, 483, 484, 485, 486, 487, 488, 490, 492, 493, 494, 495, 496, 498, 499, 500, 501, 502, 503, 505, 506, 507, 508, 509, 510, 511, 512, 513, 514, 515, 516, 517, 518, 519, 520, 521, 522, 523, 524, 525, 526, 528, 529, 530, 531, 532, 533, 534, 535, 536, 537, 538, 539, 540, 541, 542, 543, 544, 545, 547, 549, 550, 551, 552, 553, 554, 555, 556, 557, 558, 560, 561, 562, 563, 565, 567, 568, 569, 571, 572, 573, 574, 575, 576, 578, 579, 580, 581, 582, 583, 584, 585, 586, 587, 588, 589, 590, 591, 592, 594, 595, 596, 597, 598, 599, 600, 602, 603, 604, 605, 606, 607, 608, 609, 610, 611, 612, 613, 614, 615, 617, 619, 620, 621, 622, 623, 625, 626, 627, 628, 629, 630, 631, 633, 634, 635, 636, 637, 638, 639, 640, 641, 642, 643, 644, 645, 646, 647, 648, 649, 650, 651, 652, 653, 654, 655, 656, 657, 658, 659, 660, 661, 662, 663, 664, 665, 666, 667, 668, 671, 672, 673, 675, 676, 677, 678, 679, 680, 681, 682, 683, 684, 685, 688, 689, 690, 691, 693, 694, 695, 696, 697, 698, 699, 700, 701, 704, 705, 706, 707, 708, 709, 710, 712, 713, 714, 715, 716, 717, 718, 719, 720, 721, 722, 723, 724, 725, 727, 728, 729, 731, 732, 733, 734, 735, 736, 737, 738, 739, 740, 741, 742, 744, 745, 746, 747, 748, 749, 750, 751, 752, 753, 756, 757, 758, 759, 760, 761, 762, 763, 765, 766, 767, 768, 770, 772, 773, 774, 775, 776, 777, 778, 779, 780, 782, 783, 784, 785, 787, 789, 790, 791, 792, 793, 794, 795, 796, 797, 798, 799, 800, 801, 802, 803, 804, 805, 806, 807, 808, 810, 811, 812, 813, 814, 815, 816, 817, 818, 819, 820, 821, 823, 825, 826, 827, 828, 829, 830, 831, 833, 836, 838, 839, 841, 842, 843, 844, 845, 846, 847, 849, 850, 851, 852, 853, 854, 856, 858, 859, 860, 861, 862, 863, 866, 867, 868, 869, 870, 871, 872, 873, 874, 875, 876, 877, 878, 879, 880, 881, 883, 884, 885, 886, 888, 889]
[9, 30, 35, 45, 49, 51, 74, 75, 76, 84, 86, 94, 110, 121, 140, 154, 159, 168, 169, 179, 201, 202, 234, 242, 247, 260, 271, 273, 274, 275, 321, 325, 335, 349, 350, 363, 378, 379, 380, 385, 390, 391, 393, 400, 401, 402, 404, 410, 414, 420, 430, 431, 433, 441, 446, 452, 453, 456, 459, 464, 468, 472, 476, 478, 484, 492, 499, 508, 512, 516, 528, 529, 545, 568, 576, 578, 579, 583, 590, 597, 607, 612, 623, 628, 630, 632, 635, 651, 674, 677, 680, 681, 691, 697, 698, 723, 736, 751, 755, 760, 766, 769, 771, 775, 780, 793, 796, 797, 801, 809, 820, 829, 837, 839, 850, 853, 855, 860, 870, 872, 877, 887]

