[6, 7, 35, 97, 177, 246, 266, 272, 319, 364, 398, 408, 417, 500, 518, 550, 557, 591, 614, 631, 701, 870]
[63, 181, 201, 218, 248, 263, 264, 271, 280, 329, 382, 412, 440, 472, 493, 496, 606, 626, 662, 740, 789, 868]

[6, 7, 35, 97, 177, 246, 266, 272, 319, 364, 398, 408, 417, 500, 518, 550, 557, 591, 614, 631, 701, 870]
[2, 5, 13, 19, 22, 26, 28, 29, 31, 44, 45, 63, 67, 69, 78, 88, 104, 106, 118, 121, 129, 151, 153, 181, 183, 186, 188, 194, 201, 209, 218, 225, 242, 247, 248, 252, 261, 262, 263, 264, 271, 274, 280, 289, 291, 316, 325, 328, 329, 333, 345, 350, 355, 359, 366, 373, 381, 382, 394, 412, 427, 440, 442, 443, 449, 451, 455, 460, 472, 474, 483, 485, 489, 493, 496, 497, 508, 509, 513, 516, 522, 524, 529, 547, 556, 565, 582, 602, 606, 615, 620, 626, 632, 642, 650, 655, 657, 662, 688, 702, 722, 730, 733, 740, 749, 764, 767, 784, 789, 790, 795, 812, 814, 818, 825, 837, 848, 863, 864, 868, 869, 881]

[6, 7, 17, 29, 35, 49, 56, 59, 60, 78, 87, 90, 93, 97, 103, 104, 107, 131, 133, 143, 152, 166, 177, 179, 195, 200, 205, 222, 224, 226, 227, 238, 246, 250, 257, 266, 272, 291, 299, 307, 312, 319, 322, 323, 336, 347, 350, 351, 364, 379, 385, 398, 406, 408, 410, 412, 417, 449, 476, 480, 500, 518, 530, 550, 557, 561, 569, 570, 573, 591, 596, 614, 615, 616, 623, 626, 631, 647, 655, 664, 666, 682, 683, 691, 693, 701, 724, 737, 746, 748, 750, 777, 789, 867, 870, 876, 889]
[2, 5, 13, 19, 22, 26, 28, 29, 31, 44, 45, 63, 67, 69, 78, 88, 104, 106, 118, 121, 129, 151, 153, 181, 183, 186, 188, 194, 201, 209, 218, 225, 242, 247, 248, 252, 261, 262, 263, 264, 271, 274, 280, 289, 291, 316, 325, 328, 329, 333, 345, 350, 355, 359, 366, 373, 381, 382, 394, 412, 427, 440, 442, 443, 449, 451, 455, 460, 472, 474, 483, 485, 489, 493, 496, 497, 508, 509, 513, 516, 522, 524, 529, 547, 556, 565, 582, 602, 606, 615, 620, 626, 632, 642, 650, 655, 657, 662, 688, 702, 722, 730, 733, 740, 749, 764, 767, 784, 789, 790, 795, 812, 814, 818, 825, 837, 848, 863, 864, 868, 869, 881]

[4, 6, 7, 17, 19, 29, 35, 41, 49, 52, 56, 58, 59, 60, 77, 78, 87, 90, 93, 97, 102, 103, 104, 107, 108, 113, 119, 123, 131, 133, 140, 143, 152, 153, 155, 162, 166, 177, 179, 185, 192, 195, 200, 205, 209, 218, 222, 224, 226, 227, 238, 246, 250, 255, 257, 266, 270, 272, 288, 291, 299, 306, 307, 312, 319, 322, 323, 335, 336, 340, 347, 350, 351, 363, 364, 378, 379, 385, 386, 398, 405, 406, 408, 410, 412, 417, 427, 428, 433, 445, 449, 462, 463, 476, 480, 485, 488, 500, 508, 518, 522, 527, 530, 536, 550, 557, 559, 561, 569, 570, 573, 589, 591, 596, 605, 614, 615, 616, 623, 626, 627, 631, 641, 647, 651, 655, 657, 664, 666, 668, 681, 682, 683, 689, 691, 693, 697, 699, 700, 701, 711, 717, 724, 736, 737, 746, 747, 748, 750, 756, 759, 768, 777, 789, 795, 807, 815, 819, 831, 836, 840, 847, 851, 865, 866, 867, 870, 872, 876, 879, 885, 889]
[2, 5, 13, 19, 22, 26, 28, 29, 31, 44, 45, 63, 67, 69, 78, 88, 104, 106, 118, 121, 129, 151, 153, 181, 183, 186, 188, 194, 201, 209, 218, 225, 242, 247, 248, 252, 261, 262, 263, 264, 271, 274, 280, 289, 291, 316, 325, 328, 329, 333, 345, 350, 355, 359, 366, 373, 381, 382, 394, 412, 427, 440, 442, 443, 449, 451, 455, 460, 472, 474, 483, 485, 489, 493, 496, 497, 508, 509, 513, 516, 522, 524, 529, 547, 556, 565, 582, 602, 606, 615, 620, 626, 632, 642, 650, 655, 657, 662, 688, 702, 722, 730, 733, 740, 749, 764, 767, 784, 789, 790, 795, 812, 814, 818, 825, 837, 848, 863, 864, 868, 869, 881]

[1, 4, 6, 7, 12, 13, 17, 19, 27, 29, 35, 41, 49, 52, 56, 58, 59, 60, 66, 69, 77, 78, 87, 90, 92, 93, 97, 102, 103, 104, 107, 108, 109, 110, 113, 118, 119, 122, 123, 131, 133, 140, 141, 143, 145, 151, 152, 153, 155, 157, 162, 166, 167, 177, 179, 185, 187, 188, 192, 193, 195, 197, 200, 205, 209, 213, 218, 220, 222, 223, 224, 226, 227, 238, 241, 246, 247, 250, 252, 255, 257, 266, 268, 270, 272, 277, 287, 288, 291, 299, 306, 307, 311, 312, 319, 320, 322, 323, 328, 335, 336, 340, 345, 346, 347, 350, 351, 363, 364, 366, 373, 378, 379, 385, 386, 398, 405, 406, 408, 410, 412, 417, 418, 427, 428, 433, 435, 445, 449, 457, 462, 463, 476, 480, 485, 488, 497, 500, 501, 502, 504, 508, 518, 522, 525, 527, 530, 535, 536, 550, 556, 557, 559, 561, 569, 570, 573, 579, 584, 585, 589, 591, 596, 597, 599, 605, 613, 614, 615, 616, 618, 623, 626, 627, 631, 641, 646, 647, 648, 651, 655, 657, 664, 665, 666, 668, 679, 681, 682, 683, 688, 689, 691, 693, 697, 699, 700, 701, 711, 714, 717, 724, 728, 733, 734, 736, 737, 743, 746, 747, 748, 750, 756, 759, 764, 768, 775, 777, 789, 794, 795, 801, 805, 807, 815, 817, 819, 824, 830, 831, 836, 840, 847, 851, 852, 858, 859, 861, 865, 866, 867, 870, 872, 876, 879, 885, 889]
[2, 5, 13, 19, 22, 26, 28, 29, 31, 44, 45, 63, 67, 69, 78, 88, 104, 106, 118, 121, 129, 151, 153, 181, 183, 186, 188, 194, 201, 209, 218, 225, 242, 247, 248, 252, 261, 262, 263, 264, 271, 274, 280, 289, 291, 316, 325, 328, 329, 333, 345, 350, 355, 359, 366, 373, 381, 382, 394, 412, 427, 440, 442, 443, 449, 451, 455, 460, 472, 474, 483, 485, 489, 493, 496, 497, 508, 509, 513, 516, 522, 524, 529, 547, 556, 565, 582, 602, 606, 615, 620, 626, 632, 642, 650, 655, 657, 662, 688, 702, 722, 730, 733, 740, 749, 764, 767, 784, 789, 790, 795, 812, 814, 818, 825, 837, 848, 863, 864, 868, 869, 881]

[1, 4, 6, 7, 12, 13, 16, 17, 19, 27, 29, 32, 35, 41, 49, 52, 56, 58, 59, 60, 66, 69, 75, 77, 78, 79, 85, 87, 90, 92, 93, 96, 97, 101, 102, 103, 104, 107, 108, 109, 110, 113, 115, 118, 119, 120, 121, 122, 123, 125, 131, 133, 135, 140, 141, 143, 145, 151, 152, 153, 155, 157, 162, 163, 166, 167, 176, 177, 179, 181, 185, 186, 187, 188, 192, 193, 195, 197, 198, 200, 201, 205, 206, 208, 209, 210, 213, 214, 218, 220, 222, 223, 224, 226, 227, 238, 241, 242, 244, 246, 247, 249, 250, 252, 255, 257, 266, 268, 270, 272, 277, 286, 287, 288, 291, 299, 306, 307, 311, 312, 315, 319, 320, 322, 323, 328, 331, 335, 336, 337, 340, 342, 345, 346, 347, 350, 351, 363, 364, 366, 373, 378, 379, 385, 386, 388, 392, 398, 405, 406, 408, 410, 411, 412, 415, 417, 418, 422, 424, 427, 428, 431, 433, 435, 436, 443, 444, 445, 449, 452, 456, 457, 462, 463, 466, 476, 480, 481, 482, 485, 488, 497, 500, 501, 502, 504, 508, 512, 518, 522, 525, 527, 530, 535, 536, 549, 550, 553, 556, 557, 559, 561, 567, 569, 570, 573, 579, 584, 585, 589, 591, 596, 597, 599, 605, 609, 613, 614, 615, 616, 618, 623, 626, 627, 631, 632, 641, 646, 647, 648, 651, 652, 655, 657, 664, 665, 666, 668, 669, 679, 681, 682, 683, 688, 689, 690, 691, 693, 694, 697, 699, 700, 701, 708, 710, 711, 714, 717, 724, 728, 733, 734, 736, 737, 743, 744, 746, 747, 748, 750, 756, 758, 759, 764, 768, 770, 775, 777, 778, 781, 786, 787, 789, 791, 794, 795, 798, 801, 805, 807, 808, 815, 817, 818, 819, 821, 824, 830, 831, 832, 836, 840, 847, 849, 851, 852, 854, 858, 859, 860, 861, 865, 866, 867, 868, 870, 871, 872, 876, 879, 885, 889]
[2, 5, 13, 19, 22, 26, 28, 29, 31, 44, 45, 63, 67, 69, 78, 88, 104, 106, 118, 121, 129, 151, 153, 181, 183, 186, 188, 194, 201, 209, 218, 225, 242, 247, 248, 252, 261, 262, 263, 264, 271, 274, 280, 289, 291, 316, 325, 328, 329, 333, 345, 350, 355, 359, 366, 373, 381, 382, 394, 412, 427, 440, 442, 443, 449, 451, 455, 460, 472, 474, 483, 485, 489, 493, 496, 497, 508, 509, 513, 516, 522, 524, 529, 547, 556, 565, 582, 602, 606, 615, 620, 626, 632, 642, 650, 655, 657, 662, 688, 702, 722, 730, 733, 740, 749, 764, 767, 784, 789, 790, 795, 812, 814, 818, 825, 837, 848, 863, 864, 868, 869, 881]

[1, 2, 4, 6, 7, 12, 13, 14, 16, 17, 19, 20, 27, 28, 29, 30, 32, 35, 41, 43, 49, 52, 56, 58, 59, 60, 64, 66, 69, 70, 75, 77, 78, 79, 85, 86, 87, 90, 92, 93, 94, 96, 97, 101, 102, 103, 104, 107, 108, 109, 110, 113, 115, 117, 118, 119, 120, 121, 122, 123, 125, 130, 131, 133, 135, 140, 141, 143, 145, 151, 152, 153, 155, 156, 157, 158, 160, 162, 163, 166, 167, 170, 173, 176, 177, 179, 181, 185, 186, 187, 188, 192, 193, 195, 196, 197, 198, 200, 201, 205, 206, 208, 209, 210, 213, 214, 216, 218, 220, 222, 223, 224, 226, 227, 228, 230, 238, 241, 242, 244, 246, 247, 249, 250, 251, 252, 253, 255, 257, 259, 261, 266, 268, 269, 270, 272, 274, 277, 286, 287, 288, 291, 293, 296, 299, 302, 306, 307, 311, 312, 315, 319, 320, 322, 323, 326, 328, 331, 335, 336, 337, 340, 342, 344, 345, 346, 347, 350, 351, 352, 363, 364, 366, 370, 373, 376, 378, 379, 385, 386, 387, 388, 392, 398, 399, 400, 405, 406, 408, 410, 411, 412, 414, 415, 417, 418, 420, 422, 424, 426, 427, 428, 431, 432, 433, 435, 436, 443, 444, 445, 449, 452, 455, 456, 457, 462, 463, 466, 471, 476, 480, 481, 482, 485, 486, 488, 493, 497, 499, 500, 501, 502, 504, 506, 508, 510, 512, 517, 518, 522, 524, 525, 527, 529, 530, 533, 535, 536, 549, 550, 551, 553, 556, 557, 559, 560, 561, 564, 567, 569, 570, 573, 575, 579, 584, 585, 587, 589, 591, 596, 597, 599, 601, 603, 605, 609, 612, 613, 614, 615, 616, 618, 623, 626, 627, 631, 632, 637, 638, 641, 646, 647, 648, 651, 652, 655, 657, 664, 665, 666, 668, 669, 679, 681, 682, 683, 688, 689, 690, 691, 693, 694, 697, 699, 700, 701, 703, 705, 708, 710, 711, 714, 717, 724, 728, 733, 734, 735, 736, 737, 739, 743, 744, 746, 747, 748, 749, 750, 756, 758, 759, 764, 768, 770, 771, 775, 777, 778, 781, 786, 787, 789, 791, 792, 794, 795, 798, 801, 805, 807, 808, 815, 817, 818, 819, 821, 824, 830, 831, 832, 836, 840, 842, 843, 847, 849, 851, 852, 854, 856, 858, 859, 860, 861, 865, 866, 867, 868, 869, 870, 871, 872, 875, 876, 879, 885, 889]
[2, 5, 13, 19, 22, 26, 28, 29, 31, 44, 45, 63, 67, 69, 78, 88, 104, 106, 118, 121, 129, 151, 153, 181, 183, 186, 188, 194, 201, 209, 218, 225, 242, 247, 248, 252, 261, 262, 263, 264, 271, 274, 280, 289, 291, 316, 325, 328, 329, 333, 345, 350, 355, 359, 366, 373, 381, 382, 394, 412, 427, 440, 442, 443, 449, 451, 455, 460, 472, 474, 483, 485, 489, 493, 496, 497, 508, 509, 513, 516, 522, 524, 529, 547, 556, 565, 582, 602, 606, 615, 620, 626, 632, 642, 650, 655, 657, 662, 688, 702, 722, 730, 733, 740, 749, 764, 767, 784, 789, 790, 795, 812, 814, 818, 825, 837, 848, 863, 864, 868, 869, 881]

[0, 1, 2, 4, 6, 7, 12, 13, 14, 16, 17, 19, 20, 22, 23, 25, 27, 28, 29, 30, 31, 32, 33, 35, 41, 42, 43, 44, 49, 50, 52, 54, 56, 57, 58, 59, 60, 64, 65, 66, 69, 70, 71, 75, 77, 78, 79, 83, 85, 86, 87, 90, 91, 92, 93, 94, 96, 97, 101, 102, 103, 104, 107, 108, 109, 110, 112, 113, 115, 117, 118, 119, 120, 121, 122, 123, 125, 130, 131, 133, 135, 136, 137, 139, 140, 141, 143, 145, 151, 152, 153, 155, 156, 157, 158, 160, 162, 163, 166, 167, 168, 170, 173, 175, 176, 177, 179, 180, 181, 185, 186, 187, 188, 192, 193, 195, 196, 197, 198, 200, 201, 205, 206, 208, 209, 210, 212, 213, 214, 216, 218, 220, 221, 222, 223, 224, 226, 227, 228, 230, 238, 241, 242, 243, 244, 246, 247, 249, 250, 251, 252, 253, 255, 257, 259, 261, 262, 266, 268, 269, 270, 272, 274, 275, 277, 286, 287, 288, 291, 293, 296, 299, 302, 306, 307, 311, 312, 315, 316, 319, 320, 322, 323, 326, 328, 330, 331, 335, 336, 337, 340, 342, 344, 345, 346, 347, 350, 351, 352, 354, 356, 363, 364, 366, 370, 373, 376, 378, 379, 384, 385, 386, 387, 388, 390, 392, 398, 399, 400, 401, 402, 405, 406, 408, 410, 411, 412, 414, 415, 416, 417, 418, 420, 422, 424, 426, 427, 428, 431, 432, 433, 435, 436, 442, 443, 444, 445, 449, 450, 451, 452, 455, 456, 457, 458, 461, 462, 463, 466, 469, 471, 476, 480, 481, 482, 485, 486, 487, 488, 493, 497, 499, 500, 501, 502, 503, 504, 505, 506, 508, 510, 512, 517, 518, 522, 524, 525, 527, 529, 530, 531, 533, 535, 536, 539, 548, 549, 550, 551, 553, 556, 557, 559, 560, 561, 564, 567, 569, 570, 573, 575, 579, 583, 584, 585, 587, 589, 591, 596, 597, 599, 601, 602, 603, 605, 607, 609, 612, 613, 614, 615, 616, 618, 623, 626, 627, 631, 632, 637, 638, 641, 646, 647, 648, 651, 652, 655, 656, 657, 658, 661, 664, 665, 666, 668, 669, 671, 679, 681, 682, 683, 688, 689, 690, 691, 693, 694, 697, 699, 700, 701, 703, 705, 708, 709, 710, 711, 714, 717, 719, 721, 724, 728, 732, 733, 734, 735, 736, 737, 739, 743, 744, 746, 747, 748, 749, 750, 751, 754, 756, 758, 759, 763, 764, 765, 768, 769, 770, 771, 772, 775, 777, 778, 779, 781, 786, 787, 788, 789, 790, 791, 792, 794, 795, 798, 801, 804, 805, 807, 808, 811, 812, 815, 817, 818, 819, 821, 824, 828, 830, 831, 832, 836, 840, 842, 843, 847, 849, 851, 852, 854, 856, 858, 859, 860, 861, 865, 866, 867, 868, 869, 870, 871, 872, 875, 876, 878, 879, 882, 883, 885, 889]
[2, 5, 13, 19, 22, 26, 28, 29, 31, 44, 45, 63, 67, 69, 78, 88, 104, 106, 118, 121, 129, 151, 153, 181, 183, 186, 188, 194, 201, 209, 218, 225, 242, 247, 248, 252, 261, 262, 263, 264, 271, 274, 280, 289, 291, 316, 325, 328, 329, 333, 345, 350, 355, 359, 366, 373, 381, 382, 394, 412, 427, 440, 442, 443, 449, 451, 455, 460, 472, 474, 483, 485, 489, 493, 496, 497, 508, 509, 513, 516, 522, 524, 529, 547, 556, 565, 582, 602, 606, 615, 620, 626, 632, 642, 650, 655, 657, 662, 688, 702, 722, 730, 733, 740, 749, 764, 767, 784, 789, 790, 795, 812, 814, 818, 825, 837, 848, 863, 864, 868, 869, 881]

[0, 1, 2, 3, 4, 6, 7, 12, 13, 14, 16, 17, 19, 20, 22, 23, 25, 27, 28, 29, 30, 31, 32, 33, 34, 35, 37, 38, 41, 42, 43, 44, 46, 49, 50, 52, 53, 54, 56, 57, 58, 59, 60, 62, 63, 64, 65, 66, 69, 70, 71, 72, 75, 77, 78, 79, 83, 84, 85, 86, 87, 88, 90, 91, 92, 93, 94, 95, 96, 97, 100, 101, 102, 103, 104, 107, 108, 109, 110, 112, 113, 115, 117, 118, 119, 120, 121, 122, 123, 124, 125, 130, 131, 133, 135, 136, 137, 139, 140, 141, 143, 144, 145, 146, 151, 152, 153, 155, 156, 157, 158, 160, 162, 163, 166, 167, 168, 169, 170, 172, 173, 175, 176, 177, 179, 180, 181, 182, 185, 186, 187, 188, 189, 192, 193, 195, 196, 197, 198, 200, 201, 205, 206, 207, 208, 209, 210, 212, 213, 214, 216, 218, 220, 221, 222, 223, 224, 225, 226, 227, 228, 230, 231, 236, 238, 241, 242, 243, 244, 246, 247, 249, 250, 251, 252, 253, 255, 256, 257, 259, 261, 262, 266, 267, 268, 269, 270, 272, 274, 275, 276, 277, 286, 287, 288, 290, 291, 293, 296, 299, 302, 303, 306, 307, 308, 309, 311, 312, 315, 316, 319, 320, 321, 322, 323, 325, 326, 327, 328, 330, 331, 335, 336, 337, 339, 340, 341, 342, 344, 345, 346, 347, 350, 351, 352, 354, 356, 363, 364, 366, 368, 370, 373, 376, 378, 379, 384, 385, 386, 387, 388, 390, 392, 395, 398, 399, 400, 401, 402, 405, 406, 408, 409, 410, 411, 412, 414, 415, 416, 417, 418, 420, 422, 423, 424, 426, 427, 428, 431, 432, 433, 435, 436, 441, 442, 443, 444, 445, 446, 449, 450, 451, 452, 455, 456, 457, 458, 461, 462, 463, 464, 465, 466, 469, 471, 473, 475, 476, 480, 481, 482, 484, 485, 486, 487, 488, 489, 493, 497, 499, 500, 501, 502, 503, 504, 505, 506, 508, 510, 512, 513, 516, 517, 518, 519, 520, 522, 524, 525, 527, 529, 530, 531, 533, 535, 536, 539, 548, 549, 550, 551, 553, 556, 557, 558, 559, 560, 561, 564, 565, 566, 567, 568, 569, 570, 571, 573, 575, 579, 580, 581, 583, 584, 585, 586, 587, 589, 591, 596, 597, 598, 599, 601, 602, 603, 605, 607, 609, 612, 613, 614, 615, 616, 618, 621, 623, 626, 627, 629, 631, 632, 637, 638, 641, 643, 646, 647, 648, 649, 651, 652, 655, 656, 657, 658, 660, 661, 664, 665, 666, 667, 668, 669, 671, 675, 679, 681, 682, 683, 688, 689, 690, 691, 693, 694, 697, 699, 700, 701, 703, 705, 708, 709, 710, 711, 712, 714, 716, 717, 719, 721, 724, 725, 728, 732, 733, 734, 735, 736, 737, 739, 740, 743, 744, 746, 747, 748, 749, 750, 751, 754, 756, 758, 759, 763, 764, 765, 766, 768, 769, 770, 771, 772, 775, 777, 778, 779, 781, 782, 785, 786, 787, 788, 789, 790, 791, 792, 794, 795, 798, 801, 804, 805, 806, 807, 808, 809, 811, 812, 813, 815, 817, 818, 819, 820, 821, 824, 826, 828, 830, 831, 832, 836, 837, 840, 842, 843, 847, 849, 851, 852, 854, 856, 858, 859, 860, 861, 865, 866, 867, 868, 869, 870, 871, 872, 875, 876, 878, 879, 882, 883, 885, 889]
[2, 5, 13, 19, 22, 26, 28, 29, 31, 44, 45, 63, 67, 69, 78, 88, 104, 106, 118, 121, 129, 151, 153, 181, 183, 186, 188, 194, 201, 209, 218, 225, 242, 247, 248, 252, 261, 262, 263, 264, 271, 274, 280, 289, 291, 316, 325, 328, 329, 333, 345, 350, 355, 359, 366, 373, 381, 382, 394, 412, 427, 440, 442, 443, 449, 451, 455, 460, 472, 474, 483, 485, 489, 493, 496, 497, 508, 509, 513, 516, 522, 524, 529, 547, 556, 565, 582, 602, 606, 615, 620, 626, 632, 642, 650, 655, 657, 662, 688, 702, 722, 730, 733, 740, 749, 764, 767, 784, 789, 790, 795, 812, 814, 818, 825, 837, 848, 863, 864, 868, 869, 881]

[0, 1, 2, 3, 4, 5, 6, 7, 8, 12, 13, 14, 16, 17, 19, 20, 22, 23, 25, 26, 27, 28, 29, 30, 31, 32, 33, 34, 35, 37, 38, 41, 42, 43, 44, 46, 49, 50, 52, 53, 54, 56, 57, 58, 59, 60, 61, 62, 63, 64, 65, 66, 67, 68, 69, 70, 71, 72, 74, 75, 77, 78, 79, 81, 82, 83, 84, 85, 86, 87, 88, 90, 91, 92, 93, 94, 95, 96, 97, 99, 100, 101, 102, 103, 104, 107, 108, 109, 110, 112, 113, 114, 115, 117, 118, 119, 120, 121, 122, 123, 124, 125, 129, 130, 131, 133, 135, 136, 137, 139, 140, 141, 143, 144, 145, 146, 151, 152, 153, 155, 156, 157, 158, 160, 162, 163, 166, 167, 168, 169, 170, 172, 173, 175, 176, 177, 179, 180, 181, 182, 185, 186, 187, 188, 189, 192, 193, 195, 196, 197, 198, 200, 201, 205, 206, 207, 208, 209, 210, 212, 213, 214, 216, 218, 220, 221, 222, 223, 224, 225, 226, 227, 228, 230, 231, 236, 237, 238, 241, 242, 243, 244, 246, 247, 249, 250, 251, 252, 253, 255, 256, 257, 259, 261, 262, 264, 265, 266, 267, 268, 269, 270, 272, 274, 275, 276, 277, 286, 287, 288, 290, 291, 293, 294, 295, 296, 299, 300, 302, 303, 306, 307, 308, 309, 311, 312, 313, 315, 316, 317, 319, 320, 321, 322, 323, 325, 326, 327, 328, 330, 331, 332, 335, 336, 337, 338, 339, 340, 341, 342, 344, 345, 346, 347, 350, 351, 352, 353, 354, 356, 363, 364, 366, 368, 370, 373, 376, 377, 378, 379, 381, 383, 384, 385, 386, 387, 388, 389, 390, 392, 393, 395, 398, 399, 400, 401, 402, 405, 406, 408, 409, 410, 411, 412, 414, 415, 416, 417, 418, 420, 422, 423, 424, 425, 426, 427, 428, 431, 432, 433, 435, 436, 437, 441, 442, 443, 444, 445, 446, 449, 450, 451, 452, 455, 456, 457, 458, 461, 462, 463, 464, 465, 466, 469, 471, 473, 475, 476, 480, 481, 482, 483, 484, 485, 486, 487, 488, 489, 493, 497, 499, 500, 501, 502, 503, 504, 505, 506, 508, 510, 512, 513, 515, 516, 517, 518, 519, 520, 522, 524, 525, 527, 529, 530, 531, 533, 535, 536, 539, 542, 545, 548, 549, 550, 551, 553, 554, 556, 557, 558, 559, 560, 561, 563, 564, 565, 566, 567, 568, 569, 570, 571, 573, 575, 576, 578, 579, 580, 581, 583, 584, 585, 586, 587, 589, 591, 596, 597, 598, 599, 601, 602, 603, 604, 605, 606, 607, 609, 612, 613, 614, 615, 616, 618, 620, 621, 623, 624, 626, 627, 629, 631, 632, 637, 638, 641, 643, 644, 645, 646, 647, 648, 649, 651, 652, 654, 655, 656, 657, 658, 659, 660, 661, 664, 665, 666, 667, 668, 669, 670, 671, 673, 675, 677, 679, 681, 682, 683, 684, 686, 687, 688, 689, 690, 691, 693, 694, 695, 696, 697, 699, 700, 701, 703, 705, 708, 709, 710, 711, 712, 714, 715, 716, 717, 719, 721, 724, 725, 728, 732, 733, 734, 735, 736, 737, 739, 740, 743, 744, 746, 747, 748, 749, 750, 751, 752, 754, 755, 756, 757, 758, 759, 760, 763, 764, 765, 766, 768, 769, 770, 771, 772, 774, 775, 777, 778, 779, 781, 782, 785, 786, 787, 788, 789, 790, 791, 792, 794, 795, 796, 797, 798, 800, 801, 804, 805, 806, 807, 808, 809, 811, 812, 813, 815, 817, 818, 819, 820, 821, 822, 824, 826, 828, 830, 831, 832, 834, 835, 836, 837, 838, 840, 842, 843, 847, 849, 851, 852, 853, 854, 855, 856, 858, 859, 860, 861, 864, 865, 866, 867, 868, 869, 870, 871, 872, 873, 875, 876, 878, 879, 881, 882, 883, 884, 885, 886, 887, 889]
[2, 5, 13, 19, 22, 26, 28, 29, 31, 44, 45, 63, 67, 69, 78, 88, 104, 106, 118, 121, 129, 151, 153, 181, 183, 186, 188, 194, 201, 209, 218, 225, 242, 247, 248, 252, 261, 262, 263, 264, 271, 274, 280, 289, 291, 316, 325, 328, 329, 333, 345, 350, 355, 359, 366, 373, 381, 382, 394, 412, 427, 440, 442, 443, 449, 451, 455, 460, 472, 474, 483, 485, 489, 493, 496, 497, 508, 509, 513, 516, 522, 524, 529, 547, 556, 565, 582, 602, 606, 615, 620, 626, 632, 642, 650, 655, 657, 662, 688, 702, 722, 730, 733, 740, 749, 764, 767, 784, 789, 790, 795, 812, 814, 818, 825, 837, 848, 863, 864, 868, 869, 881]

[0, 1, 2, 3, 4, 5, 6, 7, 8, 12, 13, 14, 16, 17, 19, 20, 21, 22, 23, 25, 26, 27, 28, 29, 30, 31, 32, 33, 34, 35, 37, 38, 39, 41, 42, 43, 44, 46, 47, 49, 50, 52, 53, 54, 55, 56, 57, 58, 59, 60, 61, 62, 63, 64, 65, 66, 67, 68, 69, 70, 71, 72, 74, 75, 77, 78, 79, 81, 82, 83, 84, 85, 86, 87, 88, 89, 90, 91, 92, 93, 94, 95, 96, 97, 99, 100, 101, 102, 103, 104, 105, 107, 108, 109, 110, 112, 113, 114, 115, 117, 118, 119, 120, 121, 122, 123, 124, 125, 128, 129, 130, 131, 133, 134, 135, 136, 137, 139, 140, 141, 142, 143, 144, 145, 146, 148, 151, 152, 153, 155, 156, 157, 158, 159, 160, 162, 163, 166, 167, 168, 169, 170, 172, 173, 175, 176, 177, 179, 180, 181, 182, 184, 185, 186, 187, 188, 189, 190, 191, 192, 193, 195, 196, 197, 198, 199, 200, 201, 205, 206, 207, 208, 209, 210, 212, 213, 214, 216, 218, 219, 220, 221, 222, 223, 224, 225, 226, 227, 228, 229, 230, 231, 233, 236, 237, 238, 241, 242, 243, 244, 246, 247, 249, 250, 251, 252, 253, 255, 256, 257, 259, 261, 262, 264, 265, 266, 267, 268, 269, 270, 272, 274, 275, 276, 277, 280, 281, 286, 287, 288, 290, 291, 293, 294, 295, 296, 297, 298, 299, 300, 301, 302, 303, 304, 306, 307, 308, 309, 311, 312, 313, 315, 316, 317, 319, 320, 321, 322, 323, 325, 326, 327, 328, 330, 331, 332, 335, 336, 337, 338, 339, 340, 341, 342, 344, 345, 346, 347, 348, 349, 350, 351, 352, 353, 354, 356, 363, 364, 365, 366, 367, 368, 370, 373, 376, 377, 378, 379, 380, 381, 383, 384, 385, 386, 387, 388, 389, 390, 391, 392, 393, 394, 395, 396, 397, 398, 399, 400, 401, 402, 404, 405, 406, 407, 408, 409, 410, 411, 412, 414, 415, 416, 417, 418, 420, 421, 422, 423, 424, 425, 426, 427, 428, 431, 432, 433, 435, 436, 437, 441, 442, 443, 444, 445, 446, 449, 450, 451, 452, 455, 456, 457, 458, 459, 461, 462, 463, 464, 465, 466, 468, 469, 471, 472, 473, 475, 476, 480, 481, 482, 483, 484, 485, 486, 487, 488, 489, 491, 492, 493, 494, 497, 498, 499, 500, 501, 502, 503, 504, 505, 506, 507, 508, 509, 510, 512, 513, 515, 516, 517, 518, 519, 520, 521, 522, 523, 524, 525, 527, 529, 530, 531, 533, 534, 535, 536, 537, 538, 539, 540, 542, 545, 548, 549, 550, 551, 552, 553, 554, 556, 557, 558, 559, 560, 561, 563, 564, 565, 566, 567, 568, 569, 570, 571, 573, 574, 575, 576, 578, 579, 580, 581, 583, 584, 585, 586, 587, 589, 591, 593, 596, 597, 598, 599, 601, 602, 603, 604, 605, 606, 607, 609, 611, 612, 613, 614, 615, 616, 618, 620, 621, 623, 624, 626, 627, 628, 629, 631, 632, 633, 635, 636, 637, 638, 641, 643, 644, 645, 646, 647, 648, 649, 650, 651, 652, 653, 654, 655, 656, 657, 658, 659, 660, 661, 664, 665, 666, 667, 668, 669, 670, 671, 673, 674, 675, 677, 678, 679, 681, 682, 683, 684, 686, 687, 688, 689, 690, 691, 693, 694, 695, 696, 697, 698, 699, 700, 701, 703, 704, 705, 707, 708, 709, 710, 711, 712, 713, 714, 715, 716, 717, 719, 720, 721, 722, 724, 725, 727, 728, 732, 733, 734, 735, 736, 737, 739, 740, 743, 744, 746, 747, 748, 749, 750, 751, 752, 753, 754, 755, 756, 757, 758, 759, 760, 761, 763, 764, 765, 766, 767, 768, 769, 770, 771, 772, 774, 775, 776, 777, 778, 779, 781, 782, 784, 785, 786, 787, 788, 789, 790, 791, 792, 794, 795, 796, 797, 798, 800, 801, 803, 804, 805, 806, 807, 808, 809, 810, 811, 812, 813, 815, 817, 818, 819, 820, 821, 822, 823, 824, 826, 828, 830, 831, 832, 834, 835, 836, 837, 838, 839, 840, 842, 843, 844, 845, 847, 849, 851, 852, 853, 854, 855, 856, 858, 859, 860, 861, 864, 865, 866, 867, 868, 869, 870, 871, 872, 873, 875, 876, 877, 878, 879, 881, 882, 883, 884, 885, 886, 887, 889]
[2, 5, 13, 19, 22, 26, 28, 29, 31, 44, 45, 63, 67, 69, 78, 88, 104, 106, 118, 121, 129, 151, 153, 181, 183, 186, 188, 194, 201, 209, 218, 225, 242, 247, 248, 252, 261, 262, 263, 264, 271, 274, 280, 289, 291, 316, 325, 328, 329, 333, 345, 350, 355, 359, 366, 373, 381, 382, 394, 412, 427, 440, 442, 443, 449, 451, 455, 460, 472, 474, 483, 485, 489, 493, 496, 497, 508, 509, 513, 516, 522, 524, 529, 547, 556, 565, 582, 602, 606, 615, 620, 626, 632, 642, 650, 655, 657, 662, 688, 702, 722, 730, 733, 740, 749, 764, 767, 784, 789, 790, 795, 812, 814, 818, 825, 837, 848, 863, 864, 868, 869, 881]

[0, 1, 2, 3, 4, 5, 6, 7, 8, 10, 12, 13, 14, 15, 16, 17, 18, 19, 20, 21, 22, 23, 24, 25, 26, 27, 28, 29, 30, 31, 32, 33, 34, 35, 37, 38, 39, 40, 41, 42, 43, 44, 45, 46, 47, 49, 50, 52, 53, 54, 55, 56, 57, 58, 59, 60, 61, 62, 63, 64, 65, 66, 67, 68, 69, 70, 71, 72, 74, 75, 77, 78, 79, 80, 81, 82, 83, 84, 85, 86, 87, 88, 89, 90, 91, 92, 93, 94, 95, 96, 97, 98, 99, 100, 101, 102, 103, 104, 105, 107, 108, 109, 110, 112, 113, 114, 115, 116, 117, 118, 119, 120, 121, 122, 123, 124, 125, 128, 129, 130, 131, 133, 134, 135, 136, 137, 138, 139, 140, 141, 142, 143, 144, 145, 146, 148, 149, 151, 152, 153, 154, 155, 156, 157, 158, 159, 160, 161, 162, 163, 164, 166, 167, 168, 169, 170, 172, 173, 175, 176, 177, 179, 180, 181, 182, 183, 184, 185, 186, 187, 188, 189, 190, 191, 192, 193, 194, 195, 196, 197, 198, 199, 200, 201, 202, 205, 206, 207, 208, 209, 210, 211, 212, 213, 214, 215, 216, 217, 218, 219, 220, 221, 222, 223, 224, 225, 226, 227, 228, 229, 230, 231, 233, 234, 236, 237, 238, 240, 241, 242, 243, 244, 246, 247, 249, 250, 251, 252, 253, 254, 255, 256, 257, 259, 261, 262, 264, 265, 266, 267, 268, 269, 270, 272, 273, 274, 275, 276, 277, 280, 281, 282, 286, 287, 288, 289, 290, 291, 293, 294, 295, 296, 297, 298, 299, 300, 301, 302, 303, 304, 305, 306, 307, 308, 309, 311, 312, 313, 314, 315, 316, 317, 318, 319, 320, 321, 322, 323, 324, 325, 326, 327, 328, 330, 331, 332, 334, 335, 336, 337, 338, 339, 340, 341, 342, 344, 345, 346, 347, 348, 349, 350, 351, 352, 353, 354, 356, 358, 359, 360, 361, 363, 364, 365, 366, 367, 368, 370, 371, 373, 375, 376, 377, 378, 379, 380, 381, 383, 384, 385, 386, 387, 388, 389, 390, 391, 392, 393, 394, 395, 396, 397, 398, 399, 400, 401, 402, 404, 405, 406, 407, 408, 409, 410, 411, 412, 414, 415, 416, 417, 418, 420, 421, 422, 423, 424, 425, 426, 427, 428, 431, 432, 433, 434, 435, 436, 437, 439, 440, 441, 442, 443, 444, 445, 446, 447, 448, 449, 450, 451, 452, 454, 455, 456, 457, 458, 459, 460, 461, 462, 463, 464, 465, 466, 468, 469, 470, 471, 472, 473, 474, 475, 476, 478, 479, 480, 481, 482, 483, 484, 485, 486, 487, 488, 489, 490, 491, 492, 493, 494, 497, 498, 499, 500, 501, 502, 503, 504, 505, 506, 507, 508, 509, 510, 511, 512, 513, 514, 515, 516, 517, 518, 519, 520, 521, 522, 523, 524, 525, 527, 529, 530, 531, 532, 533, 534, 535, 536, 537, 538, 539, 540, 542, 545, 546, 548, 549, 550, 551, 552, 553, 554, 556, 557, 558, 559, 560, 561, 563, 564, 565, 566, 567, 568, 569, 570, 571, 573, 574, 575, 576, 577, 578, 579, 580, 581, 583, 584, 585, 586, 587, 588, 589, 591, 593, 596, 597, 598, 599, 600, 601, 602, 603, 604, 605, 606, 607, 609, 611, 612, 613, 614, 615, 616, 617, 618, 620, 621, 623, 624, 626, 627, 628, 629, 630, 631, 632, 633, 635, 636, 637, 638, 640, 641, 643, 644, 645, 646, 647, 648, 649, 650, 651, 652, 653, 654, 655, 656, 657, 658, 659, 660, 661, 662, 664, 665, 666, 667, 668, 669, 670, 671, 673, 674, 675, 676, 677, 678, 679, 681, 682, 683, 684, 686, 687, 688, 689, 690, 691, 693, 694, 695, 696, 697, 698, 699, 700, 701, 702, 703, 704, 705, 706, 707, 708, 709, 710, 711, 712, 713, 714, 715, 716, 717, 718, 719, 720, 721, 722, 724, 725, 727, 728, 729, 731, 732, 733, 734, 735, 736, 737, 739, 740, 743, 744, 746, 747, 748, 749, 750, 751, 752, 753, 754, 755, 756, 757, 758, 759, 760, 761, 763, 764, 765, 766, 767, 768, 769, 770, 771, 772, 774, 775, 776, 777, 778, 779, 781, 782, 783, 784, 785, 786, 787, 788, 789, 790, 791, 792, 794, 795, 796, 797, 798, 799, 800, 801, 803, 804, 805, 806, 807, 808, 809, 810, 811, 812, 813, 815, 816, 817, 818, 819, 820, 821, 822, 823, 824, 826, 827, 828, 830, 831, 832, 834, 835, 836, 837, 838, 839, 840, 841, 842, 843, 844, 845, 847, 848, 849, 850, 851, 852, 853, 854, 855, 856, 857, 858, 859, 860, 861, 863, 864, 865, 866, 867, 868, 869, 870, 871, 872, 873, 875, 876, 877, 878, 879, 881, 882, 883, 884, 885, 886, 887, 889]
[2, 5, 13, 19, 22, 26, 28, 29, 31, 44, 45, 63, 67, 69, 78, 88, 104, 106, 118, 121, 129, 151, 153, 181, 183, 186, 188, 194, 201, 209, 218, 225, 242, 247, 248, 252, 261, 262, 263, 264, 271, 274, 280, 289, 291, 316, 325, 328, 329, 333, 345, 350, 355, 359, 366, 373, 381, 382, 394, 412, 427, 440, 442, 443, 449, 451, 455, 460, 472, 474, 483, 485, 489, 493, 496, 497, 508, 509, 513, 516, 522, 524, 529, 547, 556, 565, 582, 602, 606, 615, 620, 626, 632, 642, 650, 655, 657, 662, 688, 702, 722, 730, 733, 740, 749, 764, 767, 784, 789, 790, 795, 812, 814, 818, 825, 837, 848, 863, 864, 868, 869, 881]

